date,country,population_total,state,population_per_state,one_shot_perc,one_shot_daily,one_shot_total,two_shot_perc,two_shot_daily,two_shot_total,three_shot_perc,three_shot_daily,three_shot_total
2021-01-17,Brazil,203070494,Acre,830018,0.0000,5,5,0.0000,0,0,0.0000,0,0
2021-01-18,Brazil,203070494,Acre,830018,0.0000,5,10,0.0000,0,0,0.0000,0,0
2021-01-19,Brazil,203070494,Acre,830018,0.0001,48,58,0.0000,0,0,0.0000,0,0
2021-01-20,Brazil,203070494,Acre,830018,0.0013,1037,1095,0.0000,1,1,0.0000,0,0
2021-01-21,Brazil,203070494,Acre,830018,0.0033,1624,2719,0.0000,2,3,0.0000,0,0
2021-01-22,Brazil,203070494,Acre,830018,0.0046,1127,3846,0.0000,2,5,0.0000,0,0
2021-01-23,Brazil,203070494,Acre,830018,0.0049,199,4045,0.0000,2,7,0.0000,0,0
2021-01-24,Brazil,203070494,Acre,830018,0.0050,104,4149,0.0000,6,13,0.0000,0,0
2021-01-25,Brazil,203070494,Acre,830018,0.0061,911,5060,0.0000,0,13,0.0000,0,0
2021-01-26,Brazil,203070494,Acre,830018,0.0076,1224,6284,0.0000,2,15,0.0000,0,0
2021-01-27,Brazil,203070494,Acre,830018,0.0091,1273,7557,0.0000,1,16,0.0000,0,0
2021-01-28,Brazil,203070494,Acre,830018,0.0103,1026,8583,0.0000,0,16,0.0000,0,0
2021-01-29,Brazil,203070494,Acre,830018,0.0124,1693,10276,0.0000,3,19,0.0000,0,0
2021-01-30,Brazil,203070494,Acre,830018,0.0132,684,10960,0.0000,2,21,0.0000,0,0
2021-01-31,Brazil,203070494,Acre,830018,0.0134,146,11106,0.0000,0,21,0.0000,0,0
2021-02-01,Brazil,203070494,Acre,830018,0.0144,851,11957,0.0000,3,24,0.0000,0,0
2021-02-02,Brazil,203070494,Acre,830018,0.0150,490,12447,0.0000,4,28,0.0000,0,0
2021-02-03,Brazil,203070494,Acre,830018,0.0160,873,13320,0.0000,2,30,0.0000,0,0
2021-02-04,Brazil,203070494,Acre,830018,0.0166,491,13811,0.0001,51,81,0.0000,0,0
2021-02-05,Brazil,203070494,Acre,830018,0.0173,530,14341,0.0001,13,94,0.0000,0,0
2021-02-06,Brazil,203070494,Acre,830018,0.0175,177,14518,0.0001,29,123,0.0000,0,0
2021-02-07,Brazil,203070494,Acre,830018,0.0176,80,14598,0.0002,9,132,0.0000,0,0
2021-02-08,Brazil,203070494,Acre,830018,0.0187,882,15480,0.0002,66,198,0.0000,0,0
2021-02-09,Brazil,203070494,Acre,830018,0.0192,430,15910,0.0003,64,262,0.0000,0,0
2021-02-10,Brazil,203070494,Acre,830018,0.0200,705,16615,0.0004,89,351,0.0000,0,0
2021-02-11,Brazil,203070494,Acre,830018,0.0207,532,17147,0.0005,65,416,0.0000,0,0
2021-02-12,Brazil,203070494,Acre,830018,0.0214,617,17764,0.0007,138,554,0.0000,0,0
2021-02-13,Brazil,203070494,Acre,830018,0.0216,134,17898,0.0009,187,741,0.0000,0,0
2021-02-14,Brazil,203070494,Acre,830018,0.0217,136,18034,0.0009,39,780,0.0000,0,0
2021-02-15,Brazil,203070494,Acre,830018,0.0221,304,18338,0.0012,219,999,0.0000,0,0
2021-02-16,Brazil,203070494,Acre,830018,0.0229,663,19001,0.0015,283,1282,0.0000,0,0
2021-02-17,Brazil,203070494,Acre,830018,0.0234,396,19397,0.0033,1440,2722,0.0000,0,0
2021-02-18,Brazil,203070494,Acre,830018,0.0242,718,20115,0.0050,1427,4149,0.0000,0,0
2021-02-19,Brazil,203070494,Acre,830018,0.0247,389,20504,0.0061,899,5048,0.0000,0,0
2021-02-20,Brazil,203070494,Acre,830018,0.0252,376,20880,0.0064,304,5352,0.0000,0,0
2021-02-21,Brazil,203070494,Acre,830018,0.0253,100,20980,0.0068,271,5623,0.0000,0,0
2021-02-22,Brazil,203070494,Acre,830018,0.0258,439,21419,0.0077,782,6405,0.0000,0,0
2021-02-23,Brazil,203070494,Acre,830018,0.0261,214,21633,0.0085,665,7070,0.0000,0,0
2021-02-24,Brazil,203070494,Acre,830018,0.0263,212,21845,0.0092,550,7620,0.0000,0,0
2021-02-25,Brazil,203070494,Acre,830018,0.0285,1843,23688,0.0096,337,7957,0.0000,0,0
2021-02-26,Brazil,203070494,Acre,830018,0.0320,2893,26581,0.0107,909,8866,0.0000,0,0
2021-02-27,Brazil,203070494,Acre,830018,0.0334,1166,27747,0.0108,118,8984,0.0000,0,0
2021-02-28,Brazil,203070494,Acre,830018,0.0338,326,28073,0.0109,51,9035,0.0000,0,0
2021-03-01,Brazil,203070494,Acre,830018,0.0354,1313,29386,0.0113,319,9354,0.0000,0,0
2021-03-02,Brazil,203070494,Acre,830018,0.0380,2143,31529,0.0118,430,9784,0.0000,0,0
2021-03-03,Brazil,203070494,Acre,830018,0.0401,1766,33295,0.0120,216,10000,0.0000,0,0
2021-03-04,Brazil,203070494,Acre,830018,0.0427,2153,35448,0.0123,209,10209,0.0000,0,0
2021-03-05,Brazil,203070494,Acre,830018,0.0446,1537,36985,0.0125,187,10396,0.0000,0,0
2021-03-06,Brazil,203070494,Acre,830018,0.0448,168,37153,0.0126,43,10439,0.0000,0,0
2021-03-07,Brazil,203070494,Acre,830018,0.0448,23,37176,0.0126,57,10496,0.0000,0,0
2021-03-08,Brazil,203070494,Acre,830018,0.0450,173,37349,0.0128,88,10584,0.0000,0,0
2021-03-09,Brazil,203070494,Acre,830018,0.0460,834,38183,0.0130,216,10800,0.0000,0,0
2021-03-10,Brazil,203070494,Acre,830018,0.0473,1109,39292,0.0137,554,11354,0.0000,0,0
2021-03-11,Brazil,203070494,Acre,830018,0.0496,1897,41189,0.0141,316,11670,0.0000,0,0
2021-03-12,Brazil,203070494,Acre,830018,0.0506,778,41967,0.0144,297,11967,0.0000,0,0
2021-03-13,Brazil,203070494,Acre,830018,0.0507,104,42071,0.0145,68,12035,0.0000,0,0
2021-03-14,Brazil,203070494,Acre,830018,0.0507,33,42104,0.0145,25,12060,0.0000,0,0
2021-03-15,Brazil,203070494,Acre,830018,0.0514,539,42643,0.0149,271,12331,0.0000,0,0
2021-03-16,Brazil,203070494,Acre,830018,0.0522,708,43351,0.0156,600,12931,0.0000,0,0
2021-03-17,Brazil,203070494,Acre,830018,0.0533,849,44200,0.0161,397,13328,0.0000,0,0
2021-03-18,Brazil,203070494,Acre,830018,0.0553,1731,45931,0.0164,321,13649,0.0000,0,0
2021-03-19,Brazil,203070494,Acre,830018,0.0562,702,46633,0.0167,174,13823,0.0000,0,0
2021-03-20,Brazil,203070494,Acre,830018,0.0563,57,46690,0.0167,40,13863,0.0000,0,0
2021-03-21,Brazil,203070494,Acre,830018,0.0563,35,46725,0.0167,37,13900,0.0000,0,0
2021-03-22,Brazil,203070494,Acre,830018,0.0575,980,47705,0.0170,210,14110,0.0000,0,0
2021-03-23,Brazil,203070494,Acre,830018,0.0584,781,48486,0.0173,279,14389,0.0000,0,0
2021-03-24,Brazil,203070494,Acre,830018,0.0607,1870,50356,0.0176,254,14643,0.0000,0,0
2021-03-25,Brazil,203070494,Acre,830018,0.0654,3925,54281,0.0183,511,15154,0.0000,0,0
2021-03-26,Brazil,203070494,Acre,830018,0.0691,3108,57389,0.0186,250,15404,0.0000,0,0
2021-03-27,Brazil,203070494,Acre,830018,0.0695,335,57724,0.0187,99,15503,0.0000,0,0
2021-03-28,Brazil,203070494,Acre,830018,0.0710,1227,58951,0.0187,19,15522,0.0000,0,0
2021-03-29,Brazil,203070494,Acre,830018,0.0745,2910,61861,0.0190,264,15786,0.0000,0,0
2021-03-30,Brazil,203070494,Acre,830018,0.0794,4064,65925,0.0193,229,16015,0.0000,0,0
2021-03-31,Brazil,203070494,Acre,830018,0.0839,3748,69673,0.0195,205,16220,0.0000,0,0
2021-04-01,Brazil,203070494,Acre,830018,0.0874,2864,72537,0.0205,766,16986,0.0000,0,0
2021-04-02,Brazil,203070494,Acre,830018,0.0877,275,72812,0.0207,168,17154,0.0000,0,0
2021-04-03,Brazil,203070494,Acre,830018,0.0893,1291,74103,0.0208,89,17243,0.0000,0,0
2021-04-04,Brazil,203070494,Acre,830018,0.0896,275,74378,0.0208,49,17292,0.0000,0,0
2021-04-05,Brazil,203070494,Acre,830018,0.0919,1928,76306,0.0215,521,17813,0.0000,0,0
2021-04-06,Brazil,203070494,Acre,830018,0.0936,1399,77705,0.0220,447,18260,0.0000,0,0
2021-04-07,Brazil,203070494,Acre,830018,0.0959,1890,79595,0.0229,731,18991,0.0000,0,0
2021-04-08,Brazil,203070494,Acre,830018,0.0972,1060,80655,0.0241,987,19978,0.0000,0,0
2021-04-09,Brazil,203070494,Acre,830018,0.0989,1439,82094,0.0247,521,20499,0.0000,0,0
2021-04-10,Brazil,203070494,Acre,830018,0.1028,3198,85292,0.0249,201,20700,0.0000,0,0
2021-04-11,Brazil,203070494,Acre,830018,0.1032,332,85624,0.0250,21,20721,0.0000,0,0
2021-04-12,Brazil,203070494,Acre,830018,0.1046,1216,86840,0.0257,646,21367,0.0000,0,0
2021-04-13,Brazil,203070494,Acre,830018,0.1058,941,87781,0.0262,405,21772,0.0000,0,0
2021-04-14,Brazil,203070494,Acre,830018,0.1068,830,88611,0.0283,1680,23452,0.0000,0,0
2021-04-15,Brazil,203070494,Acre,830018,0.1073,489,89100,0.0295,997,24449,0.0000,0,0
2021-04-16,Brazil,203070494,Acre,830018,0.1082,690,89790,0.0303,661,25110,0.0000,0,0
2021-04-17,Brazil,203070494,Acre,830018,0.1115,2794,92584,0.0306,316,25426,0.0000,0,0
2021-04-18,Brazil,203070494,Acre,830018,0.1121,498,93082,0.0307,92,25518,0.0000,0,0
2021-04-19,Brazil,203070494,Acre,830018,0.1133,947,94029,0.0313,426,25944,0.0000,0,0
2021-04-20,Brazil,203070494,Acre,830018,0.1142,737,94766,0.0321,691,26635,0.0000,0,0
2021-04-21,Brazil,203070494,Acre,830018,0.1147,470,95236,0.0324,238,26873,0.0000,0,0
2021-04-22,Brazil,203070494,Acre,830018,0.1156,754,95990,0.0334,846,27719,0.0000,0,0
2021-04-23,Brazil,203070494,Acre,830018,0.1164,637,96627,0.0342,676,28395,0.0000,0,0
2021-04-24,Brazil,203070494,Acre,830018,0.1170,517,97144,0.0345,261,28656,0.0000,0,0
2021-04-25,Brazil,203070494,Acre,830018,0.1174,284,97428,0.0347,135,28791,0.0000,0,0
2021-04-26,Brazil,203070494,Acre,830018,0.1182,698,98126,0.0361,1200,29991,0.0000,0,0
2021-04-27,Brazil,203070494,Acre,830018,0.1190,669,98795,0.0385,1968,31959,0.0000,0,0
2021-04-28,Brazil,203070494,Acre,830018,0.1199,712,99507,0.0423,3146,35105,0.0000,0,0
2021-04-29,Brazil,203070494,Acre,830018,0.1206,634,100141,0.0456,2761,37866,0.0000,0,0
2021-04-30,Brazil,203070494,Acre,830018,0.1211,389,100530,0.0469,1039,38905,0.0000,0,0
2021-05-01,Brazil,203070494,Acre,830018,0.1214,209,100739,0.0475,529,39434,0.0000,0,0
2021-05-02,Brazil,203070494,Acre,830018,0.1216,170,100909,0.0477,159,39593,0.0000,0,0
2021-05-03,Brazil,203070494,Acre,830018,0.1232,1337,102246,0.0499,1860,41453,0.0000,0,0
2021-05-04,Brazil,203070494,Acre,830018,0.1252,1640,103886,0.0511,948,42401,0.0000,0,0
2021-05-05,Brazil,203070494,Acre,830018,0.1273,1815,105701,0.0538,2221,44622,0.0000,0,0
2021-05-06,Brazil,203070494,Acre,830018,0.1295,1770,107471,0.0551,1099,45721,0.0000,0,0
2021-05-07,Brazil,203070494,Acre,830018,0.1322,2226,109697,0.0561,883,46604,0.0000,0,0
2021-05-08,Brazil,203070494,Acre,830018,0.1337,1243,110940,0.0570,689,47293,0.0000,0,0
2021-05-09,Brazil,203070494,Acre,830018,0.1337,47,110987,0.0571,105,47398,0.0000,0,0
2021-05-10,Brazil,203070494,Acre,830018,0.1365,2269,113256,0.0590,1548,48946,0.0000,0,0
2021-05-11,Brazil,203070494,Acre,830018,0.1398,2770,116026,0.0601,961,49907,0.0000,0,0
2021-05-12,Brazil,203070494,Acre,830018,0.1431,2755,118781,0.0611,822,50729,0.0000,0,0
2021-05-13,Brazil,203070494,Acre,830018,0.1468,3062,121843,0.0618,588,51317,0.0000,0,0
2021-05-14,Brazil,203070494,Acre,830018,0.1493,2074,123917,0.0625,567,51884,0.0000,0,0
2021-05-15,Brazil,203070494,Acre,830018,0.1523,2498,126415,0.0633,631,52515,0.0000,0,0
2021-05-16,Brazil,203070494,Acre,830018,0.1526,247,126662,0.0634,83,52598,0.0000,0,0
2021-05-17,Brazil,203070494,Acre,830018,0.1557,2562,129224,0.0641,582,53180,0.0000,0,0
2021-05-18,Brazil,203070494,Acre,830018,0.1585,2328,131552,0.0648,574,53754,0.0000,0,0
2021-05-19,Brazil,203070494,Acre,830018,0.1611,2136,133688,0.0653,428,54182,0.0000,0,0
2021-05-20,Brazil,203070494,Acre,830018,0.1642,2572,136260,0.0661,679,54861,0.0000,0,0
2021-05-21,Brazil,203070494,Acre,830018,0.1674,2698,138958,0.0666,389,55250,0.0000,0,0
2021-05-22,Brazil,203070494,Acre,830018,0.1679,441,139399,0.0668,165,55415,0.0000,0,0
2021-05-23,Brazil,203070494,Acre,830018,0.1680,46,139445,0.0668,33,55448,0.0000,0,0
2021-05-24,Brazil,203070494,Acre,830018,0.1696,1349,140794,0.0672,291,55739,0.0000,0,0
2021-05-25,Brazil,203070494,Acre,830018,0.1714,1489,142283,0.0683,989,56728,0.0000,0,0
2021-05-26,Brazil,203070494,Acre,830018,0.1730,1333,143616,0.0703,1644,58372,0.0000,0,0
2021-05-27,Brazil,203070494,Acre,830018,0.1743,1083,144699,0.0724,1731,60103,0.0000,0,0
2021-05-28,Brazil,203070494,Acre,830018,0.1758,1183,145882,0.0734,797,60900,0.0000,0,0
2021-05-29,Brazil,203070494,Acre,830018,0.1778,1723,147605,0.0738,380,61280,0.0000,0,0
2021-05-30,Brazil,203070494,Acre,830018,0.1779,73,147678,0.0739,22,61302,0.0000,0,0
2021-05-31,Brazil,203070494,Acre,830018,0.1796,1407,149085,0.0755,1394,62696,0.0000,0,0
2021-06-01,Brazil,203070494,Acre,830018,0.1825,2364,151449,0.0769,1150,63846,0.0000,0,0
2021-06-02,Brazil,203070494,Acre,830018,0.1867,3542,154991,0.0791,1820,65666,0.0000,0,0
2021-06-03,Brazil,203070494,Acre,830018,0.1879,962,155953,0.0796,362,66028,0.0000,0,0
2021-06-04,Brazil,203070494,Acre,830018,0.1896,1425,157378,0.0809,1157,67185,0.0000,0,0
2021-06-05,Brazil,203070494,Acre,830018,0.1905,764,158142,0.0814,401,67586,0.0000,0,0
2021-06-06,Brazil,203070494,Acre,830018,0.1906,83,158225,0.0815,24,67610,0.0000,0,0
2021-06-07,Brazil,203070494,Acre,830018,0.1937,2542,160767,0.0831,1387,68997,0.0000,0,0
2021-06-08,Brazil,203070494,Acre,830018,0.1977,3327,164094,0.0839,603,69600,0.0000,0,0
2021-06-09,Brazil,203070494,Acre,830018,0.2026,4107,168201,0.0845,518,70118,0.0000,0,0
2021-06-10,Brazil,203070494,Acre,830018,0.2076,4086,172287,0.0851,476,70594,0.0000,0,0
2021-06-11,Brazil,203070494,Acre,830018,0.2119,3558,175845,0.0855,356,70950,0.0000,0,0
2021-06-12,Brazil,203070494,Acre,830018,0.2147,2367,178212,0.0857,174,71124,0.0000,0,0
2021-06-13,Brazil,203070494,Acre,830018,0.2148,114,178326,0.0858,73,71197,0.0000,0,0
2021-06-14,Brazil,203070494,Acre,830018,0.2210,5139,183465,0.0863,425,71622,0.0000,0,0
2021-06-15,Brazil,203070494,Acre,830018,0.2262,4304,187769,0.0864,67,71689,0.0000,0,0
2021-06-16,Brazil,203070494,Acre,830018,0.2369,8824,196593,0.0871,643,72332,0.0000,0,0
2021-06-17,Brazil,203070494,Acre,830018,0.2486,9722,206315,0.0876,382,72714,0.0000,0,0
2021-06-18,Brazil,203070494,Acre,830018,0.2657,14249,220564,0.0880,360,73074,0.0000,0,0
2021-06-19,Brazil,203070494,Acre,830018,0.2772,9518,230082,0.0882,174,73248,0.0000,0,0
2021-06-20,Brazil,203070494,Acre,830018,0.2819,3924,234006,0.0883,12,73260,0.0000,0,0
2021-06-21,Brazil,203070494,Acre,830018,0.2919,8268,242274,0.0888,459,73719,0.0000,0,0
2021-06-22,Brazil,203070494,Acre,830018,0.3015,7958,250232,0.0899,901,74620,0.0000,0,0
2021-06-23,Brazil,203070494,Acre,830018,0.3112,8093,258325,0.0912,1095,75715,0.0000,0,0
2021-06-24,Brazil,203070494,Acre,830018,0.3143,2532,260857,0.0927,1215,76930,0.0000,0,0
2021-06-25,Brazil,203070494,Acre,830018,0.3209,5487,266344,0.0974,3874,80804,0.0000,0,0
2021-06-26,Brazil,203070494,Acre,830018,0.3306,8085,274429,0.1008,2881,83685,0.0000,0,0
2021-06-27,Brazil,203070494,Acre,830018,0.3307,34,274463,0.1008,8,83693,0.0000,0,0
2021-06-28,Brazil,203070494,Acre,830018,0.3373,5513,279976,0.1040,2628,86321,0.0000,0,0
2021-06-29,Brazil,203070494,Acre,830018,0.3427,4444,284420,0.1066,2153,88474,0.0000,0,0
2021-06-30,Brazil,203070494,Acre,830018,0.3488,5109,289529,0.1098,2663,91137,0.0000,0,0
2021-07-01,Brazil,203070494,Acre,830018,0.3541,4415,293944,0.1119,1772,92909,0.0000,0,0
2021-07-02,Brazil,203070494,Acre,830018,0.3619,6399,300343,0.1137,1485,94394,0.0000,0,0
2021-07-03,Brazil,203070494,Acre,830018,0.3672,4423,304766,0.1145,635,95029,0.0000,0,0
2021-07-04,Brazil,203070494,Acre,830018,0.3722,4156,308922,0.1147,188,95217,0.0000,0,0
2021-07-05,Brazil,203070494,Acre,830018,0.3804,6810,315732,0.1175,2302,97519,0.0000,0,0
2021-07-06,Brazil,203070494,Acre,830018,0.3882,6469,322201,0.1198,1896,99415,0.0000,0,0
2021-07-07,Brazil,203070494,Acre,830018,0.3945,5252,327453,0.1215,1438,100853,0.0000,0,0
2021-07-08,Brazil,203070494,Acre,830018,0.3985,3337,330790,0.1229,1121,101974,0.0000,0,0
2021-07-09,Brazil,203070494,Acre,830018,0.4036,4230,335020,0.1243,1176,103150,0.0000,0,0
2021-07-10,Brazil,203070494,Acre,830018,0.4075,3235,338255,0.1248,422,103572,0.0000,0,0
2021-07-11,Brazil,203070494,Acre,830018,0.4076,52,338307,0.1248,28,103600,0.0000,0,0
2021-07-12,Brazil,203070494,Acre,830018,0.4133,4710,343017,0.1269,1728,105328,0.0000,0,0
2021-07-13,Brazil,203070494,Acre,830018,0.4166,2787,345804,0.1287,1518,106846,0.0000,0,0
2021-07-14,Brazil,203070494,Acre,830018,0.4190,1965,347769,0.1303,1340,108186,0.0000,0,0
2021-07-15,Brazil,203070494,Acre,830018,0.4204,1190,348959,0.1315,965,109151,0.0000,0,0
2021-07-16,Brazil,203070494,Acre,830018,0.4226,1769,350728,0.1334,1565,110716,0.0000,0,0
2021-07-17,Brazil,203070494,Acre,830018,0.4269,3612,354340,0.1341,587,111303,0.0000,0,0
2021-07-18,Brazil,203070494,Acre,830018,0.4270,105,354445,0.1342,115,111418,0.0000,0,0
2021-07-19,Brazil,203070494,Acre,830018,0.4329,4847,359292,0.1365,1866,113284,0.0000,0,0
2021-07-20,Brazil,203070494,Acre,830018,0.4391,5155,364447,0.1386,1722,115006,0.0000,0,0
2021-07-21,Brazil,203070494,Acre,830018,0.4411,1634,366081,0.1406,1718,116724,0.0000,0,0
2021-07-22,Brazil,203070494,Acre,830018,0.4427,1405,367486,0.1426,1601,118325,0.0000,0,0
2021-07-23,Brazil,203070494,Acre,830018,0.4589,13409,380895,0.1452,2206,120531,0.0000,0,0
2021-07-24,Brazil,203070494,Acre,830018,0.4656,5526,386421,0.1471,1533,122064,0.0000,0,0
2021-07-25,Brazil,203070494,Acre,830018,0.4666,850,387271,0.1474,298,122362,0.0000,0,0
2021-07-26,Brazil,203070494,Acre,830018,0.4756,7472,394743,0.1511,3031,125393,0.0000,0,0
2021-07-27,Brazil,203070494,Acre,830018,0.4836,6659,401402,0.1545,2867,128260,0.0000,0,0
2021-07-28,Brazil,203070494,Acre,830018,0.4885,4077,405479,0.1571,2134,130394,0.0000,0,0
2021-07-29,Brazil,203070494,Acre,830018,0.4918,2744,408223,0.1596,2083,132477,0.0000,0,0
2021-07-30,Brazil,203070494,Acre,830018,0.4950,2620,410843,0.1624,2334,134811,0.0000,0,0
2021-07-31,Brazil,203070494,Acre,830018,0.5023,6062,416905,0.1637,1104,135915,0.0000,0,0
2021-08-01,Brazil,203070494,Acre,830018,0.5025,144,417049,0.1640,169,136084,0.0000,0,0
2021-08-02,Brazil,203070494,Acre,830018,0.5064,3251,420300,0.1697,4759,140843,0.0000,0,0
2021-08-03,Brazil,203070494,Acre,830018,0.5098,2861,423161,0.1757,4982,145825,0.0000,0,0
2021-08-04,Brazil,203070494,Acre,830018,0.5147,4074,427235,0.1808,4253,150078,0.0000,0,0
2021-08-05,Brazil,203070494,Acre,830018,0.5192,3689,430924,0.1876,5633,155711,0.0000,0,0
2021-08-06,Brazil,203070494,Acre,830018,0.5262,5799,436723,0.1897,1775,157486,0.0000,0,0
2021-08-07,Brazil,203070494,Acre,830018,0.5296,2838,439561,0.1919,1787,159273,0.0000,0,0
2021-08-08,Brazil,203070494,Acre,830018,0.5299,278,439839,0.1924,451,159724,0.0000,0,0
2021-08-09,Brazil,203070494,Acre,830018,0.5418,9839,449678,0.1991,5514,165238,0.0000,0,0
2021-08-10,Brazil,203070494,Acre,830018,0.5501,6925,456603,0.2049,4814,170052,0.0000,0,0
2021-08-11,Brazil,203070494,Acre,830018,0.5570,5737,462340,0.2107,4839,174891,0.0000,0,0
2021-08-12,Brazil,203070494,Acre,830018,0.5669,8184,470524,0.2151,3631,178522,0.0000,0,0
2021-08-13,Brazil,203070494,Acre,830018,0.5753,6997,477521,0.2195,3657,182179,0.0000,0,0
2021-08-14,Brazil,203070494,Acre,830018,0.5798,3735,481256,0.2209,1140,183319,0.0000,0,0
2021-08-15,Brazil,203070494,Acre,830018,0.5801,274,481530,0.2209,73,183392,0.0000,0,0
2021-08-16,Brazil,203070494,Acre,830018,0.5863,5070,486600,0.2260,4223,187615,0.0000,0,0
2021-08-17,Brazil,203070494,Acre,830018,0.5927,5337,491937,0.2300,3254,190869,0.0000,0,0
2021-08-18,Brazil,203070494,Acre,830018,0.5974,3890,495827,0.2333,2768,193637,0.0000,0,0
2021-08-19,Brazil,203070494,Acre,830018,0.6012,3175,499002,0.2359,2187,195824,0.0000,0,0
2021-08-20,Brazil,203070494,Acre,830018,0.6051,3254,502256,0.2390,2524,198348,0.0000,0,0
2021-08-21,Brazil,203070494,Acre,830018,0.6063,959,503215,0.2400,847,199195,0.0000,0,0
2021-08-22,Brazil,203070494,Acre,830018,0.6065,216,503431,0.2401,66,199261,0.0000,0,0
2021-08-23,Brazil,203070494,Acre,830018,0.6106,3360,506791,0.2451,4173,203434,0.0000,0,0
2021-08-24,Brazil,203070494,Acre,830018,0.6143,3128,509919,0.2488,3062,206496,0.0000,0,0
2021-08-25,Brazil,203070494,Acre,830018,0.6183,3318,513237,0.2522,2841,209337,0.0000,0,0
2021-08-26,Brazil,203070494,Acre,830018,0.6215,2626,515863,0.2568,3814,213151,0.0000,0,0
2021-08-27,Brazil,203070494,Acre,830018,0.6243,2354,518217,0.2606,3164,216315,0.0000,0,0
2021-08-28,Brazil,203070494,Acre,830018,0.6254,917,519134,0.2613,607,216922,0.0000,0,0
2021-08-29,Brazil,203070494,Acre,830018,0.6255,70,519204,0.2614,36,216958,0.0000,0,0
2021-08-30,Brazil,203070494,Acre,830018,0.6285,2488,521692,0.2673,4924,221882,0.0000,0,0
2021-08-31,Brazil,203070494,Acre,830018,0.6313,2296,523988,0.2729,4626,226508,0.0000,0,0
2021-09-01,Brazil,203070494,Acre,830018,0.6340,2208,526196,0.2778,4074,230582,0.0000,0,0
2021-09-02,Brazil,203070494,Acre,830018,0.6359,1631,527827,0.2817,3274,233856,0.0000,0,0
2021-09-03,Brazil,203070494,Acre,830018,0.6379,1639,529466,0.2868,4178,238034,0.0000,0,0
2021-09-04,Brazil,203070494,Acre,830018,0.6384,449,529915,0.2882,1148,239182,0.0000,0,0
2021-09-05,Brazil,203070494,Acre,830018,0.6385,76,529991,0.2882,44,239226,0.0000,0,0
2021-09-06,Brazil,203070494,Acre,830018,0.6392,592,530583,0.2903,1766,240992,0.0000,0,0
2021-09-07,Brazil,203070494,Acre,830018,0.6398,447,531030,0.2916,1055,242047,0.0000,0,0
2021-09-08,Brazil,203070494,Acre,830018,0.6419,1769,532799,0.2972,4663,246710,0.0000,0,0
2021-09-09,Brazil,203070494,Acre,830018,0.6436,1398,534197,0.3026,4471,251181,0.0000,0,0
2021-09-10,Brazil,203070494,Acre,830018,0.6453,1379,535576,0.3072,3766,254947,0.0000,0,0
2021-09-11,Brazil,203070494,Acre,830018,0.6459,545,536121,0.3088,1389,256336,0.0000,0,0
2021-09-12,Brazil,203070494,Acre,830018,0.6460,70,536191,0.3089,63,256399,0.0000,0,0
2021-09-13,Brazil,203070494,Acre,830018,0.6479,1557,537748,0.3147,4847,261246,0.0000,0,0
2021-09-14,Brazil,203070494,Acre,830018,0.6498,1618,539366,0.3203,4591,265837,0.0000,0,0
2021-09-15,Brazil,203070494,Acre,830018,0.6523,2039,541405,0.3252,4111,269948,0.0000,0,0
2021-09-16,Brazil,203070494,Acre,830018,0.6540,1391,542796,0.3303,4248,274196,0.0000,0,0
2021-09-17,Brazil,203070494,Acre,830018,0.6555,1312,544108,0.3354,4200,278396,0.0000,0,0
2021-09-18,Brazil,203070494,Acre,830018,0.6560,367,544475,0.3371,1377,279773,0.0000,0,0
2021-09-19,Brazil,203070494,Acre,830018,0.6561,82,544557,0.3372,138,279911,0.0000,0,0
2021-09-20,Brazil,203070494,Acre,830018,0.6578,1467,546024,0.3432,4939,284850,0.0000,0,0
2021-09-21,Brazil,203070494,Acre,830018,0.6592,1120,547144,0.3489,4709,289559,0.0000,0,0
2021-09-22,Brazil,203070494,Acre,830018,0.6606,1186,548330,0.3540,4270,293829,0.0000,0,0
2021-09-23,Brazil,203070494,Acre,830018,0.6618,946,549276,0.3582,3467,297296,0.0000,0,0
2021-09-24,Brazil,203070494,Acre,830018,0.6633,1249,550525,0.3632,4167,301463,0.0000,0,0
2021-09-25,Brazil,203070494,Acre,830018,0.6635,209,550734,0.3640,696,302159,0.0000,0,0
2021-09-26,Brazil,203070494,Acre,830018,0.6636,50,550784,0.3641,77,302236,0.0000,0,0
2021-09-27,Brazil,203070494,Acre,830018,0.6648,1011,551795,0.3683,3454,305690,0.0000,0,0
2021-09-28,Brazil,203070494,Acre,830018,0.6659,915,552710,0.3734,4240,309930,0.0000,0,0
2021-09-29,Brazil,203070494,Acre,830018,0.6673,1135,553845,0.3794,4950,314880,0.0000,0,0
2021-09-30,Brazil,203070494,Acre,830018,0.6685,999,554844,0.3844,4163,319043,0.0000,0,0
2021-10-01,Brazil,203070494,Acre,830018,0.6696,903,555747,0.3892,3996,323039,0.0000,0,0
2021-10-02,Brazil,203070494,Acre,830018,0.6704,682,556429,0.3955,5257,328296,0.0000,0,0
2021-10-03,Brazil,203070494,Acre,830018,0.6704,14,556443,0.3955,7,328303,0.0000,0,0
2021-10-04,Brazil,203070494,Acre,830018,0.6713,782,557225,0.3996,3353,331656,0.0000,0,0
2021-10-05,Brazil,203070494,Acre,830018,0.6723,830,558055,0.4035,3217,334873,0.0000,0,0
2021-10-06,Brazil,203070494,Acre,830018,0.6734,913,558968,0.4078,3631,338504,0.0000,0,0
2021-10-07,Brazil,203070494,Acre,830018,0.6744,819,559787,0.4113,2860,341364,0.0000,0,0
2021-10-08,Brazil,203070494,Acre,830018,0.6755,893,560680,0.4157,3709,345073,0.0000,0,0
2021-10-09,Brazil,203070494,Acre,830018,0.6770,1235,561915,0.4225,5622,350695,0.0000,0,0
2021-10-10,Brazil,203070494,Acre,830018,0.6771,51,561966,0.4227,186,350881,0.0000,0,0
2021-10-11,Brazil,203070494,Acre,830018,0.6773,179,562145,0.4238,894,351775,0.0000,0,0
2021-10-12,Brazil,203070494,Acre,830018,0.6773,59,562204,0.4244,511,352286,0.0000,0,0
2021-10-13,Brazil,203070494,Acre,830018,0.6784,879,563083,0.4286,3482,355768,0.0000,0,0
2021-10-14,Brazil,203070494,Acre,830018,0.6793,764,563847,0.4320,2787,358555,0.0000,0,0
2021-10-15,Brazil,203070494,Acre,830018,0.6800,556,564403,0.4347,2287,360842,0.0000,0,0
2021-10-16,Brazil,203070494,Acre,830018,0.6804,309,564712,0.4367,1597,362439,0.0000,0,0
2021-10-17,Brazil,203070494,Acre,830018,0.6804,8,564720,0.4367,7,362446,0.0000,0,0
2021-10-18,Brazil,203070494,Acre,830018,0.6813,733,565453,0.4402,2925,365371,0.0000,0,0
2021-10-19,Brazil,203070494,Acre,830018,0.6820,602,566055,0.4438,2967,368338,0.0000,0,0
2021-10-20,Brazil,203070494,Acre,830018,0.6828,645,566700,0.4469,2597,370935,0.0000,0,0
2021-10-21,Brazil,203070494,Acre,830018,0.6834,510,567210,0.4497,2312,373247,0.0000,0,0
2021-10-22,Brazil,203070494,Acre,830018,0.6841,580,567790,0.4527,2536,375783,0.0000,0,0
2021-10-23,Brazil,203070494,Acre,830018,0.6843,202,567992,0.4542,1210,376993,0.0000,0,0
2021-10-24,Brazil,203070494,Acre,830018,0.6843,1,567993,0.4542,6,376999,0.0000,0,0
2021-10-25,Brazil,203070494,Acre,830018,0.6850,555,568548,0.4569,2204,379203,0.0000,0,0
2021-10-26,Brazil,203070494,Acre,830018,0.6859,795,569343,0.4601,2724,381927,0.0000,0,0
2021-10-27,Brazil,203070494,Acre,830018,0.6867,594,569937,0.4634,2696,384623,0.0000,0,0
2021-10-28,Brazil,203070494,Acre,830018,0.6872,469,570406,0.4659,2120,386743,0.0000,0,0
2021-10-29,Brazil,203070494,Acre,830018,0.6874,118,570524,0.4667,623,387366,0.0000,0,0
2021-10-30,Brazil,203070494,Acre,830018,0.6875,97,570621,0.4673,503,387869,0.0000,0,0
2021-10-31,Brazil,203070494,Acre,830018,0.6875,26,570647,0.4675,127,387996,0.0000,0,0
2021-11-01,Brazil,203070494,Acre,830018,0.6877,117,570764,0.4682,616,388612,0.0000,0,0
2021-11-02,Brazil,203070494,Acre,830018,0.6877,63,570827,0.4683,84,388696,0.0000,0,0
2021-11-03,Brazil,203070494,Acre,830018,0.6888,911,571738,0.4711,2343,391039,0.0000,0,0
2021-11-04,Brazil,203070494,Acre,830018,0.6897,700,572438,0.4743,2609,393648,0.0000,0,0
2021-11-05,Brazil,203070494,Acre,830018,0.6904,610,573048,0.4769,2228,395876,0.0000,0,0
2021-11-06,Brazil,203070494,Acre,830018,0.6908,355,573403,0.4780,896,396772,0.0000,0,0
2021-11-07,Brazil,203070494,Acre,830018,0.6910,102,573505,0.4781,96,396868,0.0000,0,0
2021-11-08,Brazil,203070494,Acre,830018,0.6917,645,574150,0.4815,2806,399674,0.0000,0,0
2021-11-09,Brazil,203070494,Acre,830018,0.6925,657,574807,0.4847,2618,402292,0.0000,0,0
2021-11-10,Brazil,203070494,Acre,830018,0.6931,507,575314,0.4876,2384,404676,0.0000,0,0
2021-11-11,Brazil,203070494,Acre,830018,0.6937,481,575795,0.4903,2300,406976,0.0000,0,0
2021-11-12,Brazil,203070494,Acre,830018,0.6943,485,576280,0.4931,2321,409297,0.0000,0,0
2021-11-13,Brazil,203070494,Acre,830018,0.6948,401,576681,0.4939,660,409957,0.0000,0,0
2021-11-14,Brazil,203070494,Acre,830018,0.6948,55,576736,0.4940,57,410014,0.0000,0,0
2021-11-15,Brazil,203070494,Acre,830018,0.6950,102,576838,0.4941,77,410091,0.0000,0,0
2021-11-16,Brazil,203070494,Acre,830018,0.6951,144,576982,0.4951,843,410934,0.0000,0,0
2021-11-17,Brazil,203070494,Acre,830018,0.6959,633,577615,0.4987,3001,413935,0.0000,0,0
2021-11-18,Brazil,203070494,Acre,830018,0.6965,527,578142,0.5016,2432,416367,0.0000,0,0
2021-11-19,Brazil,203070494,Acre,830018,0.6972,566,578708,0.5044,2263,418630,0.0000,0,0
2021-11-20,Brazil,203070494,Acre,830018,0.6979,600,579308,0.5083,3287,421917,0.0000,0,0
2021-11-21,Brazil,203070494,Acre,830018,0.6980,38,579346,0.5083,10,421927,0.0000,0,0
2021-11-22,Brazil,203070494,Acre,830018,0.6988,631,579977,0.5112,2402,424329,0.0000,0,0
2021-11-23,Brazil,203070494,Acre,830018,0.6994,516,580493,0.5137,2049,426378,0.0000,0,0
2021-11-24,Brazil,203070494,Acre,830018,0.7001,562,581055,0.5162,2082,428460,0.0000,0,0
2021-11-25,Brazil,203070494,Acre,830018,0.7008,600,581655,0.5191,2435,430895,0.0000,0,0
2021-11-26,Brazil,203070494,Acre,830018,0.7014,554,582209,0.5215,1965,432860,0.0000,0,0
2021-11-27,Brazil,203070494,Acre,830018,0.7016,120,582329,0.5221,477,433337,0.0000,0,0
2021-11-28,Brazil,203070494,Acre,830018,0.7017,74,582403,0.5222,71,433408,0.0000,0,0
2021-11-29,Brazil,203070494,Acre,830018,0.7026,747,583150,0.5252,2539,435947,0.0000,0,0
2021-11-30,Brazil,203070494,Acre,830018,0.7036,832,583982,0.5282,2485,438432,0.0000,0,0
2021-12-01,Brazil,203070494,Acre,830018,0.7048,1025,585007,0.5316,2778,441210,0.0000,0,0
2021-12-02,Brazil,203070494,Acre,830018,0.7058,814,585821,0.5342,2204,443414,0.0000,0,0
2021-12-03,Brazil,203070494,Acre,830018,0.7067,761,586582,0.5366,1978,445392,0.0000,0,0
2021-12-04,Brazil,203070494,Acre,830018,0.7072,367,586949,0.5377,928,446320,0.0000,0,0
2021-12-05,Brazil,203070494,Acre,830018,0.7072,62,587011,0.5378,86,446406,0.0000,0,0
2021-12-06,Brazil,203070494,Acre,830018,0.7083,925,587936,0.5403,2074,448480,0.0000,0,0
2021-12-07,Brazil,203070494,Acre,830018,0.7095,968,588904,0.5431,2301,450781,0.0000,0,0
2021-12-08,Brazil,203070494,Acre,830018,0.7105,817,589721,0.5454,1926,452707,0.0000,0,0
2021-12-09,Brazil,203070494,Acre,830018,0.7116,912,590633,0.5479,2052,454759,0.0000,0,0
2021-12-10,Brazil,203070494,Acre,830018,0.7126,853,591486,0.5501,1833,456592,0.0000,0,0
2021-12-11,Brazil,203070494,Acre,830018,0.7130,304,591790,0.5508,604,457196,0.0000,0,0
2021-12-12,Brazil,203070494,Acre,830018,0.7130,38,591828,0.5508,19,457215,0.0000,0,0
2021-12-13,Brazil,203070494,Acre,830018,0.7143,1044,592872,0.5532,1910,459125,0.0000,0,0
2021-12-14,Brazil,203070494,Acre,830018,0.7155,968,593840,0.5553,1804,460929,0.0000,0,0
2021-12-15,Brazil,203070494,Acre,830018,0.7165,902,594742,0.5576,1913,462842,0.0000,0,0
2021-12-16,Brazil,203070494,Acre,830018,0.7173,653,595395,0.5593,1365,464207,0.0000,0,0
2021-12-17,Brazil,203070494,Acre,830018,0.7182,700,596095,0.5611,1544,465751,0.0000,0,0
2021-12-18,Brazil,203070494,Acre,830018,0.7185,246,596341,0.5618,594,466345,0.0000,0,0
2021-12-19,Brazil,203070494,Acre,830018,0.7186,83,596424,0.5621,197,466542,0.0000,0,0
2021-12-20,Brazil,203070494,Acre,830018,0.7195,796,597220,0.5638,1433,467975,0.0000,0,0
2021-12-21,Brazil,203070494,Acre,830018,0.7203,602,597822,0.5655,1392,469367,0.0000,0,0
2021-12-22,Brazil,203070494,Acre,830018,0.7210,630,598452,0.5672,1448,470815,0.0000,0,0
2021-12-23,Brazil,203070494,Acre,830018,0.7216,452,598904,0.5685,1021,471836,0.0000,0,0
2021-12-24,Brazil,203070494,Acre,830018,0.7216,44,598948,0.5686,124,471960,0.0000,0,0
2021-12-25,Brazil,203070494,Acre,830018,0.7216,1,598949,0.5686,0,471960,0.0000,0,0
2021-12-26,Brazil,203070494,Acre,830018,0.7216,12,598961,0.5686,22,471982,0.0000,0,0
2021-12-27,Brazil,203070494,Acre,830018,0.7219,258,599219,0.5694,661,472643,0.0000,0,0
2021-12-28,Brazil,203070494,Acre,830018,0.7223,318,599537,0.5705,847,473490,0.0000,0,0
2021-12-29,Brazil,203070494,Acre,830018,0.7227,279,599816,0.5715,886,474376,0.0000,0,0
2021-12-30,Brazil,203070494,Acre,830018,0.7230,250,600066,0.5723,680,475056,0.0000,0,0
2021-12-31,Brazil,203070494,Acre,830018,0.7230,37,600103,0.5725,96,475152,0.0000,0,0
2021-01-17,Brazil,203070494,Alagoas,3127683,0.0000,11,11,0.0000,1,1,0.0000,0,0
2021-01-18,Brazil,203070494,Alagoas,3127683,0.0000,11,22,0.0000,6,7,0.0000,0,0
2021-01-19,Brazil,203070494,Alagoas,3127683,0.0002,486,508,0.0000,3,10,0.0000,0,0
2021-01-20,Brazil,203070494,Alagoas,3127683,0.0008,2104,2612,0.0000,10,20,0.0000,0,0
2021-01-21,Brazil,203070494,Alagoas,3127683,0.0021,4012,6624,0.0000,7,27,0.0000,0,0
2021-01-22,Brazil,203070494,Alagoas,3127683,0.0039,5580,12204,0.0000,12,39,0.0000,0,0
2021-01-23,Brazil,203070494,Alagoas,3127683,0.0046,2041,14245,0.0000,6,45,0.0000,0,0
2021-01-24,Brazil,203070494,Alagoas,3127683,0.0046,167,14412,0.0000,2,47,0.0000,0,0
2021-01-25,Brazil,203070494,Alagoas,3127683,0.0061,4545,18957,0.0000,11,58,0.0000,0,0
2021-01-26,Brazil,203070494,Alagoas,3127683,0.0074,4344,23301,0.0000,1,59,0.0000,0,0
2021-01-27,Brazil,203070494,Alagoas,3127683,0.0087,3976,27277,0.0000,0,59,0.0000,0,0
2021-01-28,Brazil,203070494,Alagoas,3127683,0.0106,5981,33258,0.0000,6,65,0.0000,0,0
2021-01-29,Brazil,203070494,Alagoas,3127683,0.0117,3369,36627,0.0000,8,73,0.0000,0,0
2021-01-30,Brazil,203070494,Alagoas,3127683,0.0120,1022,37649,0.0000,0,73,0.0000,0,0
2021-01-31,Brazil,203070494,Alagoas,3127683,0.0122,516,38165,0.0000,0,73,0.0000,0,0
2021-02-01,Brazil,203070494,Alagoas,3127683,0.0130,2611,40776,0.0000,9,82,0.0000,0,0
2021-02-02,Brazil,203070494,Alagoas,3127683,0.0141,3386,44162,0.0000,2,84,0.0000,0,0
2021-02-03,Brazil,203070494,Alagoas,3127683,0.0157,5032,49194,0.0000,9,93,0.0000,0,0
2021-02-04,Brazil,203070494,Alagoas,3127683,0.0172,4660,53854,0.0000,14,107,0.0000,0,0
2021-02-05,Brazil,203070494,Alagoas,3127683,0.0182,2958,56812,0.0000,15,122,0.0000,0,0
2021-02-06,Brazil,203070494,Alagoas,3127683,0.0182,119,56931,0.0000,1,123,0.0000,0,0
2021-02-07,Brazil,203070494,Alagoas,3127683,0.0182,38,56969,0.0000,1,124,0.0000,0,0
2021-02-08,Brazil,203070494,Alagoas,3127683,0.0189,2269,59238,0.0000,6,130,0.0000,0,0
2021-02-09,Brazil,203070494,Alagoas,3127683,0.0198,2707,61945,0.0000,3,133,0.0000,0,0
2021-02-10,Brazil,203070494,Alagoas,3127683,0.0205,2022,63967,0.0006,1739,1872,0.0000,0,0
2021-02-11,Brazil,203070494,Alagoas,3127683,0.0212,2198,66165,0.0017,3458,5330,0.0000,0,0
2021-02-12,Brazil,203070494,Alagoas,3127683,0.0218,1965,68130,0.0031,4428,9758,0.0000,0,0
2021-02-13,Brazil,203070494,Alagoas,3127683,0.0219,326,68456,0.0035,1235,10993,0.0000,0,0
2021-02-14,Brazil,203070494,Alagoas,3127683,0.0219,42,68498,0.0036,140,11133,0.0000,0,0
2021-02-15,Brazil,203070494,Alagoas,3127683,0.0220,206,68704,0.0037,552,11685,0.0000,0,0
2021-02-16,Brazil,203070494,Alagoas,3127683,0.0220,88,68792,0.0039,655,12340,0.0000,0,0
2021-02-17,Brazil,203070494,Alagoas,3127683,0.0221,225,69017,0.0042,838,13178,0.0000,0,0
2021-02-18,Brazil,203070494,Alagoas,3127683,0.0226,1680,70697,0.0062,6069,19247,0.0000,0,0
2021-02-19,Brazil,203070494,Alagoas,3127683,0.0230,1325,72022,0.0076,4588,23835,0.0000,0,0
2021-02-20,Brazil,203070494,Alagoas,3127683,0.0231,114,72136,0.0077,101,23936,0.0000,0,0
2021-02-21,Brazil,203070494,Alagoas,3127683,0.0231,37,72173,0.0077,35,23971,0.0000,0,0
2021-02-22,Brazil,203070494,Alagoas,3127683,0.0236,1634,73807,0.0088,3523,27494,0.0000,0,0
2021-02-23,Brazil,203070494,Alagoas,3127683,0.0241,1711,75518,0.0097,2843,30337,0.0000,0,0
2021-02-24,Brazil,203070494,Alagoas,3127683,0.0246,1368,76886,0.0104,2157,32494,0.0000,0,0
2021-02-25,Brazil,203070494,Alagoas,3127683,0.0250,1427,78313,0.0112,2540,35034,0.0000,0,0
2021-02-26,Brazil,203070494,Alagoas,3127683,0.0255,1361,79674,0.0119,2211,37245,0.0000,0,0
2021-02-27,Brazil,203070494,Alagoas,3127683,0.0255,33,79707,0.0119,10,37255,0.0000,0,0
2021-02-28,Brazil,203070494,Alagoas,3127683,0.0255,8,79715,0.0119,9,37264,0.0000,0,0
2021-03-01,Brazil,203070494,Alagoas,3127683,0.0267,3803,83518,0.0124,1567,38831,0.0000,0,0
2021-03-02,Brazil,203070494,Alagoas,3127683,0.0280,3956,87474,0.0131,2007,40838,0.0000,0,0
2021-03-03,Brazil,203070494,Alagoas,3127683,0.0293,4111,91585,0.0137,1879,42717,0.0000,0,0
2021-03-04,Brazil,203070494,Alagoas,3127683,0.0306,4178,95763,0.0142,1630,44347,0.0000,0,0
2021-03-05,Brazil,203070494,Alagoas,3127683,0.0318,3793,99556,0.0145,1153,45500,0.0000,0,0
2021-03-06,Brazil,203070494,Alagoas,3127683,0.0320,377,99933,0.0146,182,45682,0.0000,0,0
2021-03-07,Brazil,203070494,Alagoas,3127683,0.0320,27,99960,0.0146,1,45683,0.0000,0,0
2021-03-08,Brazil,203070494,Alagoas,3127683,0.0332,3826,103786,0.0147,396,46079,0.0000,0,0
2021-03-09,Brazil,203070494,Alagoas,3127683,0.0344,3909,107695,0.0149,455,46534,0.0000,0,0
2021-03-10,Brazil,203070494,Alagoas,3127683,0.0357,3909,111604,0.0151,568,47102,0.0000,0,0
2021-03-11,Brazil,203070494,Alagoas,3127683,0.0376,5853,117457,0.0153,864,47966,0.0000,0,0
2021-03-12,Brazil,203070494,Alagoas,3127683,0.0391,4926,122383,0.0156,917,48883,0.0000,0,0
2021-03-13,Brazil,203070494,Alagoas,3127683,0.0397,1918,124301,0.0156,26,48909,0.0000,0,0
2021-03-14,Brazil,203070494,Alagoas,3127683,0.0399,548,124849,0.0156,15,48924,0.0000,0,0
2021-03-15,Brazil,203070494,Alagoas,3127683,0.0409,2930,127779,0.0161,1324,50248,0.0000,0,0
2021-03-16,Brazil,203070494,Alagoas,3127683,0.0422,4160,131939,0.0165,1512,51760,0.0000,0,0
2021-03-17,Brazil,203070494,Alagoas,3127683,0.0442,6352,138291,0.0169,1202,52962,0.0000,0,0
2021-03-18,Brazil,203070494,Alagoas,3127683,0.0466,7503,145794,0.0172,950,53912,0.0000,0,0
2021-03-19,Brazil,203070494,Alagoas,3127683,0.0499,10212,156006,0.0175,832,54744,0.0000,0,0
2021-03-20,Brazil,203070494,Alagoas,3127683,0.0517,5691,161697,0.0175,66,54810,0.0000,0,0
2021-03-21,Brazil,203070494,Alagoas,3127683,0.0523,1939,163636,0.0175,28,54838,0.0000,0,0
2021-03-22,Brazil,203070494,Alagoas,3127683,0.0554,9585,173221,0.0180,1538,56376,0.0000,0,0
2021-03-23,Brazil,203070494,Alagoas,3127683,0.0600,14437,187658,0.0185,1513,57889,0.0000,0,0
2021-03-24,Brazil,203070494,Alagoas,3127683,0.0659,18347,206005,0.0190,1590,59479,0.0000,0,0
2021-03-25,Brazil,203070494,Alagoas,3127683,0.0717,18107,224112,0.0194,1327,60806,0.0000,0,0
2021-03-26,Brazil,203070494,Alagoas,3127683,0.0765,15058,239170,0.0198,1233,62039,0.0000,0,0
2021-03-27,Brazil,203070494,Alagoas,3127683,0.0802,11554,250724,0.0199,97,62136,0.0000,0,0
2021-03-28,Brazil,203070494,Alagoas,3127683,0.0820,5626,256350,0.0199,19,62155,0.0000,0,0
2021-03-29,Brazil,203070494,Alagoas,3127683,0.0863,13589,269939,0.0202,1153,63308,0.0000,0,0
2021-03-30,Brazil,203070494,Alagoas,3127683,0.0916,16440,286379,0.0208,1753,65061,0.0000,0,0
2021-03-31,Brazil,203070494,Alagoas,3127683,0.0960,13746,300125,0.0216,2347,67408,0.0000,0,0
2021-04-01,Brazil,203070494,Alagoas,3127683,0.0988,8812,308937,0.0224,2623,70031,0.0000,0,0
2021-04-02,Brazil,203070494,Alagoas,3127683,0.0995,2282,311219,0.0230,1848,71879,0.0000,0,0
2021-04-03,Brazil,203070494,Alagoas,3127683,0.1041,14497,325716,0.0235,1643,73522,0.0000,0,0
2021-04-04,Brazil,203070494,Alagoas,3127683,0.1056,4688,330404,0.0237,727,74249,0.0000,0,0
2021-04-05,Brazil,203070494,Alagoas,3127683,0.1110,16666,347070,0.0246,2543,76792,0.0000,0,0
2021-04-06,Brazil,203070494,Alagoas,3127683,0.1161,15969,363039,0.0257,3442,80234,0.0000,0,0
2021-04-07,Brazil,203070494,Alagoas,3127683,0.1210,15529,378568,0.0274,5309,85543,0.0000,0,0
2021-04-08,Brazil,203070494,Alagoas,3127683,0.1236,8022,386590,0.0294,6387,91930,0.0000,0,0
2021-04-09,Brazil,203070494,Alagoas,3127683,0.1254,5503,392093,0.0321,8436,100366,0.0000,0,0
2021-04-10,Brazil,203070494,Alagoas,3127683,0.1276,7106,399199,0.0335,4411,104777,0.0000,0,0
2021-04-11,Brazil,203070494,Alagoas,3127683,0.1291,4524,403723,0.0340,1658,106435,0.0000,0,0
2021-04-12,Brazil,203070494,Alagoas,3127683,0.1310,6140,409863,0.0367,8241,114676,0.0000,0,0
2021-04-13,Brazil,203070494,Alagoas,3127683,0.1338,8715,418578,0.0406,12340,127016,0.0000,0,0
2021-04-14,Brazil,203070494,Alagoas,3127683,0.1363,7587,426165,0.0444,11946,138962,0.0000,0,0
2021-04-15,Brazil,203070494,Alagoas,3127683,0.1376,4342,430507,0.0473,8930,147892,0.0000,0,0
2021-04-16,Brazil,203070494,Alagoas,3127683,0.1385,2695,433202,0.0496,7217,155109,0.0000,0,0
2021-04-17,Brazil,203070494,Alagoas,3127683,0.1394,2762,435964,0.0505,2889,157998,0.0000,0,0
2021-04-18,Brazil,203070494,Alagoas,3127683,0.1399,1549,437513,0.0506,332,158330,0.0000,0,0
2021-04-19,Brazil,203070494,Alagoas,3127683,0.1409,3297,440810,0.0526,6328,164658,0.0000,0,0
2021-04-20,Brazil,203070494,Alagoas,3127683,0.1423,4257,445067,0.0553,8453,173111,0.0000,0,0
2021-04-21,Brazil,203070494,Alagoas,3127683,0.1433,3194,448261,0.0566,3844,176955,0.0000,0,0
2021-04-22,Brazil,203070494,Alagoas,3127683,0.1448,4554,452815,0.0594,8785,185740,0.0000,0,0
2021-04-23,Brazil,203070494,Alagoas,3127683,0.1462,4349,457164,0.0610,5024,190764,0.0000,0,0
2021-04-24,Brazil,203070494,Alagoas,3127683,0.1467,1541,458705,0.0635,7886,198650,0.0000,0,0
2021-04-25,Brazil,203070494,Alagoas,3127683,0.1468,378,459083,0.0642,2114,200764,0.0000,0,0
2021-04-26,Brazil,203070494,Alagoas,3127683,0.1475,2349,461432,0.0650,2581,203345,0.0000,0,0
2021-04-27,Brazil,203070494,Alagoas,3127683,0.1484,2858,464290,0.0661,3477,206822,0.0000,0,0
2021-04-28,Brazil,203070494,Alagoas,3127683,0.1495,3268,467558,0.0671,3145,209967,0.0000,0,0
2021-04-29,Brazil,203070494,Alagoas,3127683,0.1507,3701,471259,0.0681,2943,212910,0.0000,0,0
2021-04-30,Brazil,203070494,Alagoas,3127683,0.1515,2525,473784,0.0688,2130,215040,0.0000,0,0
2021-05-01,Brazil,203070494,Alagoas,3127683,0.1518,1092,474876,0.0700,4037,219077,0.0000,0,0
2021-05-02,Brazil,203070494,Alagoas,3127683,0.1519,357,475233,0.0714,4089,223166,0.0000,0,0
2021-05-03,Brazil,203070494,Alagoas,3127683,0.1530,3166,478399,0.0727,4073,227239,0.0000,0,0
2021-05-04,Brazil,203070494,Alagoas,3127683,0.1542,3953,482352,0.0741,4442,231681,0.0000,0,0
2021-05-05,Brazil,203070494,Alagoas,3127683,0.1561,5969,488321,0.0759,5761,237442,0.0000,0,0
2021-05-06,Brazil,203070494,Alagoas,3127683,0.1588,8359,496680,0.0772,4054,241496,0.0000,0,0
2021-05-07,Brazil,203070494,Alagoas,3127683,0.1620,9879,506559,0.0778,1894,243390,0.0000,0,0
2021-05-08,Brazil,203070494,Alagoas,3127683,0.1646,8268,514827,0.0780,446,243836,0.0000,0,0
2021-05-09,Brazil,203070494,Alagoas,3127683,0.1650,1354,516181,0.0789,2897,246733,0.0000,0,0
2021-05-10,Brazil,203070494,Alagoas,3127683,0.1674,7528,523709,0.0797,2688,249421,0.0000,0,0
2021-05-11,Brazil,203070494,Alagoas,3127683,0.1707,10072,533781,0.0810,3774,253195,0.0000,0,0
2021-05-12,Brazil,203070494,Alagoas,3127683,0.1746,12371,546152,0.0818,2685,255880,0.0000,0,0
2021-05-13,Brazil,203070494,Alagoas,3127683,0.1781,10950,557102,0.0825,2152,258032,0.0000,0,0
2021-05-14,Brazil,203070494,Alagoas,3127683,0.1815,10519,567621,0.0831,1856,259888,0.0000,0,0
2021-05-15,Brazil,203070494,Alagoas,3127683,0.1840,7853,575474,0.0839,2677,262565,0.0000,0,0
2021-05-16,Brazil,203070494,Alagoas,3127683,0.1857,5242,580716,0.0843,1010,263575,0.0000,0,0
2021-05-17,Brazil,203070494,Alagoas,3127683,0.1892,10943,591659,0.0851,2493,266068,0.0000,0,0
2021-05-18,Brazil,203070494,Alagoas,3127683,0.1937,14099,605758,0.0862,3514,269582,0.0000,0,0
2021-05-19,Brazil,203070494,Alagoas,3127683,0.1987,15803,621561,0.0869,2191,271773,0.0000,0,0
2021-05-20,Brazil,203070494,Alagoas,3127683,0.2033,14262,635823,0.0881,3680,275453,0.0000,0,0
2021-05-21,Brazil,203070494,Alagoas,3127683,0.2077,13913,649736,0.0891,3314,278767,0.0000,0,0
2021-05-22,Brazil,203070494,Alagoas,3127683,0.2102,7730,657466,0.0896,1326,280093,0.0000,0,0
2021-05-23,Brazil,203070494,Alagoas,3127683,0.2116,4344,661810,0.0896,171,280264,0.0000,0,0
2021-05-24,Brazil,203070494,Alagoas,3127683,0.2152,11307,673117,0.0906,3086,283350,0.0000,0,0
2021-05-25,Brazil,203070494,Alagoas,3127683,0.2206,16745,689862,0.0916,3112,286462,0.0000,0,0
2021-05-26,Brazil,203070494,Alagoas,3127683,0.2256,15685,705547,0.0924,2685,289147,0.0000,0,0
2021-05-27,Brazil,203070494,Alagoas,3127683,0.2296,12660,718207,0.0931,2032,291179,0.0000,0,0
2021-05-28,Brazil,203070494,Alagoas,3127683,0.2339,13267,731474,0.0937,1951,293130,0.0000,0,0
2021-05-29,Brazil,203070494,Alagoas,3127683,0.2368,9202,740676,0.0939,614,293744,0.0000,0,0
2021-05-30,Brazil,203070494,Alagoas,3127683,0.2383,4521,745197,0.0940,144,293888,0.0000,0,0
2021-05-31,Brazil,203070494,Alagoas,3127683,0.2410,8689,753886,0.0945,1738,295626,0.0000,0,0
2021-06-01,Brazil,203070494,Alagoas,3127683,0.2442,10036,763922,0.0952,2109,297735,0.0000,0,0
2021-06-02,Brazil,203070494,Alagoas,3127683,0.2483,12571,776493,0.0957,1689,299424,0.0000,0,0
2021-06-03,Brazil,203070494,Alagoas,3127683,0.2501,5663,782156,0.0961,1245,300669,0.0000,0,0
2021-06-04,Brazil,203070494,Alagoas,3127683,0.2539,11841,793997,0.0966,1450,302119,0.0000,0,0
2021-06-05,Brazil,203070494,Alagoas,3127683,0.2576,11669,805666,0.0968,717,302836,0.0000,0,0
2021-06-06,Brazil,203070494,Alagoas,3127683,0.2582,1873,807539,0.0969,212,303048,0.0000,0,0
2021-06-07,Brazil,203070494,Alagoas,3127683,0.2609,8602,816141,0.0975,2017,305065,0.0000,0,0
2021-06-08,Brazil,203070494,Alagoas,3127683,0.2639,9197,825338,0.0982,2217,307282,0.0000,0,0
2021-06-09,Brazil,203070494,Alagoas,3127683,0.2668,9172,834510,0.0989,2123,309405,0.0000,0,0
2021-06-10,Brazil,203070494,Alagoas,3127683,0.2715,14734,849244,0.0995,1797,311202,0.0000,0,0
2021-06-11,Brazil,203070494,Alagoas,3127683,0.2762,14682,863926,0.0999,1191,312393,0.0000,0,0
2021-06-12,Brazil,203070494,Alagoas,3127683,0.2789,8327,872253,0.1001,602,312995,0.0000,0,0
2021-06-13,Brazil,203070494,Alagoas,3127683,0.2792,1002,873255,0.1003,860,313855,0.0000,0,0
2021-06-14,Brazil,203070494,Alagoas,3127683,0.2820,8720,881975,0.1012,2637,316492,0.0000,0,0
2021-06-15,Brazil,203070494,Alagoas,3127683,0.2851,9626,891601,0.1026,4456,320948,0.0000,0,0
2021-06-16,Brazil,203070494,Alagoas,3127683,0.2880,9100,900701,0.1041,4493,325441,0.0000,0,0
2021-06-17,Brazil,203070494,Alagoas,3127683,0.2904,7563,908264,0.1058,5375,330816,0.0000,0,0
2021-06-18,Brazil,203070494,Alagoas,3127683,0.2923,6094,914358,0.1075,5266,336082,0.0000,0,0
2021-06-19,Brazil,203070494,Alagoas,3127683,0.2952,8844,923202,0.1083,2514,338596,0.0000,0,0
2021-06-20,Brazil,203070494,Alagoas,3127683,0.2967,4698,927900,0.1089,1879,340475,0.0000,0,0
2021-06-21,Brazil,203070494,Alagoas,3127683,0.2998,9687,937587,0.1103,4509,344984,0.0000,0,0
2021-06-22,Brazil,203070494,Alagoas,3127683,0.3051,16731,954318,0.1116,4164,349148,0.0000,0,0
2021-06-23,Brazil,203070494,Alagoas,3127683,0.3103,16065,970383,0.1125,2821,351969,0.0000,0,0
2021-06-24,Brazil,203070494,Alagoas,3127683,0.3122,6044,976427,0.1131,1838,353807,0.0000,0,0
2021-06-25,Brazil,203070494,Alagoas,3127683,0.3164,13220,989647,0.1140,2756,356563,0.0000,0,0
2021-06-26,Brazil,203070494,Alagoas,3127683,0.3221,17632,1007279,0.1147,2162,358725,0.0000,0,0
2021-06-27,Brazil,203070494,Alagoas,3127683,0.3254,10422,1017701,0.1150,976,359701,0.0000,0,0
2021-06-28,Brazil,203070494,Alagoas,3127683,0.3316,19370,1037071,0.1159,2688,362389,0.0000,0,0
2021-06-29,Brazil,203070494,Alagoas,3127683,0.3347,9787,1046858,0.1166,2314,364703,0.0000,0,0
2021-06-30,Brazil,203070494,Alagoas,3127683,0.3406,18316,1065174,0.1184,5769,370472,0.0000,0,0
2021-07-01,Brazil,203070494,Alagoas,3127683,0.3455,15493,1080667,0.1200,4995,375467,0.0000,0,0
2021-07-02,Brazil,203070494,Alagoas,3127683,0.3507,16314,1096981,0.1210,3023,378490,0.0000,0,0
2021-07-03,Brazil,203070494,Alagoas,3127683,0.3552,13823,1110804,0.1221,3385,381875,0.0000,0,0
2021-07-04,Brazil,203070494,Alagoas,3127683,0.3569,5488,1116292,0.1228,2147,384022,0.0000,0,0
2021-07-05,Brazil,203070494,Alagoas,3127683,0.3625,17524,1133816,0.1243,4654,388676,0.0000,0,0
2021-07-06,Brazil,203070494,Alagoas,3127683,0.3694,21487,1155303,0.1259,5055,393731,0.0000,0,0
2021-07-07,Brazil,203070494,Alagoas,3127683,0.3761,20943,1176246,0.1272,4247,397978,0.0000,0,0
2021-07-08,Brazil,203070494,Alagoas,3127683,0.3807,14397,1190643,0.1282,3071,401049,0.0000,0,0
2021-07-09,Brazil,203070494,Alagoas,3127683,0.3845,12078,1202721,0.1290,2296,403345,0.0000,0,0
2021-07-10,Brazil,203070494,Alagoas,3127683,0.3859,4399,1207120,0.1296,1848,405193,0.0000,0,0
2021-07-11,Brazil,203070494,Alagoas,3127683,0.3871,3592,1210712,0.1298,901,406094,0.0000,0,0
2021-07-12,Brazil,203070494,Alagoas,3127683,0.3896,7942,1218654,0.1310,3685,409779,0.0000,0,0
2021-07-13,Brazil,203070494,Alagoas,3127683,0.3921,7621,1226275,0.1325,4592,414371,0.0000,0,0
2021-07-14,Brazil,203070494,Alagoas,3127683,0.3943,7012,1233287,0.1339,4295,418666,0.0000,0,0
2021-07-15,Brazil,203070494,Alagoas,3127683,0.3958,4615,1237902,0.1349,3321,421987,0.0000,0,0
2021-07-16,Brazil,203070494,Alagoas,3127683,0.3979,6629,1244531,0.1360,3406,425393,0.0000,0,0
2021-07-17,Brazil,203070494,Alagoas,3127683,0.4009,9290,1253821,0.1367,2126,427519,0.0000,0,0
2021-07-18,Brazil,203070494,Alagoas,3127683,0.4013,1433,1255254,0.1368,456,427975,0.0000,0,0
2021-07-19,Brazil,203070494,Alagoas,3127683,0.4033,6073,1261327,0.1380,3632,431607,0.0000,0,0
2021-07-20,Brazil,203070494,Alagoas,3127683,0.4050,5385,1266712,0.1394,4313,435920,0.0000,0,0
2021-07-21,Brazil,203070494,Alagoas,3127683,0.4083,10455,1277167,0.1408,4530,440450,0.0000,0,0
2021-07-22,Brazil,203070494,Alagoas,3127683,0.4141,17889,1295056,0.1424,5058,445508,0.0000,0,0
2021-07-23,Brazil,203070494,Alagoas,3127683,0.4191,15856,1310912,0.1440,4745,450253,0.0000,0,0
2021-07-24,Brazil,203070494,Alagoas,3127683,0.4218,8404,1319316,0.1456,5094,455347,0.0000,0,0
2021-07-25,Brazil,203070494,Alagoas,3127683,0.4223,1357,1320673,0.1462,1828,457175,0.0000,0,0
2021-07-26,Brazil,203070494,Alagoas,3127683,0.4252,9370,1330043,0.1481,5913,463088,0.0000,0,0
2021-07-27,Brazil,203070494,Alagoas,3127683,0.4278,8133,1338176,0.1505,7561,470649,0.0000,0,0
2021-07-28,Brazil,203070494,Alagoas,3127683,0.4318,12290,1350466,0.1532,8577,479226,0.0000,0,0
2021-07-29,Brazil,203070494,Alagoas,3127683,0.4378,18716,1369182,0.1557,7652,486878,0.0000,0,0
2021-07-30,Brazil,203070494,Alagoas,3127683,0.4437,18516,1387698,0.1585,8768,495646,0.0000,0,0
2021-07-31,Brazil,203070494,Alagoas,3127683,0.4492,17155,1404853,0.1597,3997,499643,0.0000,0,0
2021-08-01,Brazil,203070494,Alagoas,3127683,0.4497,1703,1406556,0.1608,3193,502836,0.0000,0,0
2021-08-02,Brazil,203070494,Alagoas,3127683,0.4551,16909,1423465,0.1639,9923,512759,0.0000,0,0
2021-08-03,Brazil,203070494,Alagoas,3127683,0.4617,20439,1443904,0.1669,9379,522138,0.0000,0,0
2021-08-04,Brazil,203070494,Alagoas,3127683,0.4677,19003,1462907,0.1706,11528,533666,0.0000,0,0
2021-08-05,Brazil,203070494,Alagoas,3127683,0.4738,19101,1482008,0.1737,9685,543351,0.0000,0,0
2021-08-06,Brazil,203070494,Alagoas,3127683,0.4790,16137,1498145,0.1766,9094,552445,0.0000,0,0
2021-08-07,Brazil,203070494,Alagoas,3127683,0.4814,7601,1505746,0.1792,8093,560538,0.0000,0,0
2021-08-08,Brazil,203070494,Alagoas,3127683,0.4819,1551,1507297,0.1805,4013,564551,0.0000,0,0
2021-08-09,Brazil,203070494,Alagoas,3127683,0.4864,13881,1521178,0.1844,12201,576752,0.0000,0,0
2021-08-10,Brazil,203070494,Alagoas,3127683,0.4930,20751,1541929,0.1889,13941,590693,0.0000,0,0
2021-08-11,Brazil,203070494,Alagoas,3127683,0.5019,27969,1569898,0.1938,15389,606082,0.0000,0,0
2021-08-12,Brazil,203070494,Alagoas,3127683,0.5106,27059,1596957,0.1982,13671,619753,0.0000,0,0
2021-08-13,Brazil,203070494,Alagoas,3127683,0.5181,23534,1620491,0.2020,11903,631656,0.0000,0,0
2021-08-14,Brazil,203070494,Alagoas,3127683,0.5241,18808,1639299,0.2039,6205,637861,0.0000,0,0
2021-08-15,Brazil,203070494,Alagoas,3127683,0.5273,9992,1649291,0.2051,3631,641492,0.0000,0,0
2021-08-16,Brazil,203070494,Alagoas,3127683,0.5326,16415,1665706,0.2084,10472,651964,0.0000,0,0
2021-08-17,Brazil,203070494,Alagoas,3127683,0.5370,13891,1679597,0.2133,15174,667138,0.0000,0,0
2021-08-18,Brazil,203070494,Alagoas,3127683,0.5417,14623,1694220,0.2177,13765,680903,0.0000,0,0
2021-08-19,Brazil,203070494,Alagoas,3127683,0.5485,21184,1715404,0.2217,12454,693357,0.0000,0,0
2021-08-20,Brazil,203070494,Alagoas,3127683,0.5547,19526,1734930,0.2253,11243,704600,0.0000,0,0
2021-08-21,Brazil,203070494,Alagoas,3127683,0.5603,17414,1752344,0.2282,9044,713644,0.0000,0,0
2021-08-22,Brazil,203070494,Alagoas,3127683,0.5625,6929,1759273,0.2292,3329,716973,0.0000,0,0
2021-08-23,Brazil,203070494,Alagoas,3127683,0.5689,20122,1779395,0.2329,11603,728576,0.0000,0,0
2021-08-24,Brazil,203070494,Alagoas,3127683,0.5769,24822,1804217,0.2368,11926,740502,0.0000,0,0
2021-08-25,Brazil,203070494,Alagoas,3127683,0.5846,24243,1828460,0.2409,13084,753586,0.0000,0,0
2021-08-26,Brazil,203070494,Alagoas,3127683,0.5909,19673,1848133,0.2446,11309,764895,0.0000,0,0
2021-08-27,Brazil,203070494,Alagoas,3127683,0.5958,15406,1863539,0.2483,11595,776490,0.0000,0,0
2021-08-28,Brazil,203070494,Alagoas,3127683,0.5995,11451,1874990,0.2511,9022,785512,0.0000,0,0
2021-08-29,Brazil,203070494,Alagoas,3127683,0.6017,6844,1881834,0.2520,2637,788149,0.0000,0,0
2021-08-30,Brazil,203070494,Alagoas,3127683,0.6069,16272,1898106,0.2562,13230,801379,0.0000,0,0
2021-08-31,Brazil,203070494,Alagoas,3127683,0.6119,15570,1913676,0.2598,11348,812727,0.0000,0,0
2021-09-01,Brazil,203070494,Alagoas,3127683,0.6149,9638,1923314,0.2635,11519,824246,0.0000,0,0
2021-09-02,Brazil,203070494,Alagoas,3127683,0.6176,8323,1931637,0.2687,16297,840543,0.0000,0,0
2021-09-03,Brazil,203070494,Alagoas,3127683,0.6210,10501,1942138,0.2731,13550,854093,0.0000,0,0
2021-09-04,Brazil,203070494,Alagoas,3127683,0.6237,8629,1950767,0.2760,9244,863337,0.0000,0,0
2021-09-05,Brazil,203070494,Alagoas,3127683,0.6246,2776,1953543,0.2767,2171,865508,0.0000,0,0
2021-09-06,Brazil,203070494,Alagoas,3127683,0.6276,9483,1963026,0.2799,9799,875307,0.0000,0,0
2021-09-07,Brazil,203070494,Alagoas,3127683,0.6293,5135,1968161,0.2809,3150,878457,0.0000,0,0
2021-09-08,Brazil,203070494,Alagoas,3127683,0.6332,12232,1980393,0.2859,15689,894146,0.0000,0,0
2021-09-09,Brazil,203070494,Alagoas,3127683,0.6379,14808,1995201,0.2909,15798,909944,0.0000,0,0
2021-09-10,Brazil,203070494,Alagoas,3127683,0.6426,14523,2009724,0.2951,12974,922918,0.0000,0,0
2021-09-11,Brazil,203070494,Alagoas,3127683,0.6458,10187,2019911,0.2977,8175,931093,0.0000,0,0
2021-09-12,Brazil,203070494,Alagoas,3127683,0.6462,1341,2021252,0.2980,968,932061,0.0000,0,0
2021-09-13,Brazil,203070494,Alagoas,3127683,0.6499,11398,2032650,0.3023,13496,945557,0.0000,0,0
2021-09-14,Brazil,203070494,Alagoas,3127683,0.6542,13433,2046083,0.3077,16962,962519,0.0000,0,0
2021-09-15,Brazil,203070494,Alagoas,3127683,0.6587,14080,2060163,0.3139,19318,981837,0.0000,0,0
2021-09-16,Brazil,203070494,Alagoas,3127683,0.6602,4762,2064925,0.3156,5272,987109,0.0000,0,0
2021-09-17,Brazil,203070494,Alagoas,3127683,0.6620,5447,2070372,0.3186,9386,996495,0.0000,0,0
2021-09-18,Brazil,203070494,Alagoas,3127683,0.6637,5587,2075959,0.3210,7544,1004039,0.0000,0,0
2021-09-19,Brazil,203070494,Alagoas,3127683,0.6647,2863,2078822,0.3223,3869,1007908,0.0000,0,0
2021-09-20,Brazil,203070494,Alagoas,3127683,0.6665,5783,2084605,0.3270,14962,1022870,0.0000,0,0
2021-09-21,Brazil,203070494,Alagoas,3127683,0.6685,6195,2090800,0.3322,16104,1038974,0.0000,0,0
2021-09-22,Brazil,203070494,Alagoas,3127683,0.6707,7042,2097842,0.3375,16712,1055686,0.0000,0,0
2021-09-23,Brazil,203070494,Alagoas,3127683,0.6737,9284,2107126,0.3421,14170,1069856,0.0000,0,0
2021-09-24,Brazil,203070494,Alagoas,3127683,0.6778,12884,2120010,0.3459,11973,1081829,0.0000,0,0
2021-09-25,Brazil,203070494,Alagoas,3127683,0.6802,7533,2127543,0.3486,8563,1090392,0.0000,0,0
2021-09-26,Brazil,203070494,Alagoas,3127683,0.6810,2352,2129895,0.3498,3585,1093977,0.0000,0,0
2021-09-27,Brazil,203070494,Alagoas,3127683,0.6846,11227,2141122,0.3538,12480,1106457,0.0000,0,0
2021-09-28,Brazil,203070494,Alagoas,3127683,0.6880,10860,2151982,0.3585,14738,1121195,0.0000,0,0
2021-09-29,Brazil,203070494,Alagoas,3127683,0.6913,10328,2162310,0.3632,14851,1136046,0.0000,0,0
2021-09-30,Brazil,203070494,Alagoas,3127683,0.6941,8604,2170914,0.3670,11881,1147927,0.0000,0,0
2021-10-01,Brazil,203070494,Alagoas,3127683,0.6968,8361,2179275,0.3701,9751,1157678,0.0000,0,0
2021-10-02,Brazil,203070494,Alagoas,3127683,0.6988,6325,2185600,0.3720,5689,1163367,0.0000,0,0
2021-10-03,Brazil,203070494,Alagoas,3127683,0.6992,1367,2186967,0.3729,2923,1166290,0.0000,0,0
2021-10-04,Brazil,203070494,Alagoas,3127683,0.7016,7463,2194430,0.3758,9247,1175537,0.0000,0,0
2021-10-05,Brazil,203070494,Alagoas,3127683,0.7038,6969,2201399,0.3791,10279,1185816,0.0000,0,0
2021-10-06,Brazil,203070494,Alagoas,3127683,0.7062,7347,2208746,0.3825,10588,1196404,0.0000,0,0
2021-10-07,Brazil,203070494,Alagoas,3127683,0.7080,5604,2214350,0.3853,8785,1205189,0.0000,0,0
2021-10-08,Brazil,203070494,Alagoas,3127683,0.7099,5913,2220263,0.3881,8711,1213900,0.0000,0,0
2021-10-09,Brazil,203070494,Alagoas,3127683,0.7107,2682,2222945,0.3900,6004,1219904,0.0000,0,0
2021-10-10,Brazil,203070494,Alagoas,3127683,0.7111,1144,2224089,0.3910,2877,1222781,0.0000,0,0
2021-10-11,Brazil,203070494,Alagoas,3127683,0.7120,2843,2226932,0.3934,7498,1230279,0.0000,0,0
2021-10-12,Brazil,203070494,Alagoas,3127683,0.7123,922,2227854,0.3946,3949,1234228,0.0000,0,0
2021-10-13,Brazil,203070494,Alagoas,3127683,0.7136,4006,2231860,0.3985,12251,1246479,0.0000,0,0
2021-10-14,Brazil,203070494,Alagoas,3127683,0.7151,4677,2236537,0.4032,14561,1261040,0.0000,0,0
2021-10-15,Brazil,203070494,Alagoas,3127683,0.7163,3978,2240515,0.4071,12213,1273253,0.0000,0,0
2021-10-16,Brazil,203070494,Alagoas,3127683,0.7169,1709,2242224,0.4094,7333,1280586,0.0000,0,0
2021-10-17,Brazil,203070494,Alagoas,3127683,0.7171,647,2242871,0.4104,3099,1283685,0.0000,0,0
2021-10-18,Brazil,203070494,Alagoas,3127683,0.7182,3539,2246410,0.4139,10826,1294511,0.0000,0,0
2021-10-19,Brazil,203070494,Alagoas,3127683,0.7196,4269,2250679,0.4179,12640,1307151,0.0000,0,0
2021-10-20,Brazil,203070494,Alagoas,3127683,0.7209,3922,2254601,0.4221,12949,1320100,0.0000,0,0
2021-10-21,Brazil,203070494,Alagoas,3127683,0.7220,3697,2258298,0.4259,11993,1332093,0.0000,0,0
2021-10-22,Brazil,203070494,Alagoas,3127683,0.7232,3673,2261971,0.4298,12241,1344334,0.0000,0,0
2021-10-23,Brazil,203070494,Alagoas,3127683,0.7239,2119,2264090,0.4327,8948,1353282,0.0000,0,0
2021-10-24,Brazil,203070494,Alagoas,3127683,0.7240,505,2264595,0.4337,3179,1356461,0.0000,0,0
2021-10-25,Brazil,203070494,Alagoas,3127683,0.7252,3446,2268041,0.4378,12685,1369146,0.0000,0,0
2021-10-26,Brazil,203070494,Alagoas,3127683,0.7264,3781,2271822,0.4427,15559,1384705,0.0000,0,0
2021-10-27,Brazil,203070494,Alagoas,3127683,0.7279,4668,2276490,0.4475,15031,1399736,0.0000,0,0
2021-10-28,Brazil,203070494,Alagoas,3127683,0.7289,3425,2279915,0.4510,10886,1410622,0.0000,0,0
2021-10-29,Brazil,203070494,Alagoas,3127683,0.7298,2773,2282688,0.4541,9508,1420130,0.0000,0,0
2021-10-30,Brazil,203070494,Alagoas,3127683,0.7302,1006,2283694,0.4556,4798,1424928,0.0000,0,0
2021-10-31,Brazil,203070494,Alagoas,3127683,0.7302,106,2283800,0.4558,567,1425495,0.0000,0,0
2021-11-01,Brazil,203070494,Alagoas,3127683,0.7305,1045,2284845,0.4574,4987,1430482,0.0000,0,0
2021-11-02,Brazil,203070494,Alagoas,3127683,0.7307,564,2285409,0.4587,4139,1434621,0.0000,0,0
2021-11-03,Brazil,203070494,Alagoas,3127683,0.7315,2635,2288044,0.4634,14810,1449431,0.0000,0,0
2021-11-04,Brazil,203070494,Alagoas,3127683,0.7323,2312,2290356,0.4681,14505,1463936,0.0000,0,0
2021-11-05,Brazil,203070494,Alagoas,3127683,0.7330,2332,2292688,0.4727,14433,1478369,0.0000,0,0
2021-11-06,Brazil,203070494,Alagoas,3127683,0.7334,1142,2293830,0.4748,6760,1485129,0.0000,0,0
2021-11-07,Brazil,203070494,Alagoas,3127683,0.7335,403,2294233,0.4751,734,1485863,0.0000,0,0
2021-11-08,Brazil,203070494,Alagoas,3127683,0.7343,2471,2296704,0.4794,13673,1499536,0.0000,0,0
2021-11-09,Brazil,203070494,Alagoas,3127683,0.7352,2904,2299608,0.4841,14479,1514015,0.0000,0,0
2021-11-10,Brazil,203070494,Alagoas,3127683,0.7361,2796,2302404,0.4883,13256,1527271,0.0000,1,1
2021-11-11,Brazil,203070494,Alagoas,3127683,0.7371,2932,2305336,0.4930,14590,1541861,0.0000,0,1
2021-11-12,Brazil,203070494,Alagoas,3127683,0.7379,2518,2307854,0.4973,13433,1555294,0.0000,0,1
2021-11-13,Brazil,203070494,Alagoas,3127683,0.7382,864,2308718,0.4994,6602,1561896,0.0000,0,1
2021-11-14,Brazil,203070494,Alagoas,3127683,0.7382,108,2308826,0.4996,778,1562674,0.0000,0,1
2021-11-15,Brazil,203070494,Alagoas,3127683,0.7383,428,2309254,0.5009,4071,1566745,0.0000,0,1
2021-11-16,Brazil,203070494,Alagoas,3127683,0.7390,2038,2311292,0.5064,17050,1583795,0.0000,0,1
2021-11-17,Brazil,203070494,Alagoas,3127683,0.7398,2692,2313984,0.5116,16185,1599980,0.0000,0,1
2021-11-18,Brazil,203070494,Alagoas,3127683,0.7405,2172,2316156,0.5162,14645,1614625,0.0000,0,1
2021-11-19,Brazil,203070494,Alagoas,3127683,0.7413,2478,2318634,0.5204,13047,1627672,0.0000,0,1
2021-11-20,Brazil,203070494,Alagoas,3127683,0.7416,799,2319433,0.5227,7016,1634688,0.0000,0,1
2021-11-21,Brazil,203070494,Alagoas,3127683,0.7416,101,2319534,0.5229,778,1635466,0.0000,0,1
2021-11-22,Brazil,203070494,Alagoas,3127683,0.7423,2015,2321549,0.5268,12222,1647688,0.0000,0,1
2021-11-23,Brazil,203070494,Alagoas,3127683,0.7429,1927,2323476,0.5310,13116,1660804,0.0000,0,1
2021-11-24,Brazil,203070494,Alagoas,3127683,0.7435,2088,2325564,0.5348,11841,1672645,0.0000,0,1
2021-11-25,Brazil,203070494,Alagoas,3127683,0.7442,2123,2327687,0.5383,11000,1683645,0.0000,0,1
2021-11-26,Brazil,203070494,Alagoas,3127683,0.7449,2044,2329731,0.5416,10237,1693882,0.0000,0,1
2021-11-27,Brazil,203070494,Alagoas,3127683,0.7451,586,2330317,0.5430,4583,1698465,0.0000,0,1
2021-11-28,Brazil,203070494,Alagoas,3127683,0.7451,90,2330407,0.5432,434,1698899,0.0000,0,1
2021-11-29,Brazil,203070494,Alagoas,3127683,0.7454,1108,2331515,0.5457,7848,1706747,0.0000,0,1
2021-11-30,Brazil,203070494,Alagoas,3127683,0.7460,1622,2333137,0.5486,9021,1715768,0.0000,0,1
2021-12-01,Brazil,203070494,Alagoas,3127683,0.7468,2583,2335720,0.5524,12110,1727878,0.0000,0,1
2021-12-02,Brazil,203070494,Alagoas,3127683,0.7474,1870,2337590,0.5560,11176,1739054,0.0000,0,1
2021-12-03,Brazil,203070494,Alagoas,3127683,0.7480,1784,2339374,0.5591,9519,1748573,0.0000,0,1
2021-12-04,Brazil,203070494,Alagoas,3127683,0.7481,587,2339961,0.5605,4411,1752984,0.0000,0,1
2021-12-05,Brazil,203070494,Alagoas,3127683,0.7482,79,2340040,0.5606,547,1753531,0.0000,0,1
2021-12-06,Brazil,203070494,Alagoas,3127683,0.7487,1688,2341728,0.5640,10404,1763935,0.0000,0,1
2021-12-07,Brazil,203070494,Alagoas,3127683,0.7493,1895,2343623,0.5674,10769,1774704,0.0000,0,1
2021-12-08,Brazil,203070494,Alagoas,3127683,0.7495,631,2344254,0.5686,3826,1778530,0.0000,0,1
2021-12-09,Brazil,203070494,Alagoas,3127683,0.7501,1907,2346161,0.5722,10992,1789522,0.0000,0,1
2021-12-10,Brazil,203070494,Alagoas,3127683,0.7505,1276,2347437,0.5747,7961,1797483,0.0000,0,1
2021-12-11,Brazil,203070494,Alagoas,3127683,0.7507,642,2348079,0.5755,2430,1799913,0.0000,0,1
2021-12-12,Brazil,203070494,Alagoas,3127683,0.7509,349,2348428,0.5756,337,1800250,0.0000,0,1
2021-12-13,Brazil,203070494,Alagoas,3127683,0.7512,1132,2349560,0.5779,7156,1807406,0.0000,0,1
2021-12-14,Brazil,203070494,Alagoas,3127683,0.7516,1242,2350802,0.5800,6763,1814169,0.0000,0,1
2021-12-15,Brazil,203070494,Alagoas,3127683,0.7521,1597,2352399,0.5827,8390,1822559,0.0000,0,1
2021-12-16,Brazil,203070494,Alagoas,3127683,0.7527,1653,2354052,0.5858,9522,1832081,0.0000,0,1
2021-12-17,Brazil,203070494,Alagoas,3127683,0.7532,1789,2355841,0.5890,10075,1842156,0.0000,0,1
2021-12-18,Brazil,203070494,Alagoas,3127683,0.7534,471,2356312,0.5900,3270,1845426,0.0000,0,1
2021-12-19,Brazil,203070494,Alagoas,3127683,0.7534,212,2356524,0.5906,1802,1847228,0.0000,0,1
2021-12-20,Brazil,203070494,Alagoas,3127683,0.7538,1276,2357800,0.5932,8154,1855382,0.0000,0,1
2021-12-21,Brazil,203070494,Alagoas,3127683,0.7543,1458,2359258,0.5958,8019,1863401,0.0000,0,1
2021-12-22,Brazil,203070494,Alagoas,3127683,0.7547,1135,2360393,0.5987,9213,1872614,0.0000,0,1
2021-12-23,Brazil,203070494,Alagoas,3127683,0.7549,787,2361180,0.6005,5522,1878136,0.0000,0,1
2021-12-24,Brazil,203070494,Alagoas,3127683,0.7549,60,2361240,0.6007,537,1878673,0.0000,0,1
2021-12-25,Brazil,203070494,Alagoas,3127683,0.7549,0,2361240,0.6007,25,1878698,0.0000,0,1
2021-12-26,Brazil,203070494,Alagoas,3127683,0.7550,32,2361272,0.6007,184,1878882,0.0000,0,1
2021-12-27,Brazil,203070494,Alagoas,3127683,0.7552,689,2361961,0.6022,4546,1883428,0.0000,0,1
2021-12-28,Brazil,203070494,Alagoas,3127683,0.7555,860,2362821,0.6038,5193,1888621,0.0000,0,1
2021-12-29,Brazil,203070494,Alagoas,3127683,0.7557,783,2363604,0.6053,4575,1893196,0.0000,0,1
2021-12-30,Brazil,203070494,Alagoas,3127683,0.7558,426,2364030,0.6062,2815,1896011,0.0000,0,1
2021-12-31,Brazil,203070494,Alagoas,3127683,0.7558,14,2364044,0.6063,196,1896207,0.0000,0,1
2021-01-17,Brazil,203070494,Amapá,733759,0.0000,0,0,0.0000,2,2,0.0000,0,0
2021-01-18,Brazil,203070494,Amapá,733759,0.0000,11,11,0.0000,1,3,0.0000,0,0
2021-01-19,Brazil,203070494,Amapá,733759,0.0004,248,259,0.0000,2,5,0.0000,0,0
2021-01-20,Brazil,203070494,Amapá,733759,0.0026,1647,1906,0.0000,1,6,0.0000,0,0
2021-01-21,Brazil,203070494,Amapá,733759,0.0045,1371,3277,0.0000,0,6,0.0000,0,0
2021-01-22,Brazil,203070494,Amapá,733759,0.0057,936,4213,0.0000,5,11,0.0000,0,0
2021-01-23,Brazil,203070494,Amapá,733759,0.0072,1070,5283,0.0000,0,11,0.0000,0,0
2021-01-24,Brazil,203070494,Amapá,733759,0.0080,562,5845,0.0000,2,13,0.0000,0,0
2021-01-25,Brazil,203070494,Amapá,733759,0.0099,1387,7232,0.0000,0,13,0.0000,0,0
2021-01-26,Brazil,203070494,Amapá,733759,0.0110,843,8075,0.0000,1,14,0.0000,0,0
2021-01-27,Brazil,203070494,Amapá,733759,0.0119,684,8759,0.0000,2,16,0.0000,0,0
2021-01-28,Brazil,203070494,Amapá,733759,0.0130,757,9516,0.0000,5,21,0.0000,0,0
2021-01-29,Brazil,203070494,Amapá,733759,0.0142,922,10438,0.0000,2,23,0.0000,0,0
2021-01-30,Brazil,203070494,Amapá,733759,0.0158,1124,11562,0.0000,2,25,0.0000,0,0
2021-01-31,Brazil,203070494,Amapá,733759,0.0158,5,11567,0.0000,0,25,0.0000,0,0
2021-02-01,Brazil,203070494,Amapá,733759,0.0163,403,11970,0.0000,3,28,0.0000,0,0
2021-02-02,Brazil,203070494,Amapá,733759,0.0175,852,12822,0.0000,0,28,0.0000,0,0
2021-02-03,Brazil,203070494,Amapá,733759,0.0190,1108,13930,0.0000,3,31,0.0000,0,0
2021-02-04,Brazil,203070494,Amapá,733759,0.0200,730,14660,0.0000,0,31,0.0000,0,0
2021-02-05,Brazil,203070494,Amapá,733759,0.0213,985,15645,0.0001,10,41,0.0000,0,0
2021-02-06,Brazil,203070494,Amapá,733759,0.0216,201,15846,0.0001,0,41,0.0000,0,0
2021-02-07,Brazil,203070494,Amapá,733759,0.0216,30,15876,0.0001,2,43,0.0000,0,0
2021-02-08,Brazil,203070494,Amapá,733759,0.0218,150,16026,0.0001,8,51,0.0000,0,0
2021-02-09,Brazil,203070494,Amapá,733759,0.0222,237,16263,0.0003,168,219,0.0000,0,0
2021-02-10,Brazil,203070494,Amapá,733759,0.0231,714,16977,0.0004,75,294,0.0000,0,0
2021-02-11,Brazil,203070494,Amapá,733759,0.0240,665,17642,0.0011,517,811,0.0000,0,0
2021-02-12,Brazil,203070494,Amapá,733759,0.0244,284,17926,0.0017,408,1219,0.0000,0,0
2021-02-13,Brazil,203070494,Amapá,733759,0.0264,1474,19400,0.0017,38,1257,0.0000,0,0
2021-02-14,Brazil,203070494,Amapá,733759,0.0265,19,19419,0.0017,2,1259,0.0000,0,0
2021-02-15,Brazil,203070494,Amapá,733759,0.0268,233,19652,0.0024,484,1743,0.0000,0,0
2021-02-16,Brazil,203070494,Amapá,733759,0.0272,290,19942,0.0029,366,2109,0.0000,0,0
2021-02-17,Brazil,203070494,Amapá,733759,0.0277,349,20291,0.0053,1771,3880,0.0000,0,0
2021-02-18,Brazil,203070494,Amapá,733759,0.0291,1098,21389,0.0071,1337,5217,0.0000,0,0
2021-02-19,Brazil,203070494,Amapá,733759,0.0304,905,22294,0.0084,969,6186,0.0000,0,0
2021-02-20,Brazil,203070494,Amapá,733759,0.0305,116,22410,0.0091,478,6664,0.0000,0,0
2021-02-21,Brazil,203070494,Amapá,733759,0.0306,20,22430,0.0092,75,6739,0.0000,0,0
2021-02-22,Brazil,203070494,Amapá,733759,0.0309,277,22707,0.0104,859,7598,0.0000,0,0
2021-02-23,Brazil,203070494,Amapá,733759,0.0313,230,22937,0.0110,498,8096,0.0000,0,0
2021-02-24,Brazil,203070494,Amapá,733759,0.0316,271,23208,0.0115,366,8462,0.0000,0,0
2021-02-25,Brazil,203070494,Amapá,733759,0.0320,261,23469,0.0124,612,9074,0.0000,0,0
2021-02-26,Brazil,203070494,Amapá,733759,0.0323,261,23730,0.0133,666,9740,0.0000,0,0
2021-02-27,Brazil,203070494,Amapá,733759,0.0324,80,23810,0.0133,23,9763,0.0000,0,0
2021-02-28,Brazil,203070494,Amapá,733759,0.0325,7,23817,0.0133,5,9768,0.0000,0,0
2021-03-01,Brazil,203070494,Amapá,733759,0.0328,283,24100,0.0135,102,9870,0.0000,0,0
2021-03-02,Brazil,203070494,Amapá,733759,0.0332,281,24381,0.0136,141,10011,0.0000,0,0
2021-03-03,Brazil,203070494,Amapá,733759,0.0344,849,25230,0.0140,238,10249,0.0000,0,0
2021-03-04,Brazil,203070494,Amapá,733759,0.0349,382,25612,0.0146,467,10716,0.0000,0,0
2021-03-05,Brazil,203070494,Amapá,733759,0.0368,1378,26990,0.0151,355,11071,0.0000,0,0
2021-03-06,Brazil,203070494,Amapá,733759,0.0370,140,27130,0.0151,29,11100,0.0000,0,0
2021-03-07,Brazil,203070494,Amapá,733759,0.0370,10,27140,0.0152,23,11123,0.0000,0,0
2021-03-08,Brazil,203070494,Amapá,733759,0.0381,819,27959,0.0153,125,11248,0.0000,0,0
2021-03-09,Brazil,203070494,Amapá,733759,0.0395,1030,28989,0.0155,120,11368,0.0000,0,0
2021-03-10,Brazil,203070494,Amapá,733759,0.0409,1011,30000,0.0161,470,11838,0.0000,0,0
2021-03-11,Brazil,203070494,Amapá,733759,0.0427,1347,31347,0.0166,311,12149,0.0000,0,0
2021-03-12,Brazil,203070494,Amapá,733759,0.0452,1806,33153,0.0168,209,12358,0.0000,0,0
2021-03-13,Brazil,203070494,Amapá,733759,0.0455,244,33397,0.0186,1301,13659,0.0000,0,0
2021-03-14,Brazil,203070494,Amapá,733759,0.0455,22,33419,0.0186,4,13663,0.0000,0,0
2021-03-15,Brazil,203070494,Amapá,733759,0.0461,398,33817,0.0189,189,13852,0.0000,0,0
2021-03-16,Brazil,203070494,Amapá,733759,0.0466,351,34168,0.0194,350,14202,0.0000,0,0
2021-03-17,Brazil,203070494,Amapá,733759,0.0473,507,34675,0.0198,339,14541,0.0000,0,0
2021-03-18,Brazil,203070494,Amapá,733759,0.0482,692,35367,0.0209,784,15325,0.0000,0,0
2021-03-19,Brazil,203070494,Amapá,733759,0.0501,1367,36734,0.0212,266,15591,0.0000,0,0
2021-03-20,Brazil,203070494,Amapá,733759,0.0515,1063,37797,0.0214,99,15690,0.0000,0,0
2021-03-21,Brazil,203070494,Amapá,733759,0.0516,30,37827,0.0214,1,15691,0.0000,0,0
2021-03-22,Brazil,203070494,Amapá,733759,0.0554,2848,40675,0.0218,286,15977,0.0000,0,0
2021-03-23,Brazil,203070494,Amapá,733759,0.0609,4039,44714,0.0222,300,16277,0.0000,0,0
2021-03-24,Brazil,203070494,Amapá,733759,0.0668,4304,49018,0.0224,178,16455,0.0000,0,0
2021-03-25,Brazil,203070494,Amapá,733759,0.0733,4750,53768,0.0227,194,16649,0.0000,0,0
2021-03-26,Brazil,203070494,Amapá,733759,0.0754,1568,55336,0.0230,263,16912,0.0000,0,0
2021-03-27,Brazil,203070494,Amapá,733759,0.0760,435,55771,0.0231,52,16964,0.0000,0,0
2021-03-28,Brazil,203070494,Amapá,733759,0.0768,578,56349,0.0231,11,16975,0.0000,0,0
2021-03-29,Brazil,203070494,Amapá,733759,0.0785,1233,57582,0.0237,429,17404,0.0000,0,0
2021-03-30,Brazil,203070494,Amapá,733759,0.0797,866,58448,0.0248,783,18187,0.0000,0,0
2021-03-31,Brazil,203070494,Amapá,733759,0.0812,1120,59568,0.0254,442,18629,0.0000,0,0
2021-04-01,Brazil,203070494,Amapá,733759,0.0830,1317,60885,0.0262,569,19198,0.0000,0,0
2021-04-02,Brazil,203070494,Amapá,733759,0.0853,1675,62560,0.0269,555,19753,0.0000,0,0
2021-04-03,Brazil,203070494,Amapá,733759,0.0878,1900,64460,0.0272,193,19946,0.0000,0,0
2021-04-04,Brazil,203070494,Amapá,733759,0.0907,2080,66540,0.0273,80,20026,0.0000,0,0
2021-04-05,Brazil,203070494,Amapá,733759,0.0930,1669,68209,0.0285,896,20922,0.0000,0,0
2021-04-06,Brazil,203070494,Amapá,733759,0.0945,1131,69340,0.0294,621,21543,0.0000,0,0
2021-04-07,Brazil,203070494,Amapá,733759,0.0961,1167,70507,0.0303,669,22212,0.0000,0,0
2021-04-08,Brazil,203070494,Amapá,733759,0.0981,1450,71957,0.0319,1159,23371,0.0000,0,0
2021-04-09,Brazil,203070494,Amapá,733759,0.1019,2826,74783,0.0338,1417,24788,0.0000,0,0
2021-04-10,Brazil,203070494,Amapá,733759,0.1059,2926,77709,0.0342,342,25130,0.0000,0,0
2021-04-11,Brazil,203070494,Amapá,733759,0.1070,799,78508,0.0344,81,25211,0.0000,0,0
2021-04-12,Brazil,203070494,Amapá,733759,0.1088,1300,79808,0.0357,951,26162,0.0000,0,0
2021-04-13,Brazil,203070494,Amapá,733759,0.1112,1769,81577,0.0364,550,26712,0.0000,0,0
2021-04-14,Brazil,203070494,Amapá,733759,0.1121,650,82227,0.0371,538,27250,0.0000,1,1
2021-04-15,Brazil,203070494,Amapá,733759,0.1126,402,82629,0.0375,296,27546,0.0000,0,1
2021-04-16,Brazil,203070494,Amapá,733759,0.1133,498,83127,0.0398,1692,29238,0.0000,0,1
2021-04-17,Brazil,203070494,Amapá,733759,0.1135,160,83287,0.0404,382,29620,0.0000,0,1
2021-04-18,Brazil,203070494,Amapá,733759,0.1141,421,83708,0.0406,205,29825,0.0000,0,1
2021-04-19,Brazil,203070494,Amapá,733759,0.1168,1990,85698,0.0447,2983,32808,0.0000,0,1
2021-04-20,Brazil,203070494,Amapá,733759,0.1181,926,86624,0.0477,2210,35018,0.0000,0,1
2021-04-21,Brazil,203070494,Amapá,733759,0.1197,1173,87797,0.0481,292,35310,0.0000,0,1
2021-04-22,Brazil,203070494,Amapá,733759,0.1210,1016,88813,0.0492,790,36100,0.0000,0,1
2021-04-23,Brazil,203070494,Amapá,733759,0.1224,1013,89826,0.0507,1069,37169,0.0000,0,1
2021-04-24,Brazil,203070494,Amapá,733759,0.1232,549,90375,0.0523,1213,38382,0.0000,0,1
2021-04-25,Brazil,203070494,Amapá,733759,0.1238,501,90876,0.0523,18,38400,0.0000,0,1
2021-04-26,Brazil,203070494,Amapá,733759,0.1249,794,91670,0.0548,1798,40198,0.0000,0,1
2021-04-27,Brazil,203070494,Amapá,733759,0.1260,762,92432,0.0562,1041,41239,0.0000,0,1
2021-04-28,Brazil,203070494,Amapá,733759,0.1274,1016,93448,0.0570,553,41792,0.0000,0,1
2021-04-29,Brazil,203070494,Amapá,733759,0.1279,423,93871,0.0576,488,42280,0.0000,0,1
2021-04-30,Brazil,203070494,Amapá,733759,0.1287,585,94456,0.0580,287,42567,0.0000,0,1
2021-05-01,Brazil,203070494,Amapá,733759,0.1297,697,95153,0.0581,44,42611,0.0000,0,1
2021-05-02,Brazil,203070494,Amapá,733759,0.1300,199,95352,0.0588,549,43160,0.0000,0,1
2021-05-03,Brazil,203070494,Amapá,733759,0.1311,847,96199,0.0596,560,43720,0.0000,0,1
2021-05-04,Brazil,203070494,Amapá,733759,0.1330,1422,97621,0.0601,400,44120,0.0000,0,1
2021-05-05,Brazil,203070494,Amapá,733759,0.1367,2687,100308,0.0606,321,44441,0.0000,0,1
2021-05-06,Brazil,203070494,Amapá,733759,0.1395,2078,102386,0.0613,551,44992,0.0000,0,1
2021-05-07,Brazil,203070494,Amapá,733759,0.1442,3444,105830,0.0624,810,45802,0.0000,0,1
2021-05-08,Brazil,203070494,Amapá,733759,0.1467,1841,107671,0.0625,50,45852,0.0000,0,1
2021-05-09,Brazil,203070494,Amapá,733759,0.1467,4,107675,0.0625,4,45856,0.0000,0,1
2021-05-10,Brazil,203070494,Amapá,733759,0.1472,339,108014,0.0634,681,46537,0.0000,0,1
2021-05-11,Brazil,203070494,Amapá,733759,0.1487,1080,109094,0.0658,1753,48290,0.0000,0,1
2021-05-12,Brazil,203070494,Amapá,733759,0.1526,2868,111962,0.0665,508,48798,0.0000,0,1
2021-05-13,Brazil,203070494,Amapá,733759,0.1558,2371,114333,0.0668,219,49017,0.0000,0,1
2021-05-14,Brazil,203070494,Amapá,733759,0.1585,1971,116304,0.0701,2394,51411,0.0000,0,1
2021-05-15,Brazil,203070494,Amapá,733759,0.1588,221,116525,0.0805,7647,59058,0.0000,0,1
2021-05-16,Brazil,203070494,Amapá,733759,0.1589,91,116616,0.0815,736,59794,0.0000,0,1
2021-05-17,Brazil,203070494,Amapá,733759,0.1623,2446,119062,0.0820,347,60141,0.0000,0,1
2021-05-18,Brazil,203070494,Amapá,733759,0.1676,3904,122966,0.0823,278,60419,0.0000,0,1
2021-05-19,Brazil,203070494,Amapá,733759,0.1691,1115,124081,0.0826,165,60584,0.0000,0,1
2021-05-20,Brazil,203070494,Amapá,733759,0.1707,1141,125222,0.0828,138,60722,0.0000,0,1
2021-05-21,Brazil,203070494,Amapá,733759,0.1735,2116,127338,0.0831,242,60964,0.0000,0,1
2021-05-22,Brazil,203070494,Amapá,733759,0.1742,500,127838,0.0833,148,61112,0.0000,0,1
2021-05-23,Brazil,203070494,Amapá,733759,0.1743,23,127861,0.0833,2,61114,0.0000,0,1
2021-05-24,Brazil,203070494,Amapá,733759,0.1759,1218,129079,0.0837,288,61402,0.0000,0,1
2021-05-25,Brazil,203070494,Amapá,733759,0.1773,1001,130080,0.0842,365,61767,0.0000,0,1
2021-05-26,Brazil,203070494,Amapá,733759,0.1800,1968,132048,0.0845,204,61971,0.0000,0,1
2021-05-27,Brazil,203070494,Amapá,733759,0.1823,1737,133785,0.0846,130,62101,0.0000,0,1
2021-05-28,Brazil,203070494,Amapá,733759,0.1857,2494,136279,0.0849,159,62260,0.0000,0,1
2021-05-29,Brazil,203070494,Amapá,733759,0.1875,1321,137600,0.0849,42,62302,0.0000,0,1
2021-05-30,Brazil,203070494,Amapá,733759,0.1876,54,137654,0.0849,2,62304,0.0000,0,1
2021-05-31,Brazil,203070494,Amapá,733759,0.1901,1862,139516,0.0852,214,62518,0.0000,0,1
2021-06-01,Brazil,203070494,Amapá,733759,0.1928,1949,141465,0.0854,177,62695,0.0000,0,1
2021-06-02,Brazil,203070494,Amapá,733759,0.1947,1364,142829,0.0858,259,62954,0.0000,0,1
2021-06-03,Brazil,203070494,Amapá,733759,0.1952,392,143221,0.0859,65,63019,0.0000,0,1
2021-06-04,Brazil,203070494,Amapá,733759,0.1974,1612,144833,0.0866,504,63523,0.0000,0,1
2021-06-05,Brazil,203070494,Amapá,733759,0.1987,943,145776,0.0868,131,63654,0.0000,0,1
2021-06-06,Brazil,203070494,Amapá,733759,0.2006,1382,147158,0.0868,15,63669,0.0000,0,1
2021-06-07,Brazil,203070494,Amapá,733759,0.2042,2669,149827,0.0871,208,63877,0.0000,0,1
2021-06-08,Brazil,203070494,Amapá,733759,0.2082,2913,152740,0.0873,159,64036,0.0000,0,1
2021-06-09,Brazil,203070494,Amapá,733759,0.2125,3211,155951,0.0875,167,64203,0.0000,0,1
2021-06-10,Brazil,203070494,Amapá,733759,0.2167,3052,159003,0.0878,206,64409,0.0000,0,1
2021-06-11,Brazil,203070494,Amapá,733759,0.2269,7477,166480,0.0881,230,64639,0.0000,0,1
2021-06-12,Brazil,203070494,Amapá,733759,0.2313,3203,169683,0.0882,77,64716,0.0000,0,1
2021-06-13,Brazil,203070494,Amapá,733759,0.2319,449,170132,0.0882,8,64724,0.0000,0,1
2021-06-14,Brazil,203070494,Amapá,733759,0.2374,4051,174183,0.0883,90,64814,0.0000,0,1
2021-06-15,Brazil,203070494,Amapá,733759,0.2430,4132,178315,0.0885,104,64918,0.0000,0,1
2021-06-16,Brazil,203070494,Amapá,733759,0.2498,4952,183267,0.0889,322,65240,0.0000,0,1
2021-06-17,Brazil,203070494,Amapá,733759,0.2546,3566,186833,0.0893,318,65558,0.0000,0,1
2021-06-18,Brazil,203070494,Amapá,733759,0.2590,3233,190066,0.0896,179,65737,0.0000,0,1
2021-06-19,Brazil,203070494,Amapá,733759,0.2616,1882,191948,0.0911,1074,66811,0.0000,0,1
2021-06-20,Brazil,203070494,Amapá,733759,0.2621,342,192290,0.0911,6,66817,0.0000,0,1
2021-06-21,Brazil,203070494,Amapá,733759,0.2664,3148,195438,0.0914,279,67096,0.0000,0,1
2021-06-22,Brazil,203070494,Amapá,733759,0.2707,3185,198623,0.0922,546,67642,0.0000,0,1
2021-06-23,Brazil,203070494,Amapá,733759,0.2777,5147,203770,0.0927,387,68029,0.0000,0,1
2021-06-24,Brazil,203070494,Amapá,733759,0.2819,3088,206858,0.0936,631,68660,0.0000,0,1
2021-06-25,Brazil,203070494,Amapá,733759,0.2862,3149,210007,0.0950,1062,69722,0.0000,0,1
2021-06-26,Brazil,203070494,Amapá,733759,0.2915,3853,213860,0.0977,1955,71677,0.0000,0,1
2021-06-27,Brazil,203070494,Amapá,733759,0.2946,2329,216189,0.0978,121,71798,0.0000,0,1
2021-06-28,Brazil,203070494,Amapá,733759,0.3011,4750,220939,0.0998,1462,73260,0.0000,0,1
2021-06-29,Brazil,203070494,Amapá,733759,0.3071,4407,225346,0.1011,954,74214,0.0000,0,1
2021-06-30,Brazil,203070494,Amapá,733759,0.3112,2973,228319,0.1031,1453,75667,0.0000,0,1
2021-07-01,Brazil,203070494,Amapá,733759,0.3138,1924,230243,0.1045,1028,76695,0.0000,0,1
2021-07-02,Brazil,203070494,Amapá,733759,0.3182,3240,233483,0.1060,1114,77809,0.0000,0,1
2021-07-03,Brazil,203070494,Amapá,733759,0.3212,2205,235688,0.1069,628,78437,0.0000,0,1
2021-07-04,Brazil,203070494,Amapá,733759,0.3216,288,235976,0.1072,200,78637,0.0000,0,1
2021-07-05,Brazil,203070494,Amapá,733759,0.3254,2781,238757,0.1082,787,79424,0.0000,0,1
2021-07-06,Brazil,203070494,Amapá,733759,0.3297,3160,241917,0.1092,724,80148,0.0000,0,1
2021-07-07,Brazil,203070494,Amapá,733759,0.3359,4543,246460,0.1106,983,81131,0.0000,0,1
2021-07-08,Brazil,203070494,Amapá,733759,0.3419,4421,250881,0.1116,783,81914,0.0000,0,1
2021-07-09,Brazil,203070494,Amapá,733759,0.3474,4030,254911,0.1125,634,82548,0.0000,0,1
2021-07-10,Brazil,203070494,Amapá,733759,0.3508,2470,257381,0.1131,448,82996,0.0000,0,1
2021-07-11,Brazil,203070494,Amapá,733759,0.3508,8,257389,0.1131,0,82996,0.0000,0,1
2021-07-12,Brazil,203070494,Amapá,733759,0.3548,2983,260372,0.1141,754,83750,0.0000,0,1
2021-07-13,Brazil,203070494,Amapá,733759,0.3596,3495,263867,0.1154,939,84689,0.0000,0,1
2021-07-14,Brazil,203070494,Amapá,733759,0.3646,3645,267512,0.1175,1511,86200,0.0000,0,1
2021-07-15,Brazil,203070494,Amapá,733759,0.3708,4570,272082,0.1187,868,87068,0.0000,0,1
2021-07-16,Brazil,203070494,Amapá,733759,0.3759,3726,275808,0.1196,696,87764,0.0000,0,1
2021-07-17,Brazil,203070494,Amapá,733759,0.3800,2994,278802,0.1203,484,88248,0.0000,0,1
2021-07-18,Brazil,203070494,Amapá,733759,0.3805,369,279171,0.1204,81,88329,0.0000,0,1
2021-07-19,Brazil,203070494,Amapá,733759,0.3877,5318,284489,0.1213,695,89024,0.0000,0,1
2021-07-20,Brazil,203070494,Amapá,733759,0.3956,5803,290292,0.1224,763,89787,0.0000,0,1
2021-07-21,Brazil,203070494,Amapá,733759,0.4035,5809,296101,0.1233,683,90470,0.0000,0,1
2021-07-22,Brazil,203070494,Amapá,733759,0.4114,5738,301839,0.1242,641,91111,0.0000,0,1
2021-07-23,Brazil,203070494,Amapá,733759,0.4177,4672,306511,0.1254,891,92002,0.0000,0,1
2021-07-24,Brazil,203070494,Amapá,733759,0.4243,4847,311358,0.1274,1472,93474,0.0000,0,1
2021-07-25,Brazil,203070494,Amapá,733759,0.4255,840,312198,0.1276,185,93659,0.0000,0,1
2021-07-26,Brazil,203070494,Amapá,733759,0.4324,5085,317283,0.1297,1516,95175,0.0000,0,1
2021-07-27,Brazil,203070494,Amapá,733759,0.4395,5220,322503,0.1319,1640,96815,0.0000,0,1
2021-07-28,Brazil,203070494,Amapá,733759,0.4454,4305,326808,0.1344,1774,98589,0.0000,0,1
2021-07-29,Brazil,203070494,Amapá,733759,0.4519,4814,331622,0.1359,1097,99686,0.0000,0,1
2021-07-30,Brazil,203070494,Amapá,733759,0.4574,4033,335655,0.1381,1665,101351,0.0000,0,1
2021-07-31,Brazil,203070494,Amapá,733759,0.4605,2217,337872,0.1398,1213,102564,0.0000,0,1
2021-08-01,Brazil,203070494,Amapá,733759,0.4605,21,337893,0.1398,6,102570,0.0000,0,1
2021-08-02,Brazil,203070494,Amapá,733759,0.4669,4686,342579,0.1410,857,103427,0.0000,0,1
2021-08-03,Brazil,203070494,Amapá,733759,0.4748,5780,348359,0.1424,1092,104519,0.0000,0,1
2021-08-04,Brazil,203070494,Amapá,733759,0.4804,4174,352533,0.1458,2431,106950,0.0000,0,1
2021-08-05,Brazil,203070494,Amapá,733759,0.4855,3712,356245,0.1486,2053,109003,0.0000,0,1
2021-08-06,Brazil,203070494,Amapá,733759,0.4896,3021,359266,0.1512,1937,110940,0.0000,0,1
2021-08-07,Brazil,203070494,Amapá,733759,0.5033,10056,369322,0.1526,1017,111957,0.0000,0,1
2021-08-08,Brazil,203070494,Amapá,733759,0.5034,16,369338,0.1526,13,111970,0.0000,0,1
2021-08-09,Brazil,203070494,Amapá,733759,0.5054,1538,370876,0.1555,2142,114112,0.0000,0,1
2021-08-10,Brazil,203070494,Amapá,733759,0.5084,2168,373044,0.1606,3732,117844,0.0000,0,1
2021-08-11,Brazil,203070494,Amapá,733759,0.5117,2442,375486,0.1631,1815,119659,0.0000,0,1
2021-08-12,Brazil,203070494,Amapá,733759,0.5158,3011,378497,0.1665,2543,122202,0.0000,0,1
2021-08-13,Brazil,203070494,Amapá,733759,0.5215,4173,382670,0.1688,1666,123868,0.0000,0,1
2021-08-14,Brazil,203070494,Amapá,733759,0.5355,10291,392961,0.1703,1075,124943,0.0000,0,1
2021-08-15,Brazil,203070494,Amapá,733759,0.5356,24,392985,0.1703,49,124992,0.0000,0,1
2021-08-16,Brazil,203070494,Amapá,733759,0.5377,1543,394528,0.1718,1066,126058,0.0000,0,1
2021-08-17,Brazil,203070494,Amapá,733759,0.5418,3051,397579,0.1738,1497,127555,0.0000,0,1
2021-08-18,Brazil,203070494,Amapá,733759,0.5466,3512,401091,0.1770,2357,129912,0.0000,0,1
2021-08-19,Brazil,203070494,Amapá,733759,0.5536,5139,406230,0.1794,1745,131657,0.0000,0,1
2021-08-20,Brazil,203070494,Amapá,733759,0.5575,2836,409066,0.1817,1684,133341,0.0000,0,1
2021-08-21,Brazil,203070494,Amapá,733759,0.5699,9116,418182,0.1834,1246,134587,0.0000,0,1
2021-08-22,Brazil,203070494,Amapá,733759,0.5701,161,418343,0.1835,37,134624,0.0000,0,1
2021-08-23,Brazil,203070494,Amapá,733759,0.5733,2342,420685,0.1863,2099,136723,0.0000,0,1
2021-08-24,Brazil,203070494,Amapá,733759,0.5778,3297,423982,0.1892,2122,138845,0.0000,0,1
2021-08-25,Brazil,203070494,Amapá,733759,0.5832,3933,427915,0.1919,1944,140789,0.0000,0,1
2021-08-26,Brazil,203070494,Amapá,733759,0.5884,3849,431764,0.1956,2734,143523,0.0000,0,1
2021-08-27,Brazil,203070494,Amapá,733759,0.5931,3405,435169,0.1983,1964,145487,0.0000,0,1
2021-08-28,Brazil,203070494,Amapá,733759,0.5988,4194,439363,0.2027,3269,148756,0.0000,0,1
2021-08-29,Brazil,203070494,Amapá,733759,0.5990,126,439489,0.2028,35,148791,0.0000,0,1
2021-08-30,Brazil,203070494,Amapá,733759,0.6031,3049,442538,0.2073,3302,152093,0.0000,0,1
2021-08-31,Brazil,203070494,Amapá,733759,0.6072,2973,445511,0.2149,5610,157703,0.0000,0,1
2021-09-01,Brazil,203070494,Amapá,733759,0.6110,2846,448357,0.2208,4331,162034,0.0000,0,1
2021-09-02,Brazil,203070494,Amapá,733759,0.6141,2238,450595,0.2246,2757,164791,0.0000,0,1
2021-09-03,Brazil,203070494,Amapá,733759,0.6174,2416,453011,0.2296,3669,168460,0.0000,0,1
2021-09-04,Brazil,203070494,Amapá,733759,0.6221,3441,456452,0.2333,2697,171157,0.0000,0,1
2021-09-05,Brazil,203070494,Amapá,733759,0.6221,14,456466,0.2333,45,171202,0.0000,0,1
2021-09-06,Brazil,203070494,Amapá,733759,0.6245,1781,458247,0.2372,2809,174011,0.0000,0,1
2021-09-07,Brazil,203070494,Amapá,733759,0.6246,88,458335,0.2389,1274,175285,0.0000,0,1
2021-09-08,Brazil,203070494,Amapá,733759,0.6277,2231,460566,0.2432,3144,178429,0.0000,0,1
2021-09-09,Brazil,203070494,Amapá,733759,0.6315,2798,463364,0.2481,3622,182051,0.0000,0,1
2021-09-10,Brazil,203070494,Amapá,733759,0.6351,2618,465982,0.2524,3148,185199,0.0000,0,1
2021-09-11,Brazil,203070494,Amapá,733759,0.6414,4624,470606,0.2552,2081,187280,0.0000,0,1
2021-09-12,Brazil,203070494,Amapá,733759,0.6414,13,470619,0.2553,13,187293,0.0000,0,1
2021-09-13,Brazil,203070494,Amapá,733759,0.6414,36,470655,0.2553,64,187357,0.0000,0,1
2021-09-14,Brazil,203070494,Amapá,733759,0.6449,2542,473197,0.2622,5010,192367,0.0000,0,1
2021-09-15,Brazil,203070494,Amapá,733759,0.6474,1860,475057,0.2684,4545,196912,0.0000,0,1
2021-09-16,Brazil,203070494,Amapá,733759,0.6484,676,475733,0.2724,2960,199872,0.0000,0,1
2021-09-17,Brazil,203070494,Amapá,733759,0.6492,643,476376,0.2759,2574,202446,0.0000,0,1
2021-09-18,Brazil,203070494,Amapá,733759,0.6507,1082,477458,0.2788,2099,204545,0.0000,0,1
2021-09-19,Brazil,203070494,Amapá,733759,0.6507,14,477472,0.2788,23,204568,0.0000,0,1
2021-09-20,Brazil,203070494,Amapá,733759,0.6517,699,478171,0.2832,3206,207774,0.0000,0,1
2021-09-21,Brazil,203070494,Amapá,733759,0.6534,1236,479407,0.2873,3019,210793,0.0000,0,1
2021-09-22,Brazil,203070494,Amapá,733759,0.6550,1208,480615,0.2915,3099,213892,0.0000,0,1
2021-09-23,Brazil,203070494,Amapá,733759,0.6564,1058,481673,0.2956,3036,216928,0.0000,0,1
2021-09-24,Brazil,203070494,Amapá,733759,0.6584,1435,483108,0.2991,2568,219496,0.0000,0,1
2021-09-25,Brazil,203070494,Amapá,733759,0.6602,1300,484408,0.3017,1890,221386,0.0000,0,1
2021-09-26,Brazil,203070494,Amapá,733759,0.6602,30,484438,0.3017,23,221409,0.0000,0,1
2021-09-27,Brazil,203070494,Amapá,733759,0.6619,1204,485642,0.3057,2891,224300,0.0000,0,1
2021-09-28,Brazil,203070494,Amapá,733759,0.6634,1106,486748,0.3088,2262,226562,0.0000,0,1
2021-09-29,Brazil,203070494,Amapá,733759,0.6647,1015,487763,0.3122,2520,229082,0.0000,0,1
2021-09-30,Brazil,203070494,Amapá,733759,0.6661,967,488730,0.3158,2656,231738,0.0000,0,1
2021-10-01,Brazil,203070494,Amapá,733759,0.6671,725,489455,0.3202,3223,234961,0.0000,0,1
2021-10-02,Brazil,203070494,Amapá,733759,0.6681,733,490188,0.3231,2101,237062,0.0000,0,1
2021-10-03,Brazil,203070494,Amapá,733759,0.6681,13,490201,0.3231,12,237074,0.0000,0,1
2021-10-04,Brazil,203070494,Amapá,733759,0.6692,806,491007,0.3273,3075,240149,0.0000,0,1
2021-10-05,Brazil,203070494,Amapá,733759,0.6704,881,491888,0.3323,3655,243804,0.0000,0,1
2021-10-06,Brazil,203070494,Amapá,733759,0.6717,972,492860,0.3366,3178,246982,0.0000,0,1
2021-10-07,Brazil,203070494,Amapá,733759,0.6728,838,493698,0.3401,2533,249515,0.0000,0,1
2021-10-08,Brazil,203070494,Amapá,733759,0.6736,592,494290,0.3441,2972,252487,0.0000,1,2
2021-10-09,Brazil,203070494,Amapá,733759,0.6743,511,494801,0.3474,2426,254913,0.0000,0,2
2021-10-10,Brazil,203070494,Amapá,733759,0.6744,28,494829,0.3478,253,255166,0.0000,0,2
2021-10-11,Brazil,203070494,Amapá,733759,0.6751,528,495357,0.3512,2554,257720,0.0000,0,2
2021-10-12,Brazil,203070494,Amapá,733759,0.6752,46,495403,0.3514,102,257822,0.0000,0,2
2021-10-13,Brazil,203070494,Amapá,733759,0.6762,757,496160,0.3564,3706,261528,0.0000,0,2
2021-10-14,Brazil,203070494,Amapá,733759,0.6772,746,496906,0.3617,3865,265393,0.0000,1,3
2021-10-15,Brazil,203070494,Amapá,733759,0.6778,469,497375,0.3657,2923,268316,0.0000,0,3
2021-10-16,Brazil,203070494,Amapá,733759,0.6784,411,497786,0.3683,1918,270234,0.0000,0,3
2021-10-17,Brazil,203070494,Amapá,733759,0.6784,8,497794,0.3683,8,270242,0.0000,0,3
2021-10-18,Brazil,203070494,Amapá,733759,0.6795,788,498582,0.3740,4210,274452,0.0000,0,3
2021-10-19,Brazil,203070494,Amapá,733759,0.6808,993,499575,0.3799,4328,278780,0.0000,0,3
2021-10-20,Brazil,203070494,Amapá,733759,0.6822,972,500547,0.3856,4163,282943,0.0000,0,3
2021-10-21,Brazil,203070494,Amapá,733759,0.6833,796,501343,0.3897,2968,285911,0.0000,0,3
2021-10-22,Brazil,203070494,Amapá,733759,0.6842,663,502006,0.3932,2585,288496,0.0000,0,3
2021-10-23,Brazil,203070494,Amapá,733759,0.6847,368,502374,0.3950,1370,289866,0.0000,0,3
2021-10-24,Brazil,203070494,Amapá,733759,0.6847,67,502441,0.3951,67,289933,0.0000,0,3
2021-10-25,Brazil,203070494,Amapá,733759,0.6856,659,503100,0.3994,3128,293061,0.0000,0,3
2021-10-26,Brazil,203070494,Amapá,733759,0.6864,537,503637,0.4037,3189,296250,0.0000,0,3
2021-10-27,Brazil,203070494,Amapá,733759,0.6877,933,504570,0.4095,4223,300473,0.0000,0,3
2021-10-28,Brazil,203070494,Amapá,733759,0.6886,675,505245,0.4135,2968,303441,0.0000,0,3
2021-10-29,Brazil,203070494,Amapá,733759,0.6895,716,505961,0.4177,3085,306526,0.0000,0,3
2021-10-30,Brazil,203070494,Amapá,733759,0.6899,258,506219,0.4193,1148,307674,0.0000,0,3
2021-10-31,Brazil,203070494,Amapá,733759,0.6899,3,506222,0.4194,37,307711,0.0000,0,3
2021-11-01,Brazil,203070494,Amapá,733759,0.6902,210,506432,0.4197,282,307993,0.0000,0,3
2021-11-02,Brazil,203070494,Amapá,733759,0.6903,94,506526,0.4198,19,308012,0.0000,0,3
2021-11-03,Brazil,203070494,Amapá,733759,0.6911,547,507073,0.4245,3477,311489,0.0000,0,3
2021-11-04,Brazil,203070494,Amapá,733759,0.6917,448,507521,0.4286,3005,314494,0.0000,0,3
2021-11-05,Brazil,203070494,Amapá,733759,0.6922,413,507934,0.4323,2689,317183,0.0000,0,3
2021-11-06,Brazil,203070494,Amapá,733759,0.6925,194,508128,0.4340,1293,318476,0.0000,0,3
2021-11-07,Brazil,203070494,Amapá,733759,0.6925,8,508136,0.4340,8,318484,0.0000,0,3
2021-11-08,Brazil,203070494,Amapá,733759,0.6937,863,508999,0.4383,3137,321621,0.0000,0,3
2021-11-09,Brazil,203070494,Amapá,733759,0.6947,768,509767,0.4431,3543,325164,0.0000,0,3
2021-11-10,Brazil,203070494,Amapá,733759,0.6961,992,510759,0.4484,3878,329042,0.0000,0,3
2021-11-11,Brazil,203070494,Amapá,733759,0.6971,733,511492,0.4522,2752,331794,0.0000,0,3
2021-11-12,Brazil,203070494,Amapá,733759,0.6979,604,512096,0.4562,2911,334705,0.0000,0,3
2021-11-13,Brazil,203070494,Amapá,733759,0.6981,121,512217,0.4575,988,335693,0.0000,0,3
2021-11-14,Brazil,203070494,Amapá,733759,0.6981,23,512240,0.4575,16,335709,0.0000,0,3
2021-11-15,Brazil,203070494,Amapá,733759,0.6981,30,512270,0.4576,54,335763,0.0000,0,3
2021-11-16,Brazil,203070494,Amapá,733759,0.6990,638,512908,0.4616,2974,338737,0.0000,0,3
2021-11-17,Brazil,203070494,Amapá,733759,0.6999,665,513573,0.4660,3202,341939,0.0000,0,3
2021-11-18,Brazil,203070494,Amapá,733759,0.7007,548,514121,0.4703,3142,345081,0.0000,0,3
2021-11-19,Brazil,203070494,Amapá,733759,0.7014,522,514643,0.4741,2806,347887,0.0000,0,3
2021-11-20,Brazil,203070494,Amapá,733759,0.7016,141,514784,0.4751,746,348633,0.0000,0,3
2021-11-21,Brazil,203070494,Amapá,733759,0.7016,30,514814,0.4752,42,348675,0.0000,0,3
2021-11-22,Brazil,203070494,Amapá,733759,0.7023,528,515342,0.4791,2837,351512,0.0000,0,3
2021-11-23,Brazil,203070494,Amapá,733759,0.7031,591,515933,0.4830,2876,354388,0.0000,1,4
2021-11-24,Brazil,203070494,Amapá,733759,0.7040,649,516582,0.4866,2693,357081,0.0000,0,4
2021-11-25,Brazil,203070494,Amapá,733759,0.7049,652,517234,0.4905,2794,359875,0.0000,0,4
2021-11-26,Brazil,203070494,Amapá,733759,0.7057,611,517845,0.4938,2471,362346,0.0000,1,5
2021-11-27,Brazil,203070494,Amapá,733759,0.7059,118,517963,0.4947,627,362973,0.0000,0,5
2021-11-28,Brazil,203070494,Amapá,733759,0.7060,39,518002,0.4948,58,363031,0.0000,0,5
2021-11-29,Brazil,203070494,Amapá,733759,0.7068,603,518605,0.4985,2740,365771,0.0000,0,5
2021-11-30,Brazil,203070494,Amapá,733759,0.7070,158,518763,0.4994,704,366475,0.0000,0,5
2021-12-01,Brazil,203070494,Amapá,733759,0.7080,719,519482,0.5030,2572,369047,0.0000,0,5
2021-12-02,Brazil,203070494,Amapá,733759,0.7091,797,520279,0.5069,2863,371910,0.0000,0,5
2021-12-03,Brazil,203070494,Amapá,733759,0.7100,691,520970,0.5106,2747,374657,0.0000,0,5
2021-12-04,Brazil,203070494,Amapá,733759,0.7110,747,521717,0.5149,3165,377822,0.0000,0,5
2021-12-05,Brazil,203070494,Amapá,733759,0.7111,57,521774,0.5151,121,377943,0.0000,0,5
2021-12-06,Brazil,203070494,Amapá,733759,0.7119,566,522340,0.5183,2337,380280,0.0000,0,5
2021-12-07,Brazil,203070494,Amapá,733759,0.7130,820,523160,0.5217,2499,382779,0.0000,0,5
2021-12-08,Brazil,203070494,Amapá,733759,0.7134,322,523482,0.5230,994,383773,0.0000,0,5
2021-12-09,Brazil,203070494,Amapá,733759,0.7144,735,524217,0.5263,2431,386204,0.0000,0,5
2021-12-10,Brazil,203070494,Amapá,733759,0.7153,652,524869,0.5287,1719,387923,0.0000,0,5
2021-12-11,Brazil,203070494,Amapá,733759,0.7157,284,525153,0.5296,709,388632,0.0000,0,5
2021-12-12,Brazil,203070494,Amapá,733759,0.7160,249,525402,0.5298,105,388737,0.0000,0,5
2021-12-13,Brazil,203070494,Amapá,733759,0.7168,575,525977,0.5322,1779,390516,0.0000,0,5
2021-12-14,Brazil,203070494,Amapá,733759,0.7178,714,526691,0.5350,2063,392579,0.0000,0,5
2021-12-15,Brazil,203070494,Amapá,733759,0.7184,449,527140,0.5373,1677,394256,0.0000,0,5
2021-12-16,Brazil,203070494,Amapá,733759,0.7190,438,527578,0.5393,1426,395682,0.0000,0,5
2021-12-17,Brazil,203070494,Amapá,733759,0.7194,261,527839,0.5405,884,396566,0.0000,0,5
2021-12-18,Brazil,203070494,Amapá,733759,0.7195,104,527943,0.5411,435,397001,0.0000,0,5
2021-12-19,Brazil,203070494,Amapá,733759,0.7195,3,527946,0.5411,27,397028,0.0000,0,5
2021-12-20,Brazil,203070494,Amapá,733759,0.7201,423,528369,0.5427,1161,398189,0.0000,0,5
2021-12-21,Brazil,203070494,Amapá,733759,0.7205,327,528696,0.5441,1032,399221,0.0000,0,5
2021-12-22,Brazil,203070494,Amapá,733759,0.7208,186,528882,0.5451,763,399984,0.0000,0,5
2021-12-23,Brazil,203070494,Amapá,733759,0.7209,108,528990,0.5458,469,400453,0.0000,0,5
2021-12-24,Brazil,203070494,Amapá,733759,0.7210,30,529020,0.5459,102,400555,0.0000,0,5
2021-12-25,Brazil,203070494,Amapá,733759,0.7210,9,529029,0.5459,24,400579,0.0000,0,5
2021-12-26,Brazil,203070494,Amapá,733759,0.7210,10,529039,0.5460,52,400631,0.0000,0,5
2021-12-27,Brazil,203070494,Amapá,733759,0.7214,275,529314,0.5470,753,401384,0.0000,0,5
2021-12-28,Brazil,203070494,Amapá,733759,0.7217,215,529529,0.5482,837,402221,0.0000,0,5
2021-12-29,Brazil,203070494,Amapá,733759,0.7219,186,529715,0.5491,662,402883,0.0000,0,5
2021-12-30,Brazil,203070494,Amapá,733759,0.7221,115,529830,0.5496,427,403310,0.0000,0,5
2021-12-31,Brazil,203070494,Amapá,733759,0.7221,11,529841,0.5497,32,403342,0.0000,0,5
2021-01-02,Brazil,203070494,Amazonas,3941613,0.0000,23,23,0.0000,0,0,0.0000,0,0
2021-01-03,Brazil,203070494,Amazonas,3941613,0.0000,0,23,0.0000,1,1,0.0000,0,0
2021-01-08,Brazil,203070494,Amazonas,3941613,0.0000,1,24,0.0000,0,1,0.0000,0,0
2021-01-10,Brazil,203070494,Amazonas,3941613,0.0000,0,24,0.0000,1,2,0.0000,0,0
2021-01-11,Brazil,203070494,Amazonas,3941613,0.0000,0,24,0.0000,1,3,0.0000,0,0
2021-01-14,Brazil,203070494,Amazonas,3941613,0.0000,3,27,0.0000,0,3,0.0000,0,0
2021-01-17,Brazil,203070494,Amazonas,3941613,0.0000,18,45,0.0000,1,4,0.0000,0,0
2021-01-18,Brazil,203070494,Amazonas,3941613,0.0000,43,88,0.0000,0,4,0.0000,0,0
2021-01-19,Brazil,203070494,Amazonas,3941613,0.0005,1814,1902,0.0000,3,7,0.0000,0,0
2021-01-20,Brazil,203070494,Amazonas,3941613,0.0027,8675,10577,0.0000,13,20,0.0000,0,0
2021-01-21,Brazil,203070494,Amazonas,3941613,0.0042,5992,16569,0.0000,6,26,0.0000,0,0
2021-01-22,Brazil,203070494,Amazonas,3941613,0.0059,6596,23165,0.0000,18,44,0.0000,0,0
2021-01-23,Brazil,203070494,Amazonas,3941613,0.0076,6850,30015,0.0000,21,65,0.0000,0,0
2021-01-24,Brazil,203070494,Amazonas,3941613,0.0087,4137,34152,0.0000,4,69,0.0000,0,0
2021-01-25,Brazil,203070494,Amazonas,3941613,0.0112,9892,44044,0.0000,8,77,0.0000,0,0
2021-01-26,Brazil,203070494,Amazonas,3941613,0.0129,6966,51010,0.0000,22,99,0.0000,1,1
2021-01-27,Brazil,203070494,Amazonas,3941613,0.0152,8744,59754,0.0000,12,111,0.0000,5,6
2021-01-28,Brazil,203070494,Amazonas,3941613,0.0169,6695,66449,0.0000,10,121,0.0000,0,6
2021-01-29,Brazil,203070494,Amazonas,3941613,0.0193,9613,76062,0.0000,3,124,0.0000,0,6
2021-01-30,Brazil,203070494,Amazonas,3941613,0.0214,8277,84339,0.0000,8,132,0.0000,0,6
2021-01-31,Brazil,203070494,Amazonas,3941613,0.0234,8067,92406,0.0000,5,137,0.0000,0,6
2021-02-01,Brazil,203070494,Amazonas,3941613,0.0267,12741,105147,0.0000,28,165,0.0000,0,6
2021-02-02,Brazil,203070494,Amazonas,3941613,0.0308,16240,121387,0.0000,30,195,0.0000,0,6
2021-02-03,Brazil,203070494,Amazonas,3941613,0.0348,15688,137075,0.0001,35,230,0.0000,1,7
2021-02-04,Brazil,203070494,Amazonas,3941613,0.0374,10491,147566,0.0001,54,284,0.0000,0,7
2021-02-05,Brazil,203070494,Amazonas,3941613,0.0398,9162,156728,0.0001,222,506,0.0000,0,7
2021-02-06,Brazil,203070494,Amazonas,3941613,0.0406,3306,160034,0.0002,292,798,0.0000,0,7
2021-02-07,Brazil,203070494,Amazonas,3941613,0.0407,480,160514,0.0003,281,1079,0.0000,0,7
2021-02-08,Brazil,203070494,Amazonas,3941613,0.0453,18019,178533,0.0004,521,1600,0.0000,0,7
2021-02-09,Brazil,203070494,Amazonas,3941613,0.0494,16163,194696,0.0015,4178,5778,0.0000,0,7
2021-02-10,Brazil,203070494,Amazonas,3941613,0.0523,11583,206279,0.0021,2379,8157,0.0000,0,7
2021-02-11,Brazil,203070494,Amazonas,3941613,0.0542,7550,213829,0.0026,2221,10378,0.0000,0,7
2021-02-12,Brazil,203070494,Amazonas,3941613,0.0559,6491,220320,0.0034,3181,13559,0.0000,0,7
2021-02-13,Brazil,203070494,Amazonas,3941613,0.0567,2981,223301,0.0040,2249,15808,0.0000,0,7
2021-02-14,Brazil,203070494,Amazonas,3941613,0.0568,735,224036,0.0043,1192,17000,0.0000,0,7
2021-02-15,Brazil,203070494,Amazonas,3941613,0.0580,4469,228505,0.0053,3724,20724,0.0000,0,7
2021-02-16,Brazil,203070494,Amazonas,3941613,0.0589,3495,232000,0.0061,3196,23920,0.0000,0,7
2021-02-17,Brazil,203070494,Amazonas,3941613,0.0600,4415,236415,0.0076,6218,30138,0.0000,0,7
2021-02-18,Brazil,203070494,Amazonas,3941613,0.0609,3504,239919,0.0090,5343,35481,0.0000,0,7
2021-02-19,Brazil,203070494,Amazonas,3941613,0.0617,3411,243330,0.0101,4309,39790,0.0000,0,7
2021-02-20,Brazil,203070494,Amazonas,3941613,0.0621,1438,244768,0.0109,3120,42910,0.0000,0,7
2021-02-21,Brazil,203070494,Amazonas,3941613,0.0622,312,245080,0.0111,856,43766,0.0000,0,7
2021-02-22,Brazil,203070494,Amazonas,3941613,0.0629,2735,247815,0.0120,3604,47370,0.0000,0,7
2021-02-23,Brazil,203070494,Amazonas,3941613,0.0634,2250,250065,0.0130,3950,51320,0.0000,0,7
2021-02-24,Brazil,203070494,Amazonas,3941613,0.0640,2218,252283,0.0139,3511,54831,0.0000,0,7
2021-02-25,Brazil,203070494,Amazonas,3941613,0.0645,1897,254180,0.0147,2938,57769,0.0000,0,7
2021-02-26,Brazil,203070494,Amazonas,3941613,0.0651,2433,256613,0.0162,6225,63994,0.0000,0,7
2021-02-27,Brazil,203070494,Amazonas,3941613,0.0658,2717,259330,0.0172,3644,67638,0.0000,0,7
2021-02-28,Brazil,203070494,Amazonas,3941613,0.0660,746,260076,0.0173,519,68157,0.0000,0,7
2021-03-01,Brazil,203070494,Amazonas,3941613,0.0681,8310,268386,0.0185,4686,72843,0.0000,1,8
2021-03-02,Brazil,203070494,Amazonas,3941613,0.0711,11919,280305,0.0195,3978,76821,0.0000,2,10
2021-03-03,Brazil,203070494,Amazonas,3941613,0.0745,13459,293764,0.0209,5559,82380,0.0000,0,10
2021-03-04,Brazil,203070494,Amazonas,3941613,0.0776,11928,305692,0.0224,5822,88202,0.0000,0,10
2021-03-05,Brazil,203070494,Amazonas,3941613,0.0810,13636,319328,0.0238,5484,93686,0.0000,0,10
2021-03-06,Brazil,203070494,Amazonas,3941613,0.0827,6543,325871,0.0247,3706,97392,0.0000,0,10
2021-03-07,Brazil,203070494,Amazonas,3941613,0.0828,319,326190,0.0248,317,97709,0.0000,0,10
2021-03-08,Brazil,203070494,Amazonas,3941613,0.0839,4550,330740,0.0256,3301,101010,0.0000,0,10
2021-03-09,Brazil,203070494,Amazonas,3941613,0.0852,5214,335954,0.0263,2623,103633,0.0000,0,10
2021-03-10,Brazil,203070494,Amazonas,3941613,0.0870,7042,342996,0.0271,3065,106698,0.0000,0,10
2021-03-11,Brazil,203070494,Amazonas,3941613,0.0895,9681,352677,0.0277,2352,109050,0.0000,0,10
2021-03-12,Brazil,203070494,Amazonas,3941613,0.0918,8969,361646,0.0282,2190,111240,0.0000,0,10
2021-03-13,Brazil,203070494,Amazonas,3941613,0.0934,6567,368213,0.0286,1413,112653,0.0000,0,10
2021-03-14,Brazil,203070494,Amazonas,3941613,0.0935,183,368396,0.0287,354,113007,0.0000,0,10
2021-03-15,Brazil,203070494,Amazonas,3941613,0.0959,9763,378159,0.0292,2168,115175,0.0000,0,10
2021-03-16,Brazil,203070494,Amazonas,3941613,0.0977,7092,385251,0.0297,1819,116994,0.0000,0,10
2021-03-17,Brazil,203070494,Amazonas,3941613,0.1003,10138,395389,0.0302,2176,119170,0.0000,0,10
2021-03-18,Brazil,203070494,Amazonas,3941613,0.1019,6223,401612,0.0307,1658,120828,0.0000,0,10
2021-03-19,Brazil,203070494,Amazonas,3941613,0.1044,10064,411676,0.0312,2126,122954,0.0000,0,10
2021-03-20,Brazil,203070494,Amazonas,3941613,0.1063,7462,419138,0.0314,861,123815,0.0000,1,11
2021-03-21,Brazil,203070494,Amazonas,3941613,0.1064,258,419396,0.0315,308,124123,0.0000,0,11
2021-03-22,Brazil,203070494,Amazonas,3941613,0.1072,3212,422608,0.0319,1793,125916,0.0000,6,17
2021-03-23,Brazil,203070494,Amazonas,3941613,0.1080,3109,425717,0.0323,1483,127399,0.0000,0,17
2021-03-24,Brazil,203070494,Amazonas,3941613,0.1087,2765,428482,0.0326,1264,128663,0.0000,0,17
2021-03-25,Brazil,203070494,Amazonas,3941613,0.1093,2391,430873,0.0329,1184,129847,0.0000,0,17
2021-03-26,Brazil,203070494,Amazonas,3941613,0.1099,2449,433322,0.0333,1553,131400,0.0000,0,17
2021-03-27,Brazil,203070494,Amazonas,3941613,0.1104,1724,435046,0.0335,757,132157,0.0000,0,17
2021-03-28,Brazil,203070494,Amazonas,3941613,0.1105,641,435687,0.0336,171,132328,0.0000,0,17
2021-03-29,Brazil,203070494,Amazonas,3941613,0.1117,4501,440188,0.0340,1832,134160,0.0000,1,18
2021-03-30,Brazil,203070494,Amazonas,3941613,0.1131,5776,445964,0.0344,1516,135676,0.0000,0,18
2021-03-31,Brazil,203070494,Amazonas,3941613,0.1151,7625,453589,0.0348,1359,137035,0.0000,0,18
2021-04-01,Brazil,203070494,Amazonas,3941613,0.1164,5215,458804,0.0351,1158,138193,0.0000,0,18
2021-04-02,Brazil,203070494,Amazonas,3941613,0.1165,406,459210,0.0351,269,138462,0.0000,0,18
2021-04-03,Brazil,203070494,Amazonas,3941613,0.1184,7435,466645,0.0353,625,139087,0.0000,0,18
2021-04-04,Brazil,203070494,Amazonas,3941613,0.1185,338,466983,0.0353,58,139145,0.0000,0,18
2021-04-05,Brazil,203070494,Amazonas,3941613,0.1200,6012,472995,0.0364,4179,143324,0.0000,0,18
2021-04-06,Brazil,203070494,Amazonas,3941613,0.1223,9233,482228,0.0373,3581,146905,0.0000,0,18
2021-04-07,Brazil,203070494,Amazonas,3941613,0.1248,9611,491839,0.0381,3213,150118,0.0000,0,18
2021-04-08,Brazil,203070494,Amazonas,3941613,0.1274,10491,502330,0.0391,4053,154171,0.0000,0,18
2021-04-09,Brazil,203070494,Amazonas,3941613,0.1297,8798,511128,0.0404,5115,159286,0.0000,0,18
2021-04-10,Brazil,203070494,Amazonas,3941613,0.1315,7152,518280,0.0415,4267,163553,0.0000,0,18
2021-04-11,Brazil,203070494,Amazonas,3941613,0.1317,650,518930,0.0416,566,164119,0.0000,0,18
2021-04-12,Brazil,203070494,Amazonas,3941613,0.1336,7772,526702,0.0439,8916,173035,0.0000,0,18
2021-04-13,Brazil,203070494,Amazonas,3941613,0.1361,9656,536358,0.0455,6143,179178,0.0000,0,18
2021-04-14,Brazil,203070494,Amazonas,3941613,0.1388,10550,546908,0.0471,6371,185549,0.0000,0,18
2021-04-15,Brazil,203070494,Amazonas,3941613,0.1410,8689,555597,0.0484,5211,190760,0.0000,0,18
2021-04-16,Brazil,203070494,Amazonas,3941613,0.1430,7968,563565,0.0500,6481,197241,0.0000,0,18
2021-04-17,Brazil,203070494,Amazonas,3941613,0.1438,3393,566958,0.0513,5024,202265,0.0000,0,18
2021-04-18,Brazil,203070494,Amazonas,3941613,0.1441,885,567843,0.0514,238,202503,0.0000,0,18
2021-04-19,Brazil,203070494,Amazonas,3941613,0.1458,6823,574666,0.0526,4850,207353,0.0000,0,18
2021-04-20,Brazil,203070494,Amazonas,3941613,0.1481,8936,583602,0.0541,5749,213102,0.0000,0,18
2021-04-21,Brazil,203070494,Amazonas,3941613,0.1499,7437,591039,0.0553,4756,217858,0.0000,1,19
2021-04-22,Brazil,203070494,Amazonas,3941613,0.1518,7459,598498,0.0571,7058,224916,0.0000,0,19
2021-04-23,Brazil,203070494,Amazonas,3941613,0.1534,6276,604774,0.0588,6917,231833,0.0000,0,19
2021-04-24,Brazil,203070494,Amazonas,3941613,0.1546,4563,609337,0.0606,6940,238773,0.0000,8,27
2021-04-25,Brazil,203070494,Amazonas,3941613,0.1547,590,609927,0.0606,177,238950,0.0000,0,27
2021-04-26,Brazil,203070494,Amazonas,3941613,0.1563,6193,616120,0.0623,6443,245393,0.0000,1,28
2021-04-27,Brazil,203070494,Amazonas,3941613,0.1576,5249,621369,0.0646,9351,254744,0.0000,0,28
2021-04-28,Brazil,203070494,Amazonas,3941613,0.1584,3003,624372,0.0664,7146,261890,0.0000,0,28
2021-04-29,Brazil,203070494,Amazonas,3941613,0.1590,2474,626846,0.0698,13347,275237,0.0000,0,28
2021-04-30,Brazil,203070494,Amazonas,3941613,0.1599,3448,630294,0.0732,13246,288483,0.0000,1,29
2021-05-01,Brazil,203070494,Amazonas,3941613,0.1606,2619,632913,0.0754,8791,297274,0.0000,1,30
2021-05-02,Brazil,203070494,Amazonas,3941613,0.1607,436,633349,0.0755,375,297649,0.0000,0,30
2021-05-03,Brazil,203070494,Amazonas,3941613,0.1613,2370,635719,0.0786,12292,309941,0.0000,0,30
2021-05-04,Brazil,203070494,Amazonas,3941613,0.1620,2840,638559,0.0814,10843,320784,0.0000,1,31
2021-05-05,Brazil,203070494,Amazonas,3941613,0.1627,2581,641140,0.0842,10960,331744,0.0000,0,31
2021-05-06,Brazil,203070494,Amazonas,3941613,0.1635,3460,644600,0.0862,8077,339821,0.0000,0,31
2021-05-07,Brazil,203070494,Amazonas,3941613,0.1643,2967,647567,0.0881,7629,347450,0.0000,0,31
2021-05-08,Brazil,203070494,Amazonas,3941613,0.1648,1920,649487,0.0897,6243,353693,0.0000,0,31
2021-05-09,Brazil,203070494,Amazonas,3941613,0.1649,590,650077,0.0898,163,353856,0.0000,0,31
2021-05-10,Brazil,203070494,Amazonas,3941613,0.1663,5235,655312,0.0920,8870,362726,0.0000,0,31
2021-05-11,Brazil,203070494,Amazonas,3941613,0.1682,7579,662891,0.0939,7387,370113,0.0000,0,31
2021-05-12,Brazil,203070494,Amazonas,3941613,0.1701,7741,670632,0.0954,5852,375965,0.0000,0,31
2021-05-13,Brazil,203070494,Amazonas,3941613,0.1718,6696,677328,0.0969,6173,382138,0.0000,0,31
2021-05-14,Brazil,203070494,Amazonas,3941613,0.1737,7318,684646,0.0985,6227,388365,0.0000,0,31
2021-05-15,Brazil,203070494,Amazonas,3941613,0.1748,4462,689108,0.0998,5074,393439,0.0000,0,31
2021-05-16,Brazil,203070494,Amazonas,3941613,0.1749,396,689504,0.0999,206,393645,0.0000,0,31
2021-05-17,Brazil,203070494,Amazonas,3941613,0.1766,6455,695959,0.1014,6144,399789,0.0000,0,31
2021-05-18,Brazil,203070494,Amazonas,3941613,0.1783,6879,702838,0.1031,6518,406307,0.0000,0,31
2021-05-19,Brazil,203070494,Amazonas,3941613,0.1818,13884,716722,0.1043,4824,411131,0.0000,0,31
2021-05-20,Brazil,203070494,Amazonas,3941613,0.1846,10856,727578,0.1064,8224,419355,0.0000,0,31
2021-05-21,Brazil,203070494,Amazonas,3941613,0.1876,11921,739499,0.1082,7273,426628,0.0000,0,31
2021-05-22,Brazil,203070494,Amazonas,3941613,0.1894,6912,746411,0.1096,5547,432175,0.0000,0,31
2021-05-23,Brazil,203070494,Amazonas,3941613,0.1895,493,746904,0.1097,113,432288,0.0000,0,31
2021-05-24,Brazil,203070494,Amazonas,3941613,0.1928,13157,760061,0.1108,4455,436743,0.0000,0,31
2021-05-25,Brazil,203070494,Amazonas,3941613,0.1959,12234,772295,0.1120,4708,441451,0.0000,0,31
2021-05-26,Brazil,203070494,Amazonas,3941613,0.1980,8315,780610,0.1134,5484,446935,0.0000,0,31
2021-05-27,Brazil,203070494,Amazonas,3941613,0.2002,8633,789243,0.1150,6265,453200,0.0000,0,31
2021-05-28,Brazil,203070494,Amazonas,3941613,0.2024,8365,797608,0.1159,3781,456981,0.0000,0,31
2021-05-29,Brazil,203070494,Amazonas,3941613,0.2035,4438,802046,0.1167,2851,459832,0.0000,0,31
2021-05-30,Brazil,203070494,Amazonas,3941613,0.2036,423,802469,0.1167,102,459934,0.0000,0,31
2021-05-31,Brazil,203070494,Amazonas,3941613,0.2054,7083,809552,0.1176,3483,463417,0.0000,0,31
2021-06-01,Brazil,203070494,Amazonas,3941613,0.2073,7588,817140,0.1190,5486,468903,0.0000,0,31
2021-06-02,Brazil,203070494,Amazonas,3941613,0.2111,15130,832270,0.1208,7271,476174,0.0000,0,31
2021-06-03,Brazil,203070494,Amazonas,3941613,0.2145,13238,845508,0.1220,4516,480690,0.0000,0,31
2021-06-04,Brazil,203070494,Amazonas,3941613,0.2172,10690,856198,0.1235,5974,486664,0.0000,0,31
2021-06-05,Brazil,203070494,Amazonas,3941613,0.2191,7351,863549,0.1243,3277,489941,0.0000,0,31
2021-06-06,Brazil,203070494,Amazonas,3941613,0.2191,140,863689,0.1243,45,489986,0.0000,0,31
2021-06-07,Brazil,203070494,Amazonas,3941613,0.2203,4809,868498,0.1250,2831,492817,0.0000,0,31
2021-06-08,Brazil,203070494,Amazonas,3941613,0.2235,12409,880907,0.1262,4696,497513,0.0000,0,31
2021-06-09,Brazil,203070494,Amazonas,3941613,0.2273,14861,895768,0.1272,3699,501212,0.0000,0,31
2021-06-10,Brazil,203070494,Amazonas,3941613,0.2312,15531,911299,0.1280,3456,504668,0.0000,0,31
2021-06-11,Brazil,203070494,Amazonas,3941613,0.2358,18330,929629,0.1291,4121,508789,0.0000,1,32
2021-06-12,Brazil,203070494,Amazonas,3941613,0.2524,65295,994924,0.1294,1266,510055,0.0000,13,45
2021-06-13,Brazil,203070494,Amazonas,3941613,0.2729,80629,1075553,0.1295,370,510425,0.0000,0,45
2021-06-14,Brazil,203070494,Amazonas,3941613,0.2752,9105,1084658,0.1300,1830,512255,0.0000,0,45
2021-06-15,Brazil,203070494,Amazonas,3941613,0.2811,23386,1108044,0.1309,3572,515827,0.0000,0,45
2021-06-16,Brazil,203070494,Amazonas,3941613,0.2865,21258,1129302,0.1316,2767,518594,0.0000,0,45
2021-06-17,Brazil,203070494,Amazonas,3941613,0.2918,20744,1150046,0.1323,2981,521575,0.0000,0,45
2021-06-18,Brazil,203070494,Amazonas,3941613,0.3008,35688,1185734,0.1331,3223,524798,0.0000,1,46
2021-06-19,Brazil,203070494,Amazonas,3941613,0.3156,58248,1243982,0.1335,1415,526213,0.0000,1,47
2021-06-20,Brazil,203070494,Amazonas,3941613,0.3162,2229,1246211,0.1335,170,526383,0.0000,0,47
2021-06-21,Brazil,203070494,Amazonas,3941613,0.3190,11243,1257454,0.1340,1811,528194,0.0000,0,47
2021-06-22,Brazil,203070494,Amazonas,3941613,0.3257,26507,1283961,0.1347,2890,531084,0.0000,0,47
2021-06-23,Brazil,203070494,Amazonas,3941613,0.3309,20317,1304278,0.1354,2740,533824,0.0000,0,47
2021-06-24,Brazil,203070494,Amazonas,3941613,0.3348,15190,1319468,0.1361,2548,536372,0.0000,0,47
2021-06-25,Brazil,203070494,Amazonas,3941613,0.3400,20654,1340122,0.1365,1788,538160,0.0000,0,47
2021-06-26,Brazil,203070494,Amazonas,3941613,0.3481,32061,1372183,0.1367,809,538969,0.0000,24,71
2021-06-27,Brazil,203070494,Amazonas,3941613,0.3487,2417,1374600,0.1368,143,539112,0.0000,0,71
2021-06-28,Brazil,203070494,Amazonas,3941613,0.3538,20064,1394664,0.1374,2648,541760,0.0000,0,71
2021-06-29,Brazil,203070494,Amazonas,3941613,0.3668,51113,1445777,0.1382,2954,544714,0.0000,0,71
2021-06-30,Brazil,203070494,Amazonas,3941613,0.3799,51527,1497304,0.1390,3179,547893,0.0000,4,75
2021-07-01,Brazil,203070494,Amazonas,3941613,0.3825,10480,1507784,0.1396,2421,550314,0.0000,0,75
2021-07-02,Brazil,203070494,Amazonas,3941613,0.3912,34345,1542129,0.1402,2379,552693,0.0000,0,75
2021-07-03,Brazil,203070494,Amazonas,3941613,0.3985,28729,1570858,0.1404,798,553491,0.0000,1,76
2021-07-04,Brazil,203070494,Amazonas,3941613,0.3986,452,1571310,0.1405,227,553718,0.0000,0,76
2021-07-05,Brazil,203070494,Amazonas,3941613,0.4034,18674,1589984,0.1412,2849,556567,0.0000,0,76
2021-07-06,Brazil,203070494,Amazonas,3941613,0.4095,24174,1614158,0.1421,3662,560229,0.0000,0,76
2021-07-07,Brazil,203070494,Amazonas,3941613,0.4144,19258,1633416,0.1431,3677,563906,0.0000,0,76
2021-07-08,Brazil,203070494,Amazonas,3941613,0.4202,22726,1656142,0.1440,3530,567436,0.0000,1,77
2021-07-09,Brazil,203070494,Amazonas,3941613,0.4323,48002,1704144,0.1448,3246,570682,0.0000,0,77
2021-07-10,Brazil,203070494,Amazonas,3941613,0.4364,15797,1719941,0.1452,1803,572485,0.0000,0,77
2021-07-11,Brazil,203070494,Amazonas,3941613,0.4364,164,1720105,0.1454,467,572952,0.0000,0,77
2021-07-12,Brazil,203070494,Amazonas,3941613,0.4381,6635,1726740,0.1463,3800,576752,0.0000,0,77
2021-07-13,Brazil,203070494,Amazonas,3941613,0.4398,6743,1733483,0.1474,4405,581157,0.0000,0,77
2021-07-14,Brazil,203070494,Amazonas,3941613,0.4410,4711,1738194,0.1486,4466,585623,0.0000,1,78
2021-07-15,Brazil,203070494,Amazonas,3941613,0.4424,5622,1743816,0.1499,5321,590944,0.0000,0,78
2021-07-16,Brazil,203070494,Amazonas,3941613,0.4530,41922,1785738,0.1509,3724,594668,0.0000,0,78
2021-07-17,Brazil,203070494,Amazonas,3941613,0.4578,18816,1804554,0.1512,1451,596119,0.0000,1,79
2021-07-18,Brazil,203070494,Amazonas,3941613,0.4579,320,1804874,0.1513,299,596418,0.0000,0,79
2021-07-19,Brazil,203070494,Amazonas,3941613,0.4589,4077,1808951,0.1524,4177,600595,0.0000,0,79
2021-07-20,Brazil,203070494,Amazonas,3941613,0.4600,4371,1813322,0.1535,4607,605202,0.0000,0,79
2021-07-21,Brazil,203070494,Amazonas,3941613,0.4719,46610,1859932,0.1550,5943,611145,0.0000,1,80
2021-07-22,Brazil,203070494,Amazonas,3941613,0.4813,37110,1897042,0.1565,5808,616953,0.0000,0,80
2021-07-23,Brazil,203070494,Amazonas,3941613,0.4850,14574,1911616,0.1576,4300,621253,0.0000,0,80
2021-07-24,Brazil,203070494,Amazonas,3941613,0.4853,1125,1912741,0.1578,790,622043,0.0000,0,80
2021-07-25,Brazil,203070494,Amazonas,3941613,0.4854,341,1913082,0.1579,390,622433,0.0000,0,80
2021-07-26,Brazil,203070494,Amazonas,3941613,0.4895,16424,1929506,0.1592,5061,627494,0.0000,0,80
2021-07-27,Brazil,203070494,Amazonas,3941613,0.4928,12885,1942391,0.1609,6543,634037,0.0000,0,80
2021-07-28,Brazil,203070494,Amazonas,3941613,0.4958,11911,1954302,0.1621,4894,638931,0.0000,0,80
2021-07-29,Brazil,203070494,Amazonas,3941613,0.4979,8416,1962718,0.1638,6847,645778,0.0000,0,80
2021-07-30,Brazil,203070494,Amazonas,3941613,0.5000,8178,1970896,0.1652,5322,651100,0.0000,0,80
2021-07-31,Brazil,203070494,Amazonas,3941613,0.5018,7118,1978014,0.1660,3113,654213,0.0000,0,80
2021-08-01,Brazil,203070494,Amazonas,3941613,0.5020,627,1978641,0.1661,462,654675,0.0000,0,80
2021-08-02,Brazil,203070494,Amazonas,3941613,0.5037,6656,1985297,0.1681,7758,662433,0.0000,0,80
2021-08-03,Brazil,203070494,Amazonas,3941613,0.5056,7417,1992714,0.1701,8204,670637,0.0000,0,80
2021-08-04,Brazil,203070494,Amazonas,3941613,0.5072,6447,1999161,0.1715,5222,675859,0.0000,0,80
2021-08-05,Brazil,203070494,Amazonas,3941613,0.5091,7605,2006766,0.1731,6393,682252,0.0000,1,81
2021-08-06,Brazil,203070494,Amazonas,3941613,0.5112,8106,2014872,0.1747,6267,688519,0.0000,1,82
2021-08-07,Brazil,203070494,Amazonas,3941613,0.5127,5876,2020748,0.1767,7985,696504,0.0000,0,82
2021-08-08,Brazil,203070494,Amazonas,3941613,0.5127,207,2020955,0.1768,287,696791,0.0000,0,82
2021-08-09,Brazil,203070494,Amazonas,3941613,0.5146,7373,2028328,0.1789,8285,705076,0.0000,0,82
2021-08-10,Brazil,203070494,Amazonas,3941613,0.5167,8343,2036671,0.1811,8876,713952,0.0000,0,82
2021-08-11,Brazil,203070494,Amazonas,3941613,0.5186,7514,2044185,0.1829,6947,720899,0.0000,0,82
2021-08-12,Brazil,203070494,Amazonas,3941613,0.5204,7028,2051213,0.1855,10249,731148,0.0000,0,82
2021-08-13,Brazil,203070494,Amazonas,3941613,0.5227,9041,2060254,0.1882,10835,741983,0.0000,0,82
2021-08-14,Brazil,203070494,Amazonas,3941613,0.5412,72796,2133050,0.1895,4889,746872,0.0000,3,85
2021-08-15,Brazil,203070494,Amazonas,3941613,0.5412,141,2133191,0.1895,160,747032,0.0000,0,85
2021-08-16,Brazil,203070494,Amazonas,3941613,0.5421,3587,2136778,0.1912,6795,753827,0.0000,1,86
2021-08-17,Brazil,203070494,Amazonas,3941613,0.5477,21960,2158738,0.1934,8445,762272,0.0000,0,86
2021-08-18,Brazil,203070494,Amazonas,3941613,0.5528,20153,2178891,0.1951,6863,769135,0.0000,0,86
2021-08-19,Brazil,203070494,Amazonas,3941613,0.5574,18270,2197161,0.1976,9633,778768,0.0000,1,87
2021-08-20,Brazil,203070494,Amazonas,3941613,0.5624,19519,2216680,0.2005,11339,790107,0.0000,0,87
2021-08-21,Brazil,203070494,Amazonas,3941613,0.5706,32360,2249040,0.2038,13264,803371,0.0000,2,89
2021-08-22,Brazil,203070494,Amazonas,3941613,0.5706,179,2249219,0.2039,178,803549,0.0000,0,89
2021-08-23,Brazil,203070494,Amazonas,3941613,0.5745,15309,2264528,0.2064,10102,813651,0.0000,0,89
2021-08-24,Brazil,203070494,Amazonas,3941613,0.5782,14698,2279226,0.2089,9683,823334,0.0000,0,89
2021-08-25,Brazil,203070494,Amazonas,3941613,0.5817,13806,2293032,0.2109,7778,831112,0.0000,0,89
2021-08-26,Brazil,203070494,Amazonas,3941613,0.5859,16363,2309395,0.2127,7304,838416,0.0000,1,90
2021-08-27,Brazil,203070494,Amazonas,3941613,0.5891,12438,2321833,0.2149,8647,847063,0.0000,3,93
2021-08-28,Brazil,203070494,Amazonas,3941613,0.5933,16852,2338685,0.2270,47508,894571,0.0000,6,99
2021-08-29,Brazil,203070494,Amazonas,3941613,0.5948,5590,2344275,0.2319,19302,913873,0.0000,0,99
2021-08-30,Brazil,203070494,Amazonas,3941613,0.5970,9004,2353279,0.2357,15071,928944,0.0000,1,100
2021-08-31,Brazil,203070494,Amazonas,3941613,0.6001,11897,2365176,0.2425,26862,955806,0.0000,0,100
2021-09-01,Brazil,203070494,Amazonas,3941613,0.6027,10525,2375701,0.2483,22807,978613,0.0000,0,100
2021-09-02,Brazil,203070494,Amazonas,3941613,0.6059,12400,2388101,0.2524,16366,994979,0.0000,0,100
2021-09-03,Brazil,203070494,Amazonas,3941613,0.6088,11429,2399530,0.2563,15205,1010184,0.0000,0,100
2021-09-04,Brazil,203070494,Amazonas,3941613,0.6107,7589,2407119,0.2591,11256,1021440,0.0000,1,101
2021-09-05,Brazil,203070494,Amazonas,3941613,0.6107,65,2407184,0.2592,74,1021514,0.0000,0,101
2021-09-06,Brazil,203070494,Amazonas,3941613,0.6120,5159,2412343,0.2622,12087,1033601,0.0000,0,101
2021-09-07,Brazil,203070494,Amazonas,3941613,0.6121,515,2412858,0.2623,424,1034025,0.0000,0,101
2021-09-08,Brazil,203070494,Amazonas,3941613,0.6146,9813,2422671,0.2671,18866,1052891,0.0000,0,101
2021-09-09,Brazil,203070494,Amazonas,3941613,0.6172,10148,2432819,0.2717,18075,1070966,0.0000,3,104
2021-09-10,Brazil,203070494,Amazonas,3941613,0.6200,10831,2443650,0.2782,25422,1096388,0.0000,0,104
2021-09-11,Brazil,203070494,Amazonas,3941613,0.6216,6408,2450058,0.2831,19425,1115813,0.0000,0,104
2021-09-12,Brazil,203070494,Amazonas,3941613,0.6216,170,2450228,0.2831,145,1115958,0.0000,3,107
2021-09-13,Brazil,203070494,Amazonas,3941613,0.6239,8920,2459148,0.2902,27953,1143911,0.0000,8,115
2021-09-14,Brazil,203070494,Amazonas,3941613,0.6264,9798,2468946,0.2971,27091,1171002,0.0000,0,115
2021-09-15,Brazil,203070494,Amazonas,3941613,0.6285,8233,2477179,0.3034,24933,1195935,0.0000,1,116
2021-09-16,Brazil,203070494,Amazonas,3941613,0.6299,5699,2482878,0.3083,19084,1215019,0.0000,0,116
2021-09-17,Brazil,203070494,Amazonas,3941613,0.6313,5400,2488278,0.3165,32457,1247476,0.0000,2,118
2021-09-18,Brazil,203070494,Amazonas,3941613,0.6337,9400,2497678,0.3278,44462,1291938,0.0000,9,127
2021-09-19,Brazil,203070494,Amazonas,3941613,0.6337,225,2497903,0.3278,304,1292242,0.0000,0,127
2021-09-20,Brazil,203070494,Amazonas,3941613,0.6356,7206,2505109,0.3351,28426,1320668,0.0000,0,127
2021-09-21,Brazil,203070494,Amazonas,3941613,0.6377,8312,2513421,0.3420,27399,1348067,0.0000,0,127
2021-09-22,Brazil,203070494,Amazonas,3941613,0.6398,8585,2522006,0.3473,20934,1369001,0.0000,3,130
2021-09-23,Brazil,203070494,Amazonas,3941613,0.6420,8527,2530533,0.3518,17838,1386839,0.0000,1,131
2021-09-24,Brazil,203070494,Amazonas,3941613,0.6439,7589,2538122,0.3565,18452,1405291,0.0000,0,131
2021-09-25,Brazil,203070494,Amazonas,3941613,0.6455,6105,2544227,0.3606,15915,1421206,0.0000,0,131
2021-09-26,Brazil,203070494,Amazonas,3941613,0.6456,304,2544531,0.3606,291,1421497,0.0000,0,131
2021-09-27,Brazil,203070494,Amazonas,3941613,0.6473,6781,2551312,0.3655,19084,1440581,0.0000,0,131
2021-09-28,Brazil,203070494,Amazonas,3941613,0.6490,6887,2558199,0.3703,18901,1459482,0.0000,1,132
2021-09-29,Brazil,203070494,Amazonas,3941613,0.6506,6337,2564536,0.3742,15351,1474833,0.0000,19,151
2021-09-30,Brazil,203070494,Amazonas,3941613,0.6521,5719,2570255,0.3779,14872,1489705,0.0000,0,151
2021-10-01,Brazil,203070494,Amazonas,3941613,0.6535,5442,2575697,0.3813,13141,1502846,0.0000,2,153
2021-10-02,Brazil,203070494,Amazonas,3941613,0.6542,2883,2578580,0.3848,13693,1516539,0.0000,14,167
2021-10-03,Brazil,203070494,Amazonas,3941613,0.6542,121,2578701,0.3848,73,1516612,0.0000,0,167
2021-10-04,Brazil,203070494,Amazonas,3941613,0.6551,3391,2582092,0.3875,10651,1527263,0.0000,0,167
2021-10-05,Brazil,203070494,Amazonas,3941613,0.6563,4944,2587036,0.3915,15889,1543152,0.0000,1,168
2021-10-06,Brazil,203070494,Amazonas,3941613,0.6578,5584,2592620,0.3952,14690,1557842,0.0000,10,178
2021-10-07,Brazil,203070494,Amazonas,3941613,0.6590,4824,2597444,0.3986,13328,1571170,0.0000,0,178
2021-10-08,Brazil,203070494,Amazonas,3941613,0.6604,5667,2603111,0.4017,12061,1583231,0.0000,3,181
2021-10-09,Brazil,203070494,Amazonas,3941613,0.6613,3634,2606745,0.4084,26620,1609851,0.0000,4,185
2021-10-10,Brazil,203070494,Amazonas,3941613,0.6614,309,2607054,0.4085,184,1610035,0.0000,2,187
2021-10-11,Brazil,203070494,Amazonas,3941613,0.6617,1302,2608356,0.4092,2889,1612924,0.0000,0,187
2021-10-12,Brazil,203070494,Amazonas,3941613,0.6619,478,2608834,0.4093,333,1613257,0.0000,0,187
2021-10-13,Brazil,203070494,Amazonas,3941613,0.6631,4686,2613520,0.4138,17768,1631025,0.0000,2,189
2021-10-14,Brazil,203070494,Amazonas,3941613,0.6643,5077,2618597,0.4184,18183,1649208,0.0001,9,198
2021-10-15,Brazil,203070494,Amazonas,3941613,0.6653,3914,2622511,0.4226,16652,1665860,0.0001,1,199
2021-10-16,Brazil,203070494,Amazonas,3941613,0.6658,1625,2624136,0.4230,1485,1667345,0.0001,1,200
2021-10-17,Brazil,203070494,Amazonas,3941613,0.6658,208,2624344,0.4230,136,1667481,0.0001,0,200
2021-10-18,Brazil,203070494,Amazonas,3941613,0.6671,4941,2629285,0.4278,18601,1686082,0.0001,24,224
2021-10-19,Brazil,203070494,Amazonas,3941613,0.6683,4726,2634011,0.4320,16828,1702910,0.0001,3,227
2021-10-20,Brazil,203070494,Amazonas,3941613,0.6696,5106,2639117,0.4358,15016,1717926,0.0001,5,232
2021-10-21,Brazil,203070494,Amazonas,3941613,0.6706,4290,2643407,0.4390,12611,1730537,0.0001,5,237
2021-10-22,Brazil,203070494,Amazonas,3941613,0.6719,4897,2648304,0.4430,15710,1746247,0.0001,5,242
2021-10-23,Brazil,203070494,Amazonas,3941613,0.6724,1869,2650173,0.4458,10877,1757124,0.0001,6,248
2021-10-24,Brazil,203070494,Amazonas,3941613,0.6724,278,2650451,0.4458,91,1757215,0.0001,0,248
2021-10-25,Brazil,203070494,Amazonas,3941613,0.6738,5263,2655714,0.4493,13612,1770827,0.0001,6,254
2021-10-26,Brazil,203070494,Amazonas,3941613,0.6749,4424,2660138,0.4528,13875,1784702,0.0001,2,256
2021-10-27,Brazil,203070494,Amazonas,3941613,0.6759,3983,2664121,0.4557,11318,1796020,0.0001,0,256
2021-10-28,Brazil,203070494,Amazonas,3941613,0.6765,2435,2666556,0.4581,9751,1805771,0.0001,1,257
2021-10-29,Brazil,203070494,Amazonas,3941613,0.6770,2096,2668652,0.4604,8855,1814626,0.0001,1,258
2021-10-30,Brazil,203070494,Amazonas,3941613,0.6775,1673,2670325,0.4626,8794,1823420,0.0001,0,258
2021-10-31,Brazil,203070494,Amazonas,3941613,0.6775,151,2670476,0.4626,114,1823534,0.0001,0,258
2021-11-01,Brazil,203070494,Amazonas,3941613,0.6776,524,2671000,0.4630,1274,1824808,0.0001,0,258
2021-11-02,Brazil,203070494,Amazonas,3941613,0.6777,119,2671119,0.4630,117,1824925,0.0001,2,260
2021-11-03,Brazil,203070494,Amazonas,3941613,0.6786,3774,2674893,0.4661,12314,1837239,0.0001,6,266
2021-11-04,Brazil,203070494,Amazonas,3941613,0.6795,3439,2678332,0.4690,11553,1848792,0.0001,12,278
2021-11-05,Brazil,203070494,Amazonas,3941613,0.6804,3415,2681747,0.4720,11789,1860581,0.0001,16,294
2021-11-06,Brazil,203070494,Amazonas,3941613,0.6808,1660,2683407,0.4742,8505,1869086,0.0001,5,299
2021-11-07,Brazil,203070494,Amazonas,3941613,0.6809,606,2684013,0.4747,2079,1871165,0.0001,4,303
2021-11-08,Brazil,203070494,Amazonas,3941613,0.6817,3075,2687088,0.4772,9924,1881089,0.0001,36,339
2021-11-09,Brazil,203070494,Amazonas,3941613,0.6826,3269,2690357,0.4798,10201,1891290,0.0001,44,383
2021-11-10,Brazil,203070494,Amazonas,3941613,0.6836,4158,2694515,0.4827,11384,1902674,0.0001,51,434
2021-11-11,Brazil,203070494,Amazonas,3941613,0.6847,4381,2698896,0.4858,12045,1914719,0.0001,58,492
2021-11-12,Brazil,203070494,Amazonas,3941613,0.6856,3535,2702431,0.4886,11155,1925874,0.0001,38,530
2021-11-13,Brazil,203070494,Amazonas,3941613,0.6861,2054,2704485,0.4910,9520,1935394,0.0002,273,803
2021-11-14,Brazil,203070494,Amazonas,3941613,0.6863,660,2705145,0.4913,1063,1936457,0.0003,193,996
2021-11-15,Brazil,203070494,Amazonas,3941613,0.6865,649,2705794,0.4914,404,1936861,0.0003,0,996
2021-11-16,Brazil,203070494,Amazonas,3941613,0.6873,3421,2709215,0.4940,10251,1947112,0.0003,34,1030
2021-11-17,Brazil,203070494,Amazonas,3941613,0.6884,4011,2713226,0.4969,11384,1958496,0.0003,41,1071
2021-11-18,Brazil,203070494,Amazonas,3941613,0.6892,3179,2716405,0.4997,11230,1969726,0.0014,4322,5393
2021-11-19,Brazil,203070494,Amazonas,3941613,0.6898,2416,2718821,0.5026,11220,1980946,0.0014,154,5547
2021-11-20,Brazil,203070494,Amazonas,3941613,0.6901,1097,2719918,0.5045,7599,1988545,0.0015,550,6097
2021-11-21,Brazil,203070494,Amazonas,3941613,0.6901,356,2720274,0.5047,915,1989460,0.0016,238,6335
2021-11-22,Brazil,203070494,Amazonas,3941613,0.6909,3012,2723286,0.5071,9274,1998734,0.0026,4080,10415
2021-11-23,Brazil,203070494,Amazonas,3941613,0.6916,2691,2725977,0.5083,4820,2003554,0.0026,29,10444
2021-11-24,Brazil,203070494,Amazonas,3941613,0.6923,2679,2728656,0.5106,9058,2012612,0.0034,3138,13582
2021-11-25,Brazil,203070494,Amazonas,3941613,0.6930,2925,2731581,0.5135,11416,2024028,0.0045,4029,17611
2021-11-26,Brazil,203070494,Amazonas,3941613,0.6936,2336,2733917,0.5158,9111,2033139,0.0053,3095,20706
2021-11-27,Brazil,203070494,Amazonas,3941613,0.6939,1255,2735172,0.5170,4823,2037962,0.0060,2797,23503
2021-11-28,Brazil,203070494,Amazonas,3941613,0.6940,381,2735553,0.5172,581,2038543,0.0060,138,23641
2021-11-29,Brazil,203070494,Amazonas,3941613,0.6949,3669,2739222,0.5197,10026,2048569,0.0068,3345,26986
2021-11-30,Brazil,203070494,Amazonas,3941613,0.6958,3509,2742731,0.5223,10277,2058846,0.0078,3605,30591
2021-12-01,Brazil,203070494,Amazonas,3941613,0.6964,2303,2745034,0.5239,5970,2064816,0.0078,11,30602
2021-12-02,Brazil,203070494,Amazonas,3941613,0.6976,4761,2749795,0.5271,12865,2077681,0.0078,6,30608
2021-12-03,Brazil,203070494,Amazonas,3941613,0.6986,3758,2753553,0.5295,9530,2087211,0.0078,20,30628
2021-12-04,Brazil,203070494,Amazonas,3941613,0.6991,1855,2755408,0.5310,5885,2093096,0.0078,2,30630
2021-12-05,Brazil,203070494,Amazonas,3941613,0.6993,771,2756179,0.5315,1892,2094988,0.0078,7,30637
2021-12-06,Brazil,203070494,Amazonas,3941613,0.7002,3904,2760083,0.5336,8114,2103102,0.0078,8,30645
2021-12-07,Brazil,203070494,Amazonas,3941613,0.7013,4228,2764311,0.5358,8702,2111804,0.0084,2554,33199
2021-12-08,Brazil,203070494,Amazonas,3941613,0.7024,4253,2768564,0.5381,9022,2120826,0.0085,498,33697
2021-12-09,Brazil,203070494,Amazonas,3941613,0.7035,4234,2772798,0.5406,10032,2130858,0.0100,5565,39262
2021-12-10,Brazil,203070494,Amazonas,3941613,0.7043,3350,2776148,0.5427,8311,2139169,0.0116,6533,45795
2021-12-11,Brazil,203070494,Amazonas,3941613,0.7048,1838,2777986,0.5440,5107,2144276,0.0129,4937,50732
2021-12-12,Brazil,203070494,Amazonas,3941613,0.7050,673,2778659,0.5443,1233,2145509,0.0132,1364,52096
2021-12-13,Brazil,203070494,Amazonas,3941613,0.7058,3239,2781898,0.5463,7936,2153445,0.0144,4759,56855
2021-12-14,Brazil,203070494,Amazonas,3941613,0.7067,3503,2785401,0.5484,8192,2161637,0.0157,5107,61962
2021-12-15,Brazil,203070494,Amazonas,3941613,0.7074,2908,2788309,0.5504,7792,2169429,0.0165,3262,65224
2021-12-16,Brazil,203070494,Amazonas,3941613,0.7082,3324,2791633,0.5525,8404,2177833,0.0176,4284,69508
2021-12-17,Brazil,203070494,Amazonas,3941613,0.7089,2415,2794048,0.5541,6358,2184191,0.0186,3750,73258
2021-12-18,Brazil,203070494,Amazonas,3941613,0.7091,1084,2795132,0.5549,2920,2187111,0.0195,3450,76708
2021-12-19,Brazil,203070494,Amazonas,3941613,0.7093,504,2795636,0.5552,1292,2188403,0.0199,1640,78348
2021-12-20,Brazil,203070494,Amazonas,3941613,0.7098,2250,2797886,0.5567,5944,2194347,0.0206,2987,81335
2021-12-21,Brazil,203070494,Amazonas,3941613,0.7103,2005,2799891,0.5581,5330,2199677,0.0214,3012,84347
2021-12-22,Brazil,203070494,Amazonas,3941613,0.7108,1957,2801848,0.5594,5211,2204888,0.0221,2654,87001
2021-12-23,Brazil,203070494,Amazonas,3941613,0.7112,1305,2803153,0.5603,3668,2208556,0.0225,1761,88762
2021-12-24,Brazil,203070494,Amazonas,3941613,0.7112,68,2803221,0.5604,320,2208876,0.0225,0,88762
2021-12-25,Brazil,203070494,Amazonas,3941613,0.7112,24,2803245,0.5604,29,2208905,0.0225,0,88762
2021-12-26,Brazil,203070494,Amazonas,3941613,0.7112,35,2803280,0.5604,26,2208931,0.0225,5,88767
2021-12-27,Brazil,203070494,Amazonas,3941613,0.7114,971,2804251,0.5612,3107,2212038,0.0231,2449,91216
2021-12-28,Brazil,203070494,Amazonas,3941613,0.7118,1366,2805617,0.5623,4306,2216344,0.0242,4297,95513
2021-12-29,Brazil,203070494,Amazonas,3941613,0.7121,1130,2806747,0.5633,3895,2220239,0.0252,3804,99317
2021-12-30,Brazil,203070494,Amazonas,3941613,0.7123,725,2807472,0.5639,2318,2222557,0.0259,2966,102283
2021-12-31,Brazil,203070494,Amazonas,3941613,0.7123,71,2807543,0.5639,229,2222786,0.0259,0,102283
2021-01-01,Brazil,203070494,Bahia,14141626,0.0000,4,4,0.0000,1,1,0.0000,0,0
2021-01-02,Brazil,203070494,Bahia,14141626,0.0000,0,4,0.0000,0,1,0.0000,0,0
2021-01-03,Brazil,203070494,Bahia,14141626,0.0000,1,5,0.0000,0,1,0.0000,0,0
2021-01-04,Brazil,203070494,Bahia,14141626,0.0000,3,8,0.0000,0,1,0.0000,0,0
2021-01-05,Brazil,203070494,Bahia,14141626,0.0000,1,9,0.0000,2,3,0.0000,0,0
2021-01-06,Brazil,203070494,Bahia,14141626,0.0000,4,13,0.0000,2,5,0.0000,0,0
2021-01-07,Brazil,203070494,Bahia,14141626,0.0000,3,16,0.0000,0,5,0.0000,0,0
2021-01-08,Brazil,203070494,Bahia,14141626,0.0000,1,17,0.0000,2,7,0.0000,0,0
2021-01-09,Brazil,203070494,Bahia,14141626,0.0000,0,17,0.0000,1,8,0.0000,0,0
2021-01-10,Brazil,203070494,Bahia,14141626,0.0000,1,18,0.0000,2,10,0.0000,0,0
2021-01-11,Brazil,203070494,Bahia,14141626,0.0000,3,21,0.0000,1,11,0.0000,0,0
2021-01-12,Brazil,203070494,Bahia,14141626,0.0000,4,25,0.0000,2,13,0.0000,0,0
2021-01-13,Brazil,203070494,Bahia,14141626,0.0000,1,26,0.0000,1,14,0.0000,0,0
2021-01-14,Brazil,203070494,Bahia,14141626,0.0000,2,28,0.0000,0,14,0.0000,0,0
2021-01-15,Brazil,203070494,Bahia,14141626,0.0000,1,29,0.0000,1,15,0.0000,0,0
2021-01-17,Brazil,203070494,Bahia,14141626,0.0000,123,152,0.0000,9,24,0.0000,0,0
2021-01-18,Brazil,203070494,Bahia,14141626,0.0000,142,294,0.0000,31,55,0.0000,0,0
2021-01-19,Brazil,203070494,Bahia,14141626,0.0006,8124,8418,0.0000,37,92,0.0000,0,0
2021-01-20,Brazil,203070494,Bahia,14141626,0.0027,29201,37619,0.0000,56,148,0.0000,0,0
2021-01-21,Brazil,203070494,Bahia,14141626,0.0043,22923,60542,0.0000,44,192,0.0000,0,0
2021-01-22,Brazil,203070494,Bahia,14141626,0.0053,13986,74528,0.0000,77,269,0.0000,0,0
2021-01-23,Brazil,203070494,Bahia,14141626,0.0056,4693,79221,0.0000,30,299,0.0000,0,0
2021-01-24,Brazil,203070494,Bahia,14141626,0.0059,3677,82898,0.0000,8,307,0.0000,0,0
2021-01-25,Brazil,203070494,Bahia,14141626,0.0070,15777,98675,0.0000,33,340,0.0000,0,0
2021-01-26,Brazil,203070494,Bahia,14141626,0.0088,25340,124015,0.0000,53,393,0.0000,0,0
2021-01-27,Brazil,203070494,Bahia,14141626,0.0103,21847,145862,0.0000,33,426,0.0000,0,0
2021-01-28,Brazil,203070494,Bahia,14141626,0.0117,19008,164870,0.0000,32,458,0.0000,0,0
2021-01-29,Brazil,203070494,Bahia,14141626,0.0131,19792,184662,0.0000,26,484,0.0000,0,0
2021-01-30,Brazil,203070494,Bahia,14141626,0.0138,11122,195784,0.0000,20,504,0.0000,0,0
2021-01-31,Brazil,203070494,Bahia,14141626,0.0144,7637,203421,0.0000,4,508,0.0000,0,0
2021-02-01,Brazil,203070494,Bahia,14141626,0.0156,17026,220447,0.0000,58,566,0.0000,0,0
2021-02-02,Brazil,203070494,Bahia,14141626,0.0171,21533,241980,0.0001,169,735,0.0000,0,0
2021-02-03,Brazil,203070494,Bahia,14141626,0.0184,17845,259825,0.0001,157,892,0.0000,0,0
2021-02-04,Brazil,203070494,Bahia,14141626,0.0197,18350,278175,0.0001,72,964,0.0000,0,0
2021-02-05,Brazil,203070494,Bahia,14141626,0.0210,18915,297090,0.0001,60,1024,0.0000,0,0
2021-02-06,Brazil,203070494,Bahia,14141626,0.0218,10923,308013,0.0001,20,1044,0.0000,0,0
2021-02-07,Brazil,203070494,Bahia,14141626,0.0219,1645,309658,0.0001,13,1057,0.0000,0,0
2021-02-08,Brazil,203070494,Bahia,14141626,0.0234,21842,331500,0.0001,85,1142,0.0000,0,0
2021-02-09,Brazil,203070494,Bahia,14141626,0.0252,25464,356964,0.0001,124,1266,0.0000,0,0
2021-02-10,Brazil,203070494,Bahia,14141626,0.0266,18809,375773,0.0001,158,1424,0.0000,0,0
2021-02-11,Brazil,203070494,Bahia,14141626,0.0278,17717,393490,0.0001,99,1523,0.0000,0,0
2021-02-12,Brazil,203070494,Bahia,14141626,0.0287,12082,405572,0.0002,738,2261,0.0000,1,1
2021-02-13,Brazil,203070494,Bahia,14141626,0.0287,920,406492,0.0002,313,2574,0.0000,0,1
2021-02-14,Brazil,203070494,Bahia,14141626,0.0288,95,406587,0.0002,39,2613,0.0000,0,1
2021-02-15,Brazil,203070494,Bahia,14141626,0.0292,6470,413057,0.0004,2545,5158,0.0000,0,1
2021-02-16,Brazil,203070494,Bahia,14141626,0.0296,6004,419061,0.0009,7094,12252,0.0000,0,1
2021-02-17,Brazil,203070494,Bahia,14141626,0.0299,3993,423054,0.0021,17590,29842,0.0000,1,2
2021-02-18,Brazil,203070494,Bahia,14141626,0.0303,5359,428413,0.0035,20284,50126,0.0000,0,2
2021-02-19,Brazil,203070494,Bahia,14141626,0.0306,4052,432465,0.0046,15378,65504,0.0000,0,2
2021-02-20,Brazil,203070494,Bahia,14141626,0.0306,377,432842,0.0048,2801,68305,0.0000,0,2
2021-02-21,Brazil,203070494,Bahia,14141626,0.0306,198,433040,0.0048,240,68545,0.0000,0,2
2021-02-22,Brazil,203070494,Bahia,14141626,0.0308,2663,435703,0.0060,16770,85315,0.0000,0,2
2021-02-23,Brazil,203070494,Bahia,14141626,0.0310,2709,438412,0.0070,13289,98604,0.0000,0,2
2021-02-24,Brazil,203070494,Bahia,14141626,0.0311,1852,440264,0.0075,8123,106727,0.0000,0,2
2021-02-25,Brazil,203070494,Bahia,14141626,0.0317,8228,448492,0.0082,8603,115330,0.0000,0,2
2021-02-26,Brazil,203070494,Bahia,14141626,0.0330,17691,466183,0.0089,10773,126103,0.0000,0,2
2021-02-27,Brazil,203070494,Bahia,14141626,0.0337,10908,477091,0.0094,7000,133103,0.0000,0,2
2021-02-28,Brazil,203070494,Bahia,14141626,0.0343,8242,485333,0.0095,1721,134824,0.0000,0,2
2021-03-01,Brazil,203070494,Bahia,14141626,0.0357,18817,504150,0.0101,8071,142895,0.0000,0,2
2021-03-02,Brazil,203070494,Bahia,14141626,0.0369,17524,521674,0.0109,11231,154126,0.0000,0,2
2021-03-03,Brazil,203070494,Bahia,14141626,0.0379,14903,536577,0.0116,10289,164415,0.0000,0,2
2021-03-04,Brazil,203070494,Bahia,14141626,0.0397,24386,560963,0.0124,10728,175143,0.0000,0,2
2021-03-05,Brazil,203070494,Bahia,14141626,0.0412,22193,583156,0.0131,9891,185034,0.0000,0,2
2021-03-06,Brazil,203070494,Bahia,14141626,0.0418,8611,591767,0.0134,4632,189666,0.0000,4,6
2021-03-07,Brazil,203070494,Bahia,14141626,0.0419,707,592474,0.0136,2222,191888,0.0000,0,6
2021-03-08,Brazil,203070494,Bahia,14141626,0.0430,15782,608256,0.0148,17331,209219,0.0000,1,7
2021-03-09,Brazil,203070494,Bahia,14141626,0.0441,14993,623249,0.0163,21385,230604,0.0000,0,7
2021-03-10,Brazil,203070494,Bahia,14141626,0.0454,19032,642281,0.0174,15830,246434,0.0000,0,7
2021-03-11,Brazil,203070494,Bahia,14141626,0.0476,31557,673838,0.0185,15092,261526,0.0000,0,7
2021-03-12,Brazil,203070494,Bahia,14141626,0.0503,38007,711845,0.0192,10053,271579,0.0000,0,7
2021-03-13,Brazil,203070494,Bahia,14141626,0.0518,20855,732700,0.0193,955,272534,0.0000,0,7
2021-03-14,Brazil,203070494,Bahia,14141626,0.0522,5520,738220,0.0193,218,272752,0.0000,0,7
2021-03-15,Brazil,203070494,Bahia,14141626,0.0544,31488,769708,0.0197,5465,278217,0.0000,0,7
2021-03-16,Brazil,203070494,Bahia,14141626,0.0564,27372,797080,0.0200,4854,283071,0.0000,0,7
2021-03-17,Brazil,203070494,Bahia,14141626,0.0585,29760,826840,0.0203,3960,287031,0.0000,0,7
2021-03-18,Brazil,203070494,Bahia,14141626,0.0626,58536,885376,0.0206,4379,291410,0.0000,1,8
2021-03-19,Brazil,203070494,Bahia,14141626,0.0662,51228,936604,0.0208,2791,294201,0.0000,0,8
2021-03-20,Brazil,203070494,Bahia,14141626,0.0678,22701,959305,0.0208,475,294676,0.0000,0,8
2021-03-21,Brazil,203070494,Bahia,14141626,0.0687,12617,971922,0.0208,120,294796,0.0000,1,9
2021-03-22,Brazil,203070494,Bahia,14141626,0.0740,74927,1046849,0.0210,2857,297653,0.0000,0,9
2021-03-23,Brazil,203070494,Bahia,14141626,0.0807,94046,1140895,0.0212,2292,299945,0.0000,1,10
2021-03-24,Brazil,203070494,Bahia,14141626,0.0861,76256,1217151,0.0214,2170,302115,0.0000,1,11
2021-03-25,Brazil,203070494,Bahia,14141626,0.0907,65607,1282758,0.0215,2348,304463,0.0000,1,12
2021-03-26,Brazil,203070494,Bahia,14141626,0.0943,50738,1333496,0.0217,2756,307219,0.0000,0,12
2021-03-27,Brazil,203070494,Bahia,14141626,0.0980,52137,1385633,0.0218,504,307723,0.0000,0,12
2021-03-28,Brazil,203070494,Bahia,14141626,0.1002,30732,1416365,0.0218,362,308085,0.0000,0,12
2021-03-29,Brazil,203070494,Bahia,14141626,0.1072,100233,1516598,0.0220,2932,311017,0.0000,0,12
2021-03-30,Brazil,203070494,Bahia,14141626,0.1139,93840,1610438,0.0222,3018,314035,0.0000,0,12
2021-03-31,Brazil,203070494,Bahia,14141626,0.1186,66170,1676608,0.0225,4506,318541,0.0000,0,12
2021-04-01,Brazil,203070494,Bahia,14141626,0.1202,23623,1700231,0.0231,8079,326620,0.0000,0,12
2021-04-02,Brazil,203070494,Bahia,14141626,0.1204,2015,1702246,0.0231,259,326879,0.0000,0,12
2021-04-03,Brazil,203070494,Bahia,14141626,0.1226,31776,1734022,0.0237,7864,334743,0.0000,0,12
2021-04-04,Brazil,203070494,Bahia,14141626,0.1234,10923,1744945,0.0238,1527,336270,0.0000,0,12
2021-04-05,Brazil,203070494,Bahia,14141626,0.1282,68062,1813007,0.0250,17132,353402,0.0000,1,13
2021-04-06,Brazil,203070494,Bahia,14141626,0.1317,49325,1862332,0.0261,15764,369166,0.0000,0,13
2021-04-07,Brazil,203070494,Bahia,14141626,0.1339,30950,1893282,0.0273,16428,385594,0.0000,0,13
2021-04-08,Brazil,203070494,Bahia,14141626,0.1351,16882,1910164,0.0291,25382,410976,0.0000,0,13
2021-04-09,Brazil,203070494,Bahia,14141626,0.1367,22430,1932594,0.0311,28862,439838,0.0000,1,14
2021-04-10,Brazil,203070494,Bahia,14141626,0.1383,22922,1955516,0.0319,11929,451767,0.0000,0,14
2021-04-11,Brazil,203070494,Bahia,14141626,0.1387,6595,1962111,0.0320,1218,452985,0.0000,0,14
2021-04-12,Brazil,203070494,Bahia,14141626,0.1406,26557,1988668,0.0343,32559,485544,0.0000,0,14
2021-04-13,Brazil,203070494,Bahia,14141626,0.1420,19427,2008095,0.0363,28197,513741,0.0000,0,14
2021-04-14,Brazil,203070494,Bahia,14141626,0.1430,13910,2022005,0.0387,34002,547743,0.0000,0,14
2021-04-15,Brazil,203070494,Bahia,14141626,0.1436,8518,2030523,0.0420,46659,594402,0.0000,0,14
2021-04-16,Brazil,203070494,Bahia,14141626,0.1441,7263,2037786,0.0451,43770,638172,0.0000,0,14
2021-04-17,Brazil,203070494,Bahia,14141626,0.1463,31744,2069530,0.0462,15680,653852,0.0000,0,14
2021-04-18,Brazil,203070494,Bahia,14141626,0.1474,15054,2084584,0.0467,6441,660293,0.0000,4,18
2021-04-19,Brazil,203070494,Bahia,14141626,0.1512,54001,2138585,0.0508,58729,719022,0.0000,0,18
2021-04-20,Brazil,203070494,Bahia,14141626,0.1544,44652,2183237,0.0553,63098,782120,0.0000,0,18
2021-04-21,Brazil,203070494,Bahia,14141626,0.1554,13954,2197191,0.0567,19084,801204,0.0000,0,18
2021-04-22,Brazil,203070494,Bahia,14141626,0.1571,24943,2222134,0.0608,58750,859954,0.0000,0,18
2021-04-23,Brazil,203070494,Bahia,14141626,0.1589,24270,2246404,0.0638,41787,901741,0.0000,0,18
2021-04-24,Brazil,203070494,Bahia,14141626,0.1605,23414,2269818,0.0653,21385,923126,0.0000,0,18
2021-04-25,Brazil,203070494,Bahia,14141626,0.1610,7080,2276898,0.0660,10133,933259,0.0000,0,18
2021-04-26,Brazil,203070494,Bahia,14141626,0.1636,37011,2313909,0.0704,61928,995187,0.0000,0,18
2021-04-27,Brazil,203070494,Bahia,14141626,0.1661,34994,2348903,0.0742,54158,1049345,0.0000,0,18
2021-04-28,Brazil,203070494,Bahia,14141626,0.1680,27083,2375986,0.0763,30118,1079463,0.0000,0,18
2021-04-29,Brazil,203070494,Bahia,14141626,0.1695,21243,2397229,0.0778,20600,1100063,0.0000,0,18
2021-04-30,Brazil,203070494,Bahia,14141626,0.1717,30248,2427477,0.0793,20794,1120857,0.0000,0,18
2021-05-01,Brazil,203070494,Bahia,14141626,0.1728,15588,2443065,0.0798,7978,1128835,0.0000,0,18
2021-05-02,Brazil,203070494,Bahia,14141626,0.1731,4336,2447401,0.0801,3808,1132643,0.0000,0,18
2021-05-03,Brazil,203070494,Bahia,14141626,0.1759,40279,2487680,0.0826,35265,1167908,0.0000,0,18
2021-05-04,Brazil,203070494,Bahia,14141626,0.1797,53495,2541175,0.0845,26972,1194880,0.0000,0,18
2021-05-05,Brazil,203070494,Bahia,14141626,0.1844,66399,2607574,0.0859,19764,1214644,0.0000,0,18
2021-05-06,Brazil,203070494,Bahia,14141626,0.1893,69561,2677135,0.0870,16037,1230681,0.0000,1,19
2021-05-07,Brazil,203070494,Bahia,14141626,0.1937,61759,2738894,0.0879,12478,1243159,0.0000,0,19
2021-05-08,Brazil,203070494,Bahia,14141626,0.1956,27149,2766043,0.0881,2317,1245476,0.0000,0,19
2021-05-09,Brazil,203070494,Bahia,14141626,0.1956,406,2766449,0.0881,369,1245845,0.0000,0,19
2021-05-10,Brazil,203070494,Bahia,14141626,0.1993,52484,2818933,0.0895,19466,1265311,0.0000,0,19
2021-05-11,Brazil,203070494,Bahia,14141626,0.2036,60364,2879297,0.0911,22447,1287758,0.0000,0,19
2021-05-12,Brazil,203070494,Bahia,14141626,0.2070,48035,2927332,0.0918,10212,1297970,0.0000,1,20
2021-05-13,Brazil,203070494,Bahia,14141626,0.2103,46942,2974274,0.0924,8174,1306144,0.0000,0,20
2021-05-14,Brazil,203070494,Bahia,14141626,0.2130,38472,3012746,0.0926,3394,1309538,0.0000,0,20
2021-05-15,Brazil,203070494,Bahia,14141626,0.2139,12850,3025596,0.0948,31164,1340702,0.0000,0,20
2021-05-16,Brazil,203070494,Bahia,14141626,0.2140,825,3026421,0.0959,15322,1356024,0.0000,0,20
2021-05-17,Brazil,203070494,Bahia,14141626,0.2165,34684,3061105,0.0976,24668,1380692,0.0000,0,20
2021-05-18,Brazil,203070494,Bahia,14141626,0.2192,39021,3100126,0.0986,14355,1395047,0.0000,0,20
2021-05-19,Brazil,203070494,Bahia,14141626,0.2217,35470,3135596,0.0995,12149,1407196,0.0000,0,20
2021-05-20,Brazil,203070494,Bahia,14141626,0.2248,43179,3178775,0.1002,9139,1416335,0.0000,0,20
2021-05-21,Brazil,203070494,Bahia,14141626,0.2281,47530,3226305,0.1007,7609,1423944,0.0000,0,20
2021-05-22,Brazil,203070494,Bahia,14141626,0.2297,22481,3248786,0.1008,1471,1425415,0.0000,0,20
2021-05-23,Brazil,203070494,Bahia,14141626,0.2298,706,3249492,0.1008,135,1425550,0.0000,0,20
2021-05-24,Brazil,203070494,Bahia,14141626,0.2315,23876,3273368,0.1014,8474,1434024,0.0000,0,20
2021-05-25,Brazil,203070494,Bahia,14141626,0.2334,27364,3300732,0.1028,19216,1453240,0.0000,0,20
2021-05-26,Brazil,203070494,Bahia,14141626,0.2350,22266,3322998,0.1042,20949,1474189,0.0000,0,20
2021-05-27,Brazil,203070494,Bahia,14141626,0.2397,66417,3389415,0.1051,11635,1485824,0.0000,0,20
2021-05-28,Brazil,203070494,Bahia,14141626,0.2451,77027,3466442,0.1058,10094,1495918,0.0000,0,20
2021-05-29,Brazil,203070494,Bahia,14141626,0.2463,17106,3483548,0.1061,4028,1499946,0.0000,0,20
2021-05-30,Brazil,203070494,Bahia,14141626,0.2464,1609,3485157,0.1061,95,1500041,0.0000,0,20
2021-05-31,Brazil,203070494,Bahia,14141626,0.2502,53550,3538707,0.1067,8243,1508284,0.0000,0,20
2021-06-01,Brazil,203070494,Bahia,14141626,0.2539,52287,3590994,0.1074,10061,1518345,0.0000,0,20
2021-06-02,Brazil,203070494,Bahia,14141626,0.2575,50999,3641993,0.1082,12106,1530451,0.0000,0,20
2021-06-03,Brazil,203070494,Bahia,14141626,0.2608,46530,3688523,0.1083,660,1531111,0.0000,0,20
2021-06-04,Brazil,203070494,Bahia,14141626,0.2662,76032,3764555,0.1086,5028,1536139,0.0000,0,20
2021-06-05,Brazil,203070494,Bahia,14141626,0.2682,27822,3792377,0.1087,749,1536888,0.0000,0,20
2021-06-06,Brazil,203070494,Bahia,14141626,0.2684,3542,3795919,0.1087,289,1537177,0.0000,0,20
2021-06-07,Brazil,203070494,Bahia,14141626,0.2743,83362,3879281,0.1091,6213,1543390,0.0000,0,20
2021-06-08,Brazil,203070494,Bahia,14141626,0.2801,81952,3961233,0.1095,4990,1548380,0.0000,0,20
2021-06-09,Brazil,203070494,Bahia,14141626,0.2844,60942,4022175,0.1098,4044,1552424,0.0000,0,20
2021-06-10,Brazil,203070494,Bahia,14141626,0.2890,65268,4087443,0.1101,4123,1556547,0.0000,0,20
2021-06-11,Brazil,203070494,Bahia,14141626,0.2955,91933,4179376,0.1104,4368,1560915,0.0000,0,20
2021-06-12,Brazil,203070494,Bahia,14141626,0.2981,36824,4216200,0.1104,700,1561615,0.0000,0,20
2021-06-13,Brazil,203070494,Bahia,14141626,0.2984,3273,4219473,0.1104,72,1561687,0.0000,0,20
2021-06-14,Brazil,203070494,Bahia,14141626,0.3025,57747,4277220,0.1116,16674,1578361,0.0000,0,20
2021-06-15,Brazil,203070494,Bahia,14141626,0.3063,54801,4332021,0.1130,20049,1598410,0.0000,0,20
2021-06-16,Brazil,203070494,Bahia,14141626,0.3104,57120,4389141,0.1146,22462,1620872,0.0000,0,20
2021-06-17,Brazil,203070494,Bahia,14141626,0.3130,37045,4426186,0.1162,21695,1642567,0.0000,0,20
2021-06-18,Brazil,203070494,Bahia,14141626,0.3160,42918,4469104,0.1175,19285,1661852,0.0000,0,20
2021-06-19,Brazil,203070494,Bahia,14141626,0.3194,48049,4517153,0.1177,3040,1664892,0.0000,0,20
2021-06-20,Brazil,203070494,Bahia,14141626,0.3205,14612,4531765,0.1179,1975,1666867,0.0000,0,20
2021-06-21,Brazil,203070494,Bahia,14141626,0.3274,98257,4630022,0.1199,28979,1695846,0.0000,0,20
2021-06-22,Brazil,203070494,Bahia,14141626,0.3337,89569,4719591,0.1224,35664,1731510,0.0000,0,20
2021-06-23,Brazil,203070494,Bahia,14141626,0.3365,38360,4757951,0.1236,15778,1747288,0.0000,0,20
2021-06-24,Brazil,203070494,Bahia,14141626,0.3368,5298,4763249,0.1237,1722,1749010,0.0000,0,20
2021-06-25,Brazil,203070494,Bahia,14141626,0.3402,47327,4810576,0.1243,9201,1758211,0.0000,0,20
2021-06-26,Brazil,203070494,Bahia,14141626,0.3433,44668,4855244,0.1244,1407,1759618,0.0000,0,20
2021-06-27,Brazil,203070494,Bahia,14141626,0.3447,19527,4874771,0.1245,599,1760217,0.0000,0,20
2021-06-28,Brazil,203070494,Bahia,14141626,0.3521,104291,4979062,0.1264,27721,1787938,0.0000,0,20
2021-06-29,Brazil,203070494,Bahia,14141626,0.3575,75908,5054970,0.1281,23822,1811760,0.0000,0,20
2021-06-30,Brazil,203070494,Bahia,14141626,0.3609,49394,5104364,0.1296,21456,1833216,0.0000,0,20
2021-07-01,Brazil,203070494,Bahia,14141626,0.3680,99574,5203938,0.1305,11725,1844941,0.0000,0,20
2021-07-02,Brazil,203070494,Bahia,14141626,0.3710,42586,5246524,0.1306,2210,1847151,0.0000,0,20
2021-07-03,Brazil,203070494,Bahia,14141626,0.3727,24209,5270733,0.1308,2012,1849163,0.0000,0,20
2021-07-04,Brazil,203070494,Bahia,14141626,0.3751,33197,5303930,0.1308,887,1850050,0.0000,0,20
2021-07-05,Brazil,203070494,Bahia,14141626,0.3831,113995,5417925,0.1320,17165,1867215,0.0000,0,20
2021-07-06,Brazil,203070494,Bahia,14141626,0.3913,115835,5533760,0.1329,12014,1879229,0.0000,0,20
2021-07-07,Brazil,203070494,Bahia,14141626,0.3959,64527,5598287,0.1336,10387,1889616,0.0000,0,20
2021-07-08,Brazil,203070494,Bahia,14141626,0.3992,47231,5645518,0.1343,9690,1899306,0.0000,0,20
2021-07-09,Brazil,203070494,Bahia,14141626,0.4028,51067,5696585,0.1352,12520,1911826,0.0000,0,20
2021-07-10,Brazil,203070494,Bahia,14141626,0.4044,21819,5718404,0.1356,5700,1917526,0.0000,0,20
2021-07-11,Brazil,203070494,Bahia,14141626,0.4047,4944,5723348,0.1357,1135,1918661,0.0000,0,20
2021-07-12,Brazil,203070494,Bahia,14141626,0.4078,42952,5766300,0.1379,31093,1949754,0.0000,0,20
2021-07-13,Brazil,203070494,Bahia,14141626,0.4113,50375,5816675,0.1403,34714,1984468,0.0000,0,20
2021-07-14,Brazil,203070494,Bahia,14141626,0.4130,24272,5840947,0.1422,26588,2011056,0.0000,0,20
2021-07-15,Brazil,203070494,Bahia,14141626,0.4144,18774,5859721,0.1440,25174,2036230,0.0000,0,20
2021-07-16,Brazil,203070494,Bahia,14141626,0.4171,38682,5898403,0.1459,26406,2062636,0.0000,0,20
2021-07-17,Brazil,203070494,Bahia,14141626,0.4219,68559,5966962,0.1460,2613,2065249,0.0000,0,20
2021-07-18,Brazil,203070494,Bahia,14141626,0.4223,4645,5971607,0.1462,2251,2067500,0.0000,0,20
2021-07-19,Brazil,203070494,Bahia,14141626,0.4267,62599,6034206,0.1508,65698,2133198,0.0000,0,20
2021-07-20,Brazil,203070494,Bahia,14141626,0.4326,84088,6118294,0.1539,43814,2177012,0.0000,0,20
2021-07-21,Brazil,203070494,Bahia,14141626,0.4393,93556,6211850,0.1563,32949,2209961,0.0000,0,20
2021-07-22,Brazil,203070494,Bahia,14141626,0.4477,119058,6330908,0.1588,35295,2245256,0.0000,1,21
2021-07-23,Brazil,203070494,Bahia,14141626,0.4537,84537,6415445,0.1611,33660,2278916,0.0000,0,21
2021-07-24,Brazil,203070494,Bahia,14141626,0.4550,19065,6434510,0.1628,22860,2301776,0.0000,0,21
2021-07-25,Brazil,203070494,Bahia,14141626,0.4555,6538,6441048,0.1628,218,2301994,0.0000,0,21
2021-07-26,Brazil,203070494,Bahia,14141626,0.4585,42420,6483468,0.1670,59741,2361735,0.0000,0,21
2021-07-27,Brazil,203070494,Bahia,14141626,0.4615,43119,6526587,0.1719,69460,2431195,0.0000,0,21
2021-07-28,Brazil,203070494,Bahia,14141626,0.4665,70748,6597335,0.1755,49954,2481149,0.0000,1,22
2021-07-29,Brazil,203070494,Bahia,14141626,0.4712,65624,6662959,0.1790,50419,2531568,0.0000,0,22
2021-07-30,Brazil,203070494,Bahia,14141626,0.4739,38746,6701705,0.1827,51792,2583360,0.0000,0,22
2021-07-31,Brazil,203070494,Bahia,14141626,0.4757,24999,6726704,0.1834,10038,2593398,0.0000,0,22
2021-08-01,Brazil,203070494,Bahia,14141626,0.4771,19999,6746703,0.1834,678,2594076,0.0000,0,22
2021-08-02,Brazil,203070494,Bahia,14141626,0.4828,80216,6826919,0.1864,42387,2636463,0.0000,0,22
2021-08-03,Brazil,203070494,Bahia,14141626,0.4896,96647,6923566,0.1904,55419,2691882,0.0000,0,22
2021-08-04,Brazil,203070494,Bahia,14141626,0.4957,86567,7010133,0.1934,42863,2734745,0.0000,0,22
2021-08-05,Brazil,203070494,Bahia,14141626,0.5008,72148,7082281,0.1963,41387,2776132,0.0000,3,25
2021-08-06,Brazil,203070494,Bahia,14141626,0.5052,61987,7144268,0.2004,58143,2834275,0.0000,7,32
2021-08-07,Brazil,203070494,Bahia,14141626,0.5088,51511,7195779,0.2009,7080,2841355,0.0000,1,33
2021-08-08,Brazil,203070494,Bahia,14141626,0.5091,3141,7198920,0.2010,478,2841833,0.0000,0,33
2021-08-09,Brazil,203070494,Bahia,14141626,0.5183,131362,7330282,0.2035,35429,2877262,0.0000,1,34
2021-08-10,Brazil,203070494,Bahia,14141626,0.5281,138578,7468860,0.2077,60031,2937293,0.0000,6,40
2021-08-11,Brazil,203070494,Bahia,14141626,0.5355,104079,7572939,0.2114,51582,2988875,0.0000,3,43
2021-08-12,Brazil,203070494,Bahia,14141626,0.5430,105857,7678796,0.2145,45185,3034060,0.0000,8,51
2021-08-13,Brazil,203070494,Bahia,14141626,0.5503,103097,7781893,0.2176,43092,3077152,0.0000,2,53
2021-08-14,Brazil,203070494,Bahia,14141626,0.5529,36314,7818207,0.2184,11841,3088993,0.0000,1,54
2021-08-15,Brazil,203070494,Bahia,14141626,0.5539,15088,7833295,0.2185,260,3089253,0.0000,0,54
2021-08-16,Brazil,203070494,Bahia,14141626,0.5628,125068,7958363,0.2208,32956,3122209,0.0000,11,65
2021-08-17,Brazil,203070494,Bahia,14141626,0.5704,108646,8067009,0.2249,58685,3180894,0.0000,10,75
2021-08-18,Brazil,203070494,Bahia,14141626,0.5817,158580,8225589,0.2279,41324,3222218,0.0000,16,91
2021-08-19,Brazil,203070494,Bahia,14141626,0.5898,115560,8341149,0.2316,53228,3275446,0.0000,14,105
2021-08-20,Brazil,203070494,Bahia,14141626,0.5944,64830,8405979,0.2362,64936,3340382,0.0000,13,118
2021-08-21,Brazil,203070494,Bahia,14141626,0.5997,74750,8480729,0.2365,3766,3344148,0.0000,27,145
2021-08-22,Brazil,203070494,Bahia,14141626,0.6015,24911,8505640,0.2365,544,3344692,0.0000,0,145
2021-08-23,Brazil,203070494,Bahia,14141626,0.6114,140032,8645672,0.2403,53961,3398653,0.0000,17,162
2021-08-24,Brazil,203070494,Bahia,14141626,0.6215,143379,8789051,0.2443,55665,3454318,0.0000,11,173
2021-08-25,Brazil,203070494,Bahia,14141626,0.6289,104711,8893762,0.2490,67421,3521739,0.0000,12,185
2021-08-26,Brazil,203070494,Bahia,14141626,0.6358,97556,8991318,0.2531,57405,3579144,0.0000,15,200
2021-08-27,Brazil,203070494,Bahia,14141626,0.6401,60680,9051998,0.2578,66252,3645396,0.0000,11,211
2021-08-28,Brazil,203070494,Bahia,14141626,0.6433,45512,9097510,0.2594,22668,3668064,0.0000,14,225
2021-08-29,Brazil,203070494,Bahia,14141626,0.6437,5949,9103459,0.2595,1396,3669460,0.0000,0,225
2021-08-30,Brazil,203070494,Bahia,14141626,0.6495,82211,9185670,0.2652,81165,3750625,0.0000,11,236
2021-08-31,Brazil,203070494,Bahia,14141626,0.6547,73051,9258721,0.2713,85693,3836318,0.0000,11,247
2021-09-01,Brazil,203070494,Bahia,14141626,0.6579,45178,9303899,0.2771,81893,3918211,0.0000,5,252
2021-09-02,Brazil,203070494,Bahia,14141626,0.6605,37157,9341056,0.2830,83912,4002123,0.0000,4,256
2021-09-03,Brazil,203070494,Bahia,14141626,0.6654,68108,9409164,0.2879,69894,4072017,0.0000,10,266
2021-09-04,Brazil,203070494,Bahia,14141626,0.6672,25484,9434648,0.2895,21826,4093843,0.0000,0,266
2021-09-05,Brazil,203070494,Bahia,14141626,0.6674,3817,9438465,0.2902,10136,4103979,0.0000,0,266
2021-09-06,Brazil,203070494,Bahia,14141626,0.6688,18777,9457242,0.2918,22416,4126395,0.0000,0,266
2021-09-07,Brazil,203070494,Bahia,14141626,0.6689,1774,9459016,0.2919,1576,4127971,0.0000,0,266
2021-09-08,Brazil,203070494,Bahia,14141626,0.6713,33686,9492702,0.2989,98333,4226304,0.0000,10,276
2021-09-09,Brazil,203070494,Bahia,14141626,0.6750,52997,9545699,0.3055,94657,4320961,0.0000,7,283
2021-09-10,Brazil,203070494,Bahia,14141626,0.6783,47132,9592831,0.3108,73812,4394773,0.0000,9,292
2021-09-11,Brazil,203070494,Bahia,14141626,0.6798,20841,9613672,0.3125,24103,4418876,0.0000,0,292
2021-09-12,Brazil,203070494,Bahia,14141626,0.6800,2622,9616294,0.3127,3334,4422210,0.0000,0,292
2021-09-13,Brazil,203070494,Bahia,14141626,0.6825,35519,9651813,0.3196,97915,4520125,0.0000,2,294
2021-09-14,Brazil,203070494,Bahia,14141626,0.6856,43648,9695461,0.3265,96648,4616773,0.0000,2,296
2021-09-15,Brazil,203070494,Bahia,14141626,0.6903,66326,9761787,0.3315,71371,4688144,0.0000,3,299
2021-09-16,Brazil,203070494,Bahia,14141626,0.6940,52272,9814059,0.3359,61885,4750029,0.0000,7,306
2021-09-17,Brazil,203070494,Bahia,14141626,0.6954,19384,9833443,0.3392,46768,4796797,0.0000,2,308
2021-09-18,Brazil,203070494,Bahia,14141626,0.6968,20280,9853723,0.3404,17294,4814091,0.0000,2,310
2021-09-19,Brazil,203070494,Bahia,14141626,0.6969,2263,9855986,0.3405,1434,4815525,0.0000,0,310
2021-09-20,Brazil,203070494,Bahia,14141626,0.7011,58463,9914449,0.3456,71472,4886997,0.0000,5,315
2021-09-21,Brazil,203070494,Bahia,14141626,0.7059,68098,9982547,0.3508,73201,4960198,0.0000,1,316
2021-09-22,Brazil,203070494,Bahia,14141626,0.7108,69161,10051708,0.3550,60160,5020358,0.0000,2,318
2021-09-23,Brazil,203070494,Bahia,14141626,0.7142,48487,10100195,0.3616,92975,5113333,0.0000,5,323
2021-09-24,Brazil,203070494,Bahia,14141626,0.7175,46336,10146531,0.3660,61976,5175309,0.0000,1,324
2021-09-25,Brazil,203070494,Bahia,14141626,0.7181,8233,10154764,0.3676,23823,5199132,0.0000,0,324
2021-09-26,Brazil,203070494,Bahia,14141626,0.7182,1329,10156093,0.3679,4164,5203296,0.0000,0,324
2021-09-27,Brazil,203070494,Bahia,14141626,0.7211,42030,10198123,0.3744,91847,5295143,0.0000,5,329
2021-09-28,Brazil,203070494,Bahia,14141626,0.7242,42645,10240768,0.3814,98023,5393166,0.0000,4,333
2021-09-29,Brazil,203070494,Bahia,14141626,0.7277,49656,10290424,0.3868,77103,5470269,0.0000,8,341
2021-09-30,Brazil,203070494,Bahia,14141626,0.7315,53840,10344264,0.3917,68382,5538651,0.0000,13,354
2021-10-01,Brazil,203070494,Bahia,14141626,0.7338,32884,10377148,0.3958,59205,5597856,0.0000,6,360
2021-10-02,Brazil,203070494,Bahia,14141626,0.7345,10168,10387316,0.3968,13886,5611742,0.0000,0,360
2021-10-03,Brazil,203070494,Bahia,14141626,0.7345,135,10387451,0.3969,834,5612576,0.0000,0,360
2021-10-04,Brazil,203070494,Bahia,14141626,0.7363,24563,10412014,0.4014,63433,5676009,0.0000,2,362
2021-10-05,Brazil,203070494,Bahia,14141626,0.7383,28403,10440417,0.4064,70551,5746560,0.0000,2,364
2021-10-06,Brazil,203070494,Bahia,14141626,0.7397,20581,10460998,0.4109,64012,5810572,0.0000,6,370
2021-10-07,Brazil,203070494,Bahia,14141626,0.7416,26080,10487078,0.4154,64267,5874839,0.0000,6,376
2021-10-08,Brazil,203070494,Bahia,14141626,0.7432,22523,10509601,0.4192,53882,5928721,0.0000,6,382
2021-10-09,Brazil,203070494,Bahia,14141626,0.7435,4414,10514015,0.4205,18283,5947004,0.0000,1,383
2021-10-10,Brazil,203070494,Bahia,14141626,0.7436,997,10515012,0.4209,4964,5951968,0.0000,0,383
2021-10-11,Brazil,203070494,Bahia,14141626,0.7438,4134,10519146,0.4221,17243,5969211,0.0000,4,387
2021-10-12,Brazil,203070494,Bahia,14141626,0.7439,357,10519503,0.4222,948,5970159,0.0000,0,387
2021-10-13,Brazil,203070494,Bahia,14141626,0.7449,14769,10534272,0.4290,96473,6066632,0.0000,6,393
2021-10-14,Brazil,203070494,Bahia,14141626,0.7460,15213,10549485,0.4364,104979,6171611,0.0000,8,401
2021-10-15,Brazil,203070494,Bahia,14141626,0.7468,11512,10560997,0.4427,88181,6259792,0.0000,6,407
2021-10-16,Brazil,203070494,Bahia,14141626,0.7470,3283,10564280,0.4436,13125,6272917,0.0000,2,409
2021-10-17,Brazil,203070494,Bahia,14141626,0.7472,1669,10565949,0.4441,7630,6280547,0.0000,0,409
2021-10-18,Brazil,203070494,Bahia,14141626,0.7481,13642,10579591,0.4499,82379,6362926,0.0000,11,420
2021-10-19,Brazil,203070494,Bahia,14141626,0.7493,16110,10595701,0.4572,102829,6465755,0.0000,5,425
2021-10-20,Brazil,203070494,Bahia,14141626,0.7507,20214,10615915,0.4634,87398,6553153,0.0000,21,446
2021-10-21,Brazil,203070494,Bahia,14141626,0.7528,30088,10646003,0.4697,89414,6642567,0.0000,14,460
2021-10-22,Brazil,203070494,Bahia,14141626,0.7548,28321,10674324,0.4748,72033,6714600,0.0000,12,472
2021-10-23,Brazil,203070494,Bahia,14141626,0.7554,8709,10683033,0.4762,19612,6734212,0.0000,4,476
2021-10-24,Brazil,203070494,Bahia,14141626,0.7556,2616,10685649,0.4763,1045,6735257,0.0000,0,476
2021-10-25,Brazil,203070494,Bahia,14141626,0.7574,24581,10710230,0.4823,85720,6820977,0.0000,18,494
2021-10-26,Brazil,203070494,Bahia,14141626,0.7597,33342,10743572,0.4898,106262,6927239,0.0000,5,499
2021-10-27,Brazil,203070494,Bahia,14141626,0.7614,24544,10768116,0.4953,77088,7004327,0.0000,11,510
2021-10-28,Brazil,203070494,Bahia,14141626,0.7631,22732,10790848,0.5001,68321,7072648,0.0000,23,533
2021-10-29,Brazil,203070494,Bahia,14141626,0.7638,10645,10801493,0.5038,52404,7125052,0.0000,20,553
2021-10-30,Brazil,203070494,Bahia,14141626,0.7640,2383,10803876,0.5047,12299,7137351,0.0000,3,556
2021-10-31,Brazil,203070494,Bahia,14141626,0.7640,67,10803943,0.5047,115,7137466,0.0000,0,556
2021-11-01,Brazil,203070494,Bahia,14141626,0.7640,635,10804578,0.5050,4549,7142015,0.0000,0,556
2021-11-02,Brazil,203070494,Bahia,14141626,0.7640,107,10804685,0.5051,449,7142464,0.0000,0,556
2021-11-03,Brazil,203070494,Bahia,14141626,0.7650,12991,10817676,0.5106,78948,7221412,0.0000,1,557
2021-11-04,Brazil,203070494,Bahia,14141626,0.7659,13362,10831038,0.5166,84209,7305621,0.0000,13,570
2021-11-05,Brazil,203070494,Bahia,14141626,0.7667,11675,10842713,0.5208,59966,7365587,0.0000,0,570
2021-11-06,Brazil,203070494,Bahia,14141626,0.7670,3446,10846159,0.5221,17959,7383546,0.0000,0,570
2021-11-07,Brazil,203070494,Bahia,14141626,0.7670,207,10846366,0.5222,848,7384394,0.0000,0,570
2021-11-08,Brazil,203070494,Bahia,14141626,0.7679,13434,10859800,0.5266,63277,7447671,0.0000,0,570
2021-11-09,Brazil,203070494,Bahia,14141626,0.7697,25037,10884837,0.5318,73077,7520748,0.0000,0,570
2021-11-10,Brazil,203070494,Bahia,14141626,0.7715,25217,10910054,0.5375,79865,7600613,0.0000,15,585
2021-11-11,Brazil,203070494,Bahia,14141626,0.7729,20649,10930703,0.5439,90886,7691499,0.0000,0,585
2021-11-12,Brazil,203070494,Bahia,14141626,0.7741,15730,10946433,0.5477,53718,7745217,0.0000,9,594
2021-11-13,Brazil,203070494,Bahia,14141626,0.7743,3045,10949478,0.5488,15567,7760784,0.0000,0,594
2021-11-14,Brazil,203070494,Bahia,14141626,0.7743,110,10949588,0.5488,354,7761138,0.0000,0,594
2021-11-15,Brazil,203070494,Bahia,14141626,0.7743,144,10949732,0.5489,861,7761999,0.0000,0,594
2021-11-16,Brazil,203070494,Bahia,14141626,0.7753,14294,10964026,0.5543,76067,7838066,0.0000,1,595
2021-11-17,Brazil,203070494,Bahia,14141626,0.7763,13786,10977812,0.5599,80025,7918091,0.0000,0,595
2021-11-18,Brazil,203070494,Bahia,14141626,0.7772,12453,10990265,0.5659,84971,8003062,0.0000,1,596
2021-11-19,Brazil,203070494,Bahia,14141626,0.7779,10635,11000900,0.5705,65352,8068414,0.0000,1,597
2021-11-20,Brazil,203070494,Bahia,14141626,0.7782,3666,11004566,0.5714,11431,8079845,0.0000,0,597
2021-11-21,Brazil,203070494,Bahia,14141626,0.7782,131,11004697,0.5715,1501,8081346,0.0000,2,599
2021-11-22,Brazil,203070494,Bahia,14141626,0.7789,9523,11014220,0.5758,60934,8142280,0.0000,3,602
2021-11-23,Brazil,203070494,Bahia,14141626,0.7797,12711,11026931,0.5807,69949,8212229,0.0000,6,608
2021-11-24,Brazil,203070494,Bahia,14141626,0.7807,12942,11039873,0.5857,70356,8282585,0.0000,0,608
2021-11-25,Brazil,203070494,Bahia,14141626,0.7820,18349,11058222,0.5914,81450,8364035,0.0000,3,611
2021-11-26,Brazil,203070494,Bahia,14141626,0.7831,16432,11074654,0.5958,61276,8425311,0.0000,8,619
2021-11-27,Brazil,203070494,Bahia,14141626,0.7833,2425,11077079,0.5960,3142,8428453,0.0000,0,619
2021-11-28,Brazil,203070494,Bahia,14141626,0.7833,127,11077206,0.5960,259,8428712,0.0000,0,619
2021-11-29,Brazil,203070494,Bahia,14141626,0.7844,14953,11092159,0.6000,56935,8485647,0.0000,1,620
2021-11-30,Brazil,203070494,Bahia,14141626,0.7858,19708,11111867,0.6050,69733,8555380,0.0000,2,622
2021-12-01,Brazil,203070494,Bahia,14141626,0.7872,19772,11131639,0.6094,62883,8618263,0.0000,1,623
2021-12-02,Brazil,203070494,Bahia,14141626,0.7885,18887,11150526,0.6135,57093,8675356,0.0000,0,623
2021-12-03,Brazil,203070494,Bahia,14141626,0.7894,13106,11163632,0.6162,38052,8713408,0.0000,0,623
2021-12-04,Brazil,203070494,Bahia,14141626,0.7899,6688,11170320,0.6175,18366,8731774,0.0000,0,623
2021-12-05,Brazil,203070494,Bahia,14141626,0.7900,1034,11171354,0.6177,3086,8734860,0.0000,0,623
2021-12-06,Brazil,203070494,Bahia,14141626,0.7909,13289,11184643,0.6207,43424,8778284,0.0000,2,625
2021-12-07,Brazil,203070494,Bahia,14141626,0.7921,17151,11201794,0.6241,46926,8825210,0.0000,1,626
2021-12-08,Brazil,203070494,Bahia,14141626,0.7930,12233,11214027,0.6269,40022,8865232,0.0000,0,626
2021-12-09,Brazil,203070494,Bahia,14141626,0.7940,14660,11228687,0.6300,43649,8908881,0.0000,2,628
2021-12-10,Brazil,203070494,Bahia,14141626,0.7948,10954,11239641,0.6320,28481,8937362,0.0000,1,629
2021-12-11,Brazil,203070494,Bahia,14141626,0.7949,1773,11241414,0.6323,3737,8941099,0.0000,1,630
2021-12-12,Brazil,203070494,Bahia,14141626,0.7949,384,11241798,0.6323,834,8941933,0.0000,0,630
2021-12-13,Brazil,203070494,Bahia,14141626,0.7958,11792,11253590,0.6348,35311,8977244,0.0000,0,630
2021-12-14,Brazil,203070494,Bahia,14141626,0.7967,13672,11267262,0.6380,45208,9022452,0.0000,4,634
2021-12-15,Brazil,203070494,Bahia,14141626,0.7976,11940,11279202,0.6410,42688,9065140,0.0000,0,634
2021-12-16,Brazil,203070494,Bahia,14141626,0.7983,9663,11288865,0.6438,39741,9104881,0.0000,2,636
2021-12-17,Brazil,203070494,Bahia,14141626,0.7988,7537,11296402,0.6458,27619,9132500,0.0000,2,638
2021-12-18,Brazil,203070494,Bahia,14141626,0.7989,1891,11298293,0.6462,6034,9138534,0.0000,0,638
2021-12-19,Brazil,203070494,Bahia,14141626,0.7990,379,11298672,0.6464,2164,9140698,0.0000,0,638
2021-12-20,Brazil,203070494,Bahia,14141626,0.7995,8156,11306828,0.6487,32625,9173323,0.0000,2,640
2021-12-21,Brazil,203070494,Bahia,14141626,0.8002,9006,11315834,0.6513,37182,9210505,0.0000,1,641
2021-12-22,Brazil,203070494,Bahia,14141626,0.8007,7851,11323685,0.6536,32393,9242898,0.0000,6,647
2021-12-23,Brazil,203070494,Bahia,14141626,0.8010,4323,11328008,0.6550,20323,9263221,0.0000,2,649
2021-12-24,Brazil,203070494,Bahia,14141626,0.8010,134,11328142,0.6551,355,9263576,0.0000,1,650
2021-12-25,Brazil,203070494,Bahia,14141626,0.8011,24,11328166,0.6551,79,9263655,0.0000,0,650
2021-12-26,Brazil,203070494,Bahia,14141626,0.8011,37,11328203,0.6551,100,9263755,0.0000,0,650
2021-12-27,Brazil,203070494,Bahia,14141626,0.8014,4241,11332444,0.6561,14713,9278468,0.0000,2,652
2021-12-28,Brazil,203070494,Bahia,14141626,0.8017,4782,11337226,0.6573,17407,9295875,0.0000,0,652
2021-12-29,Brazil,203070494,Bahia,14141626,0.8020,4194,11341420,0.6584,15594,9311469,0.0000,0,652
2021-12-30,Brazil,203070494,Bahia,14141626,0.8022,2371,11343791,0.6590,8475,9319944,0.0000,1,653
2021-12-31,Brazil,203070494,Bahia,14141626,0.8022,116,11343907,0.6591,367,9320311,0.0000,0,653
2021-01-01,Brazil,203070494,Ceará,8794957,0.0000,34,34,0.0000,1,1,0.0000,0,0
2021-01-02,Brazil,203070494,Ceará,8794957,0.0000,3,37,0.0000,0,1,0.0000,0,0
2021-01-03,Brazil,203070494,Ceará,8794957,0.0000,2,39,0.0000,0,1,0.0000,0,0
2021-01-04,Brazil,203070494,Ceará,8794957,0.0000,24,63,0.0000,0,1,0.0000,0,0
2021-01-05,Brazil,203070494,Ceará,8794957,0.0000,2,65,0.0000,0,1,0.0000,0,0
2021-01-06,Brazil,203070494,Ceará,8794957,0.0000,9,74,0.0000,0,1,0.0000,0,0
2021-01-07,Brazil,203070494,Ceará,8794957,0.0000,5,79,0.0000,0,1,0.0000,0,0
2021-01-08,Brazil,203070494,Ceará,8794957,0.0000,0,79,0.0000,1,2,0.0000,0,0
2021-01-09,Brazil,203070494,Ceará,8794957,0.0000,3,82,0.0000,0,2,0.0000,0,0
2021-01-10,Brazil,203070494,Ceará,8794957,0.0000,10,92,0.0000,0,2,0.0000,0,0
2021-01-11,Brazil,203070494,Ceará,8794957,0.0000,8,100,0.0000,1,3,0.0000,0,0
2021-01-12,Brazil,203070494,Ceará,8794957,0.0000,16,116,0.0000,1,4,0.0000,0,0
2021-01-13,Brazil,203070494,Ceará,8794957,0.0000,6,122,0.0000,0,4,0.0000,0,0
2021-01-14,Brazil,203070494,Ceará,8794957,0.0000,10,132,0.0000,0,4,0.0000,0,0
2021-01-15,Brazil,203070494,Ceará,8794957,0.0000,2,134,0.0000,0,4,0.0000,0,0
2021-01-16,Brazil,203070494,Ceará,8794957,0.0000,3,137,0.0000,0,4,0.0000,0,0
2021-01-17,Brazil,203070494,Ceará,8794957,0.0000,30,167,0.0000,5,9,0.0000,0,0
2021-01-18,Brazil,203070494,Ceará,8794957,0.0000,163,330,0.0000,9,18,0.0000,0,0
2021-01-19,Brazil,203070494,Ceará,8794957,0.0006,4564,4894,0.0000,16,34,0.0000,0,0
2021-01-20,Brazil,203070494,Ceará,8794957,0.0018,10803,15697,0.0000,70,104,0.0000,0,0
2021-01-21,Brazil,203070494,Ceará,8794957,0.0030,10475,26172,0.0000,30,134,0.0000,0,0
2021-01-22,Brazil,203070494,Ceará,8794957,0.0040,8811,34983,0.0000,23,157,0.0000,0,0
2021-01-23,Brazil,203070494,Ceará,8794957,0.0044,3496,38479,0.0000,9,166,0.0000,0,0
2021-01-24,Brazil,203070494,Ceará,8794957,0.0046,2324,40803,0.0000,6,172,0.0000,0,0
2021-01-25,Brazil,203070494,Ceará,8794957,0.0057,9259,50062,0.0000,10,182,0.0000,0,0
2021-01-26,Brazil,203070494,Ceará,8794957,0.0067,9300,59362,0.0000,20,202,0.0000,0,0
2021-01-27,Brazil,203070494,Ceará,8794957,0.0088,18212,77574,0.0000,55,257,0.0000,0,0
2021-01-28,Brazil,203070494,Ceará,8794957,0.0111,20434,98008,0.0000,49,306,0.0000,0,0
2021-01-29,Brazil,203070494,Ceará,8794957,0.0128,14696,112704,0.0000,11,317,0.0000,0,0
2021-01-30,Brazil,203070494,Ceará,8794957,0.0133,4369,117073,0.0000,5,322,0.0000,0,0
2021-01-31,Brazil,203070494,Ceará,8794957,0.0136,2792,119865,0.0000,3,325,0.0000,0,0
2021-02-01,Brazil,203070494,Ceará,8794957,0.0150,12183,132048,0.0000,28,353,0.0000,0,0
2021-02-02,Brazil,203070494,Ceará,8794957,0.0166,14147,146195,0.0000,56,409,0.0000,0,0
2021-02-03,Brazil,203070494,Ceará,8794957,0.0180,12061,158256,0.0001,89,498,0.0000,0,0
2021-02-04,Brazil,203070494,Ceará,8794957,0.0194,12216,170472,0.0001,57,555,0.0000,0,0
2021-02-05,Brazil,203070494,Ceará,8794957,0.0208,12098,182570,0.0001,39,594,0.0000,0,0
2021-02-06,Brazil,203070494,Ceará,8794957,0.0215,6624,189194,0.0001,30,624,0.0000,0,0
2021-02-07,Brazil,203070494,Ceará,8794957,0.0222,6062,195256,0.0001,9,633,0.0000,0,0
2021-02-08,Brazil,203070494,Ceará,8794957,0.0232,8497,203753,0.0001,30,663,0.0000,0,0
2021-02-09,Brazil,203070494,Ceará,8794957,0.0242,9171,212924,0.0001,132,795,0.0000,0,0
2021-02-10,Brazil,203070494,Ceará,8794957,0.0254,10437,223361,0.0002,1176,1971,0.0000,0,0
2021-02-11,Brazil,203070494,Ceará,8794957,0.0269,13039,236400,0.0004,1487,3458,0.0000,0,0
2021-02-12,Brazil,203070494,Ceará,8794957,0.0282,11931,248331,0.0006,1423,4881,0.0000,0,0
2021-02-13,Brazil,203070494,Ceará,8794957,0.0290,6409,254740,0.0010,3507,8388,0.0000,0,0
2021-02-14,Brazil,203070494,Ceará,8794957,0.0296,5626,260366,0.0013,3039,11427,0.0000,0,0
2021-02-15,Brazil,203070494,Ceará,8794957,0.0305,8234,268600,0.0020,6302,17729,0.0000,0,0
2021-02-16,Brazil,203070494,Ceará,8794957,0.0314,7639,276239,0.0030,8641,26370,0.0000,0,0
2021-02-17,Brazil,203070494,Ceará,8794957,0.0322,7113,283352,0.0042,10407,36777,0.0000,0,0
2021-02-18,Brazil,203070494,Ceará,8794957,0.0330,7211,290563,0.0054,10811,47588,0.0000,0,0
2021-02-19,Brazil,203070494,Ceará,8794957,0.0335,4355,294918,0.0064,8708,56296,0.0000,0,0
2021-02-20,Brazil,203070494,Ceará,8794957,0.0336,737,295655,0.0070,5202,61498,0.0000,0,0
2021-02-21,Brazil,203070494,Ceará,8794957,0.0337,855,296510,0.0073,2796,64294,0.0000,0,0
2021-02-22,Brazil,203070494,Ceará,8794957,0.0340,2135,298645,0.0082,8248,72542,0.0000,0,0
2021-02-23,Brazil,203070494,Ceará,8794957,0.0341,1465,300110,0.0091,7512,80054,0.0000,0,0
2021-02-24,Brazil,203070494,Ceará,8794957,0.0342,1107,301217,0.0099,6757,86811,0.0000,0,0
2021-02-25,Brazil,203070494,Ceará,8794957,0.0348,5079,306296,0.0106,6258,93069,0.0000,0,0
2021-02-26,Brazil,203070494,Ceará,8794957,0.0363,12642,318938,0.0112,5091,98160,0.0000,0,0
2021-02-27,Brazil,203070494,Ceará,8794957,0.0367,3750,322688,0.0115,2606,100766,0.0000,0,0
2021-02-28,Brazil,203070494,Ceará,8794957,0.0370,2775,325463,0.0115,462,101228,0.0000,0,0
2021-03-01,Brazil,203070494,Ceará,8794957,0.0386,13637,339100,0.0124,7562,108790,0.0000,0,0
2021-03-02,Brazil,203070494,Ceará,8794957,0.0402,14494,353594,0.0129,4745,113535,0.0000,0,0
2021-03-03,Brazil,203070494,Ceará,8794957,0.0417,13160,366754,0.0134,4452,117987,0.0000,0,0
2021-03-04,Brazil,203070494,Ceará,8794957,0.0433,13886,380640,0.0139,3946,121933,0.0000,0,0
2021-03-05,Brazil,203070494,Ceará,8794957,0.0447,12319,392959,0.0144,4912,126845,0.0000,0,0
2021-03-06,Brazil,203070494,Ceará,8794957,0.0452,4303,397262,0.0150,4675,131520,0.0000,0,0
2021-03-07,Brazil,203070494,Ceará,8794957,0.0453,1540,398802,0.0153,2822,134342,0.0000,0,0
2021-03-08,Brazil,203070494,Ceará,8794957,0.0466,10770,409572,0.0161,6834,141176,0.0000,0,0
2021-03-09,Brazil,203070494,Ceará,8794957,0.0477,10307,419879,0.0169,7586,148762,0.0000,0,0
2021-03-10,Brazil,203070494,Ceará,8794957,0.0488,9195,429074,0.0180,9762,158524,0.0000,0,0
2021-03-11,Brazil,203070494,Ceará,8794957,0.0499,9940,439014,0.0189,7568,166092,0.0000,1,1
2021-03-12,Brazil,203070494,Ceará,8794957,0.0511,10841,449855,0.0194,4666,170758,0.0000,0,1
2021-03-13,Brazil,203070494,Ceará,8794957,0.0515,3475,453330,0.0196,1469,172227,0.0000,0,1
2021-03-14,Brazil,203070494,Ceará,8794957,0.0517,1180,454510,0.0196,486,172713,0.0000,0,1
2021-03-15,Brazil,203070494,Ceará,8794957,0.0529,10386,464896,0.0200,3547,176260,0.0000,0,1
2021-03-16,Brazil,203070494,Ceará,8794957,0.0539,8840,473736,0.0205,4369,180629,0.0000,0,1
2021-03-17,Brazil,203070494,Ceará,8794957,0.0549,8715,482451,0.0209,2852,183481,0.0000,0,1
2021-03-18,Brazil,203070494,Ceará,8794957,0.0564,13818,496269,0.0212,2708,186189,0.0000,0,1
2021-03-19,Brazil,203070494,Ceará,8794957,0.0574,8171,504440,0.0213,1241,187430,0.0000,0,1
2021-03-20,Brazil,203070494,Ceará,8794957,0.0584,8767,513207,0.0216,2281,189711,0.0000,0,1
2021-03-21,Brazil,203070494,Ceará,8794957,0.0588,4236,517443,0.0217,1068,190779,0.0000,0,1
2021-03-22,Brazil,203070494,Ceará,8794957,0.0623,30511,547954,0.0221,3377,194156,0.0000,0,1
2021-03-23,Brazil,203070494,Ceará,8794957,0.0678,48227,596181,0.0226,4343,198499,0.0000,0,1
2021-03-24,Brazil,203070494,Ceará,8794957,0.0736,50791,646972,0.0230,3677,202176,0.0000,0,1
2021-03-25,Brazil,203070494,Ceará,8794957,0.0789,46928,693900,0.0232,2299,204475,0.0000,0,1
2021-03-26,Brazil,203070494,Ceará,8794957,0.0817,24733,718633,0.0237,3858,208333,0.0000,0,1
2021-03-27,Brazil,203070494,Ceará,8794957,0.0853,31469,750102,0.0238,628,208961,0.0000,0,1
2021-03-28,Brazil,203070494,Ceará,8794957,0.0876,20559,770661,0.0238,369,209330,0.0000,0,1
2021-03-29,Brazil,203070494,Ceará,8794957,0.0920,38434,809095,0.0244,5318,214648,0.0000,0,1
2021-03-30,Brazil,203070494,Ceará,8794957,0.0969,42884,851979,0.0250,5094,219742,0.0000,0,1
2021-03-31,Brazil,203070494,Ceará,8794957,0.1020,45069,897048,0.0256,5539,225281,0.0000,0,1
2021-04-01,Brazil,203070494,Ceará,8794957,0.1072,45843,942891,0.0258,1795,227076,0.0000,0,1
2021-04-02,Brazil,203070494,Ceará,8794957,0.1103,27500,970391,0.0259,504,227580,0.0000,0,1
2021-04-03,Brazil,203070494,Ceará,8794957,0.1140,31903,1002294,0.0261,2353,229933,0.0000,0,1
2021-04-04,Brazil,203070494,Ceará,8794957,0.1148,7115,1009409,0.0263,967,230900,0.0000,0,1
2021-04-05,Brazil,203070494,Ceará,8794957,0.1168,17801,1027210,0.0273,9066,239966,0.0000,0,1
2021-04-06,Brazil,203070494,Ceará,8794957,0.1187,16381,1043591,0.0291,16186,256152,0.0000,0,1
2021-04-07,Brazil,203070494,Ceará,8794957,0.1200,11959,1055550,0.0312,18199,274351,0.0000,0,1
2021-04-08,Brazil,203070494,Ceará,8794957,0.1207,6261,1061811,0.0336,21428,295779,0.0000,0,1
2021-04-09,Brazil,203070494,Ceará,8794957,0.1214,5467,1067278,0.0356,17723,313502,0.0000,0,1
2021-04-10,Brazil,203070494,Ceará,8794957,0.1227,11554,1078832,0.0365,7205,320707,0.0000,0,1
2021-04-11,Brazil,203070494,Ceará,8794957,0.1231,3790,1082622,0.0366,1606,322313,0.0000,0,1
2021-04-12,Brazil,203070494,Ceará,8794957,0.1245,11936,1094558,0.0386,17110,339423,0.0000,0,1
2021-04-13,Brazil,203070494,Ceará,8794957,0.1258,12196,1106754,0.0406,17614,357037,0.0000,0,1
2021-04-14,Brazil,203070494,Ceará,8794957,0.1267,7810,1114564,0.0430,20913,377950,0.0000,0,1
2021-04-15,Brazil,203070494,Ceará,8794957,0.1277,8905,1123469,0.0461,27156,405106,0.0000,0,1
2021-04-16,Brazil,203070494,Ceará,8794957,0.1292,12719,1136188,0.0489,25029,430135,0.0000,0,1
2021-04-17,Brazil,203070494,Ceará,8794957,0.1318,23027,1159215,0.0508,16547,446682,0.0000,0,1
2021-04-18,Brazil,203070494,Ceará,8794957,0.1324,5537,1164752,0.0510,2061,448743,0.0000,0,1
2021-04-19,Brazil,203070494,Ceará,8794957,0.1347,19730,1184482,0.0542,27604,476347,0.0000,0,1
2021-04-20,Brazil,203070494,Ceará,8794957,0.1372,22436,1206918,0.0584,37494,513841,0.0000,0,1
2021-04-21,Brazil,203070494,Ceará,8794957,0.1398,22276,1229194,0.0599,12613,526454,0.0000,0,1
2021-04-22,Brazil,203070494,Ceará,8794957,0.1418,17899,1247093,0.0632,29786,556240,0.0000,0,1
2021-04-23,Brazil,203070494,Ceará,8794957,0.1432,12176,1259269,0.0660,24427,580667,0.0000,0,1
2021-04-24,Brazil,203070494,Ceará,8794957,0.1455,20816,1280085,0.0680,17395,598062,0.0000,0,1
2021-04-25,Brazil,203070494,Ceará,8794957,0.1456,464,1280549,0.0689,8090,606152,0.0000,0,1
2021-04-26,Brazil,203070494,Ceará,8794957,0.1474,15442,1295991,0.0717,24817,630969,0.0000,0,1
2021-04-27,Brazil,203070494,Ceará,8794957,0.1492,16405,1312396,0.0754,32095,663064,0.0000,0,1
2021-04-28,Brazil,203070494,Ceará,8794957,0.1507,12933,1325329,0.0783,26005,689069,0.0000,0,1
2021-04-29,Brazil,203070494,Ceará,8794957,0.1519,10922,1336251,0.0803,17283,706352,0.0000,0,1
2021-04-30,Brazil,203070494,Ceará,8794957,0.1532,10808,1347059,0.0813,8866,715218,0.0000,0,1
2021-05-01,Brazil,203070494,Ceará,8794957,0.1545,11971,1359030,0.0822,7779,722997,0.0000,0,1
2021-05-02,Brazil,203070494,Ceará,8794957,0.1550,4170,1363200,0.0826,3701,726698,0.0000,0,1
2021-05-03,Brazil,203070494,Ceará,8794957,0.1569,16671,1379871,0.0842,13631,740329,0.0000,0,1
2021-05-04,Brazil,203070494,Ceará,8794957,0.1590,18139,1398010,0.0856,12145,752474,0.0000,0,1
2021-05-05,Brazil,203070494,Ceará,8794957,0.1610,17788,1415798,0.0866,9365,761839,0.0000,0,1
2021-05-06,Brazil,203070494,Ceará,8794957,0.1625,13412,1429210,0.0872,5466,767305,0.0000,0,1
2021-05-07,Brazil,203070494,Ceará,8794957,0.1641,14408,1443618,0.0878,4538,771843,0.0000,0,1
2021-05-08,Brazil,203070494,Ceará,8794957,0.1657,13526,1457144,0.0892,12733,784576,0.0000,0,1
2021-05-09,Brazil,203070494,Ceará,8794957,0.1658,1461,1458605,0.0894,2113,786689,0.0000,0,1
2021-05-10,Brazil,203070494,Ceará,8794957,0.1674,14095,1472700,0.0903,7561,794250,0.0000,0,1
2021-05-11,Brazil,203070494,Ceará,8794957,0.1690,13909,1486609,0.0911,7297,801547,0.0000,0,1
2021-05-12,Brazil,203070494,Ceará,8794957,0.1706,13518,1500127,0.0918,5606,807153,0.0000,0,1
2021-05-13,Brazil,203070494,Ceará,8794957,0.1716,8735,1508862,0.0934,14147,821300,0.0000,0,1
2021-05-14,Brazil,203070494,Ceará,8794957,0.1732,14697,1523559,0.0938,3292,824592,0.0000,0,1
2021-05-15,Brazil,203070494,Ceará,8794957,0.1757,21873,1545432,0.0938,454,825046,0.0000,0,1
2021-05-16,Brazil,203070494,Ceará,8794957,0.1758,558,1545990,0.0974,31859,856905,0.0000,0,1
2021-05-17,Brazil,203070494,Ceará,8794957,0.1769,9942,1555932,0.0982,6631,863536,0.0000,0,1
2021-05-18,Brazil,203070494,Ceará,8794957,0.1782,11628,1567560,0.0990,6962,870498,0.0000,0,1
2021-05-19,Brazil,203070494,Ceará,8794957,0.1801,16473,1584033,0.0994,3843,874341,0.0000,0,1
2021-05-20,Brazil,203070494,Ceará,8794957,0.1823,19089,1603122,0.1012,15337,889678,0.0000,0,1
2021-05-21,Brazil,203070494,Ceará,8794957,0.1842,16834,1619956,0.1021,8360,898038,0.0000,0,1
2021-05-22,Brazil,203070494,Ceará,8794957,0.1862,17938,1637894,0.1023,1647,899685,0.0000,0,1
2021-05-23,Brazil,203070494,Ceará,8794957,0.1867,4490,1642384,0.1023,330,900015,0.0000,0,1
2021-05-24,Brazil,203070494,Ceará,8794957,0.1887,17608,1659992,0.1029,5005,905020,0.0000,0,1
2021-05-25,Brazil,203070494,Ceará,8794957,0.1912,21697,1681689,0.1035,5506,910526,0.0000,0,1
2021-05-26,Brazil,203070494,Ceará,8794957,0.1937,21534,1703223,0.1042,5776,916302,0.0000,0,1
2021-05-27,Brazil,203070494,Ceará,8794957,0.1963,23573,1726796,0.1047,4964,921266,0.0000,0,1
2021-05-28,Brazil,203070494,Ceará,8794957,0.1992,24753,1751549,0.1052,4045,925311,0.0000,0,1
2021-05-29,Brazil,203070494,Ceará,8794957,0.2027,31278,1782827,0.1053,1127,926438,0.0000,0,1
2021-05-30,Brazil,203070494,Ceará,8794957,0.2033,5333,1788160,0.1054,261,926699,0.0000,0,1
2021-05-31,Brazil,203070494,Ceará,8794957,0.2064,26793,1814953,0.1057,3164,929863,0.0000,0,1
2021-06-01,Brazil,203070494,Ceará,8794957,0.2105,36601,1851554,0.1063,5019,934882,0.0000,0,1
2021-06-02,Brazil,203070494,Ceará,8794957,0.2165,52823,1904377,0.1070,5823,940705,0.0000,0,1
2021-06-03,Brazil,203070494,Ceará,8794957,0.2197,27758,1932135,0.1072,1793,942498,0.0000,0,1
2021-06-04,Brazil,203070494,Ceará,8794957,0.2240,38032,1970167,0.1075,2831,945329,0.0000,0,1
2021-06-05,Brazil,203070494,Ceará,8794957,0.2271,27515,1997682,0.1076,1182,946511,0.0000,0,1
2021-06-06,Brazil,203070494,Ceará,8794957,0.2286,12432,2010114,0.1078,1183,947694,0.0000,0,1
2021-06-07,Brazil,203070494,Ceará,8794957,0.2335,43435,2053549,0.1082,3748,951442,0.0000,0,1
2021-06-08,Brazil,203070494,Ceará,8794957,0.2389,47526,2101075,0.1086,3491,954933,0.0000,0,1
2021-06-09,Brazil,203070494,Ceará,8794957,0.2451,54725,2155800,0.1089,2736,957669,0.0000,0,1
2021-06-10,Brazil,203070494,Ceará,8794957,0.2523,63229,2219029,0.1092,3165,960834,0.0000,0,1
2021-06-11,Brazil,203070494,Ceará,8794957,0.2598,65852,2284881,0.1095,1967,962801,0.0000,0,1
2021-06-12,Brazil,203070494,Ceará,8794957,0.2685,76227,2361108,0.1095,337,963138,0.0000,0,1
2021-06-13,Brazil,203070494,Ceará,8794957,0.2700,13958,2375066,0.1095,109,963247,0.0000,0,1
2021-06-14,Brazil,203070494,Ceará,8794957,0.2758,50641,2425707,0.1097,1472,964719,0.0000,0,1
2021-06-15,Brazil,203070494,Ceará,8794957,0.2831,63993,2489700,0.1099,1442,966161,0.0000,0,1
2021-06-16,Brazil,203070494,Ceará,8794957,0.2900,60973,2550673,0.1100,1435,967596,0.0000,0,1
2021-06-17,Brazil,203070494,Ceará,8794957,0.2964,56203,2606876,0.1102,1444,969040,0.0000,0,1
2021-06-18,Brazil,203070494,Ceará,8794957,0.3040,67171,2674047,0.1103,822,969862,0.0000,0,1
2021-06-19,Brazil,203070494,Ceará,8794957,0.3136,84315,2758362,0.1103,505,970367,0.0000,0,1
2021-06-20,Brazil,203070494,Ceará,8794957,0.3157,18411,2776773,0.1104,1033,971400,0.0000,0,1
2021-06-21,Brazil,203070494,Ceará,8794957,0.3236,69681,2846454,0.1106,952,972352,0.0000,0,1
2021-06-22,Brazil,203070494,Ceará,8794957,0.3335,86710,2933164,0.1107,1396,973748,0.0000,0,1
2021-06-23,Brazil,203070494,Ceará,8794957,0.3441,93189,3026353,0.1109,1745,975493,0.0000,0,1
2021-06-24,Brazil,203070494,Ceará,8794957,0.3518,67860,3094213,0.1115,5095,980588,0.0000,0,1
2021-06-25,Brazil,203070494,Ceará,8794957,0.3590,62876,3157089,0.1119,3575,984163,0.0000,0,1
2021-06-26,Brazil,203070494,Ceará,8794957,0.3702,98889,3255978,0.1121,1323,985486,0.0000,0,1
2021-06-27,Brazil,203070494,Ceará,8794957,0.3724,19329,3275307,0.1121,120,985606,0.0000,0,1
2021-06-28,Brazil,203070494,Ceará,8794957,0.3801,67827,3343134,0.1126,4508,990114,0.0000,0,1
2021-06-29,Brazil,203070494,Ceará,8794957,0.3866,56983,3400117,0.1140,12526,1002640,0.0000,0,1
2021-06-30,Brazil,203070494,Ceará,8794957,0.3924,51416,3451533,0.1155,13298,1015938,0.0000,0,1
2021-07-01,Brazil,203070494,Ceará,8794957,0.3983,51138,3502671,0.1165,8774,1024712,0.0000,0,1
2021-07-02,Brazil,203070494,Ceará,8794957,0.4027,39475,3542146,0.1179,12036,1036748,0.0000,0,1
2021-07-03,Brazil,203070494,Ceará,8794957,0.4063,31092,3573238,0.1181,2143,1038891,0.0000,0,1
2021-07-04,Brazil,203070494,Ceará,8794957,0.4075,10615,3583853,0.1182,1112,1040003,0.0000,0,1
2021-07-05,Brazil,203070494,Ceará,8794957,0.4133,51311,3635164,0.1191,7620,1047623,0.0000,0,1
2021-07-06,Brazil,203070494,Ceará,8794957,0.4199,58278,3693442,0.1201,8608,1056231,0.0000,0,1
2021-07-07,Brazil,203070494,Ceará,8794957,0.4272,63419,3756861,0.1232,27278,1083509,0.0000,0,1
2021-07-08,Brazil,203070494,Ceará,8794957,0.4346,65069,3821930,0.1249,14755,1098264,0.0000,0,1
2021-07-09,Brazil,203070494,Ceará,8794957,0.4385,35033,3856963,0.1259,8677,1106941,0.0000,0,1
2021-07-10,Brazil,203070494,Ceará,8794957,0.4416,27231,3884194,0.1262,3196,1110137,0.0000,0,1
2021-07-11,Brazil,203070494,Ceará,8794957,0.4421,3662,3887856,0.1263,278,1110415,0.0000,0,1
2021-07-12,Brazil,203070494,Ceará,8794957,0.4458,33219,3921075,0.1287,21277,1131692,0.0000,0,1
2021-07-13,Brazil,203070494,Ceará,8794957,0.4497,34256,3955331,0.1313,23476,1155168,0.0000,0,1
2021-07-14,Brazil,203070494,Ceará,8794957,0.4524,23300,3978631,0.1326,10702,1165870,0.0000,0,1
2021-07-15,Brazil,203070494,Ceará,8794957,0.4537,11960,3990591,0.1339,11396,1177266,0.0000,0,1
2021-07-16,Brazil,203070494,Ceará,8794957,0.4550,11359,4001950,0.1353,12441,1189707,0.0000,0,1
2021-07-17,Brazil,203070494,Ceará,8794957,0.4551,559,4002509,0.1357,3484,1193191,0.0000,0,1
2021-07-18,Brazil,203070494,Ceará,8794957,0.4551,56,4002565,0.1357,453,1193644,0.0000,0,1
2021-07-19,Brazil,203070494,Ceará,8794957,0.4584,29031,4031596,0.1373,14279,1207923,0.0000,0,1
2021-07-20,Brazil,203070494,Ceará,8794957,0.4623,34432,4066028,0.1391,15083,1223006,0.0000,0,1
2021-07-21,Brazil,203070494,Ceará,8794957,0.4661,33437,4099465,0.1411,18385,1241391,0.0000,0,1
2021-07-22,Brazil,203070494,Ceará,8794957,0.4701,34989,4134454,0.1438,23624,1265015,0.0000,0,1
2021-07-23,Brazil,203070494,Ceará,8794957,0.4738,32776,4167230,0.1479,36136,1301151,0.0000,0,1
2021-07-24,Brazil,203070494,Ceará,8794957,0.4750,10776,4178006,0.1489,8421,1309572,0.0000,0,1
2021-07-25,Brazil,203070494,Ceará,8794957,0.4752,1398,4179404,0.1491,1413,1310985,0.0000,0,1
2021-07-26,Brazil,203070494,Ceará,8794957,0.4780,24746,4204150,0.1518,24132,1335117,0.0000,0,1
2021-07-27,Brazil,203070494,Ceará,8794957,0.4808,24736,4228886,0.1546,24944,1360061,0.0000,0,1
2021-07-28,Brazil,203070494,Ceará,8794957,0.4819,9348,4238234,0.1579,28748,1388809,0.0000,0,1
2021-07-29,Brazil,203070494,Ceará,8794957,0.4839,17282,4255516,0.1597,16055,1404864,0.0000,0,1
2021-07-30,Brazil,203070494,Ceará,8794957,0.4897,51787,4307303,0.1617,17500,1422364,0.0000,0,1
2021-07-31,Brazil,203070494,Ceará,8794957,0.4915,15265,4322568,0.1629,10726,1433090,0.0000,0,1
2021-08-01,Brazil,203070494,Ceará,8794957,0.4916,1361,4323929,0.1640,8975,1442065,0.0000,0,1
2021-08-02,Brazil,203070494,Ceará,8794957,0.4929,11059,4334988,0.1672,28559,1470624,0.0000,0,1
2021-08-03,Brazil,203070494,Ceará,8794957,0.4943,12257,4347245,0.1713,35913,1506537,0.0000,0,1
2021-08-04,Brazil,203070494,Ceará,8794957,0.4981,33884,4381129,0.1748,31115,1537652,0.0000,0,1
2021-08-05,Brazil,203070494,Ceará,8794957,0.5040,51330,4432459,0.1782,29297,1566949,0.0000,0,1
2021-08-06,Brazil,203070494,Ceará,8794957,0.5109,61075,4493534,0.1812,26461,1593410,0.0000,0,1
2021-08-07,Brazil,203070494,Ceará,8794957,0.5144,30967,4524501,0.1821,8079,1601489,0.0000,0,1
2021-08-08,Brazil,203070494,Ceará,8794957,0.5157,10782,4535283,0.1823,1439,1602928,0.0000,0,1
2021-08-09,Brazil,203070494,Ceará,8794957,0.5213,49207,4584490,0.1854,27895,1630823,0.0000,0,1
2021-08-10,Brazil,203070494,Ceará,8794957,0.5298,75192,4659682,0.1886,28260,1659083,0.0000,0,1
2021-08-11,Brazil,203070494,Ceará,8794957,0.5399,88732,4748414,0.1928,36530,1695613,0.0000,0,1
2021-08-12,Brazil,203070494,Ceará,8794957,0.5504,92439,4840853,0.1956,24599,1720212,0.0000,0,1
2021-08-13,Brazil,203070494,Ceará,8794957,0.5600,84287,4925140,0.1974,15893,1736105,0.0000,0,1
2021-08-14,Brazil,203070494,Ceará,8794957,0.5678,69012,4994152,0.1982,7461,1743566,0.0000,0,1
2021-08-15,Brazil,203070494,Ceará,8794957,0.5698,16781,5010933,0.1986,3104,1746670,0.0000,0,1
2021-08-16,Brazil,203070494,Ceará,8794957,0.5764,58765,5069698,0.2004,15745,1762415,0.0000,0,1
2021-08-17,Brazil,203070494,Ceará,8794957,0.5864,87344,5157042,0.2028,20910,1783325,0.0000,0,1
2021-08-18,Brazil,203070494,Ceará,8794957,0.5940,66856,5223898,0.2063,30661,1813986,0.0000,0,1
2021-08-19,Brazil,203070494,Ceará,8794957,0.5996,49196,5273094,0.2115,46231,1860217,0.0000,0,1
2021-08-20,Brazil,203070494,Ceará,8794957,0.6073,68357,5341451,0.2148,28921,1889138,0.0000,0,1
2021-08-21,Brazil,203070494,Ceará,8794957,0.6125,45340,5386791,0.2168,17214,1906352,0.0000,0,1
2021-08-22,Brazil,203070494,Ceará,8794957,0.6139,12799,5399590,0.2172,4174,1910526,0.0000,0,1
2021-08-23,Brazil,203070494,Ceará,8794957,0.6186,41161,5440751,0.2214,36447,1946973,0.0000,0,1
2021-08-24,Brazil,203070494,Ceará,8794957,0.6252,58225,5498976,0.2269,48352,1995325,0.0000,0,1
2021-08-25,Brazil,203070494,Ceará,8794957,0.6342,79132,5578108,0.2331,54644,2049969,0.0000,0,1
2021-08-26,Brazil,203070494,Ceará,8794957,0.6418,66333,5644441,0.2395,56162,2106131,0.0000,0,1
2021-08-27,Brazil,203070494,Ceará,8794957,0.6499,71204,5715645,0.2447,45944,2152075,0.0000,0,1
2021-08-28,Brazil,203070494,Ceará,8794957,0.6567,60038,5775683,0.2466,16339,2168414,0.0000,0,1
2021-08-29,Brazil,203070494,Ceará,8794957,0.6582,13316,5788999,0.2468,1777,2170191,0.0000,0,1
2021-08-30,Brazil,203070494,Ceará,8794957,0.6642,52818,5841817,0.2504,32327,2202518,0.0000,0,1
2021-08-31,Brazil,203070494,Ceará,8794957,0.6720,68619,5910436,0.2546,36964,2239482,0.0000,0,1
2021-09-01,Brazil,203070494,Ceará,8794957,0.6778,50700,5961136,0.2595,42880,2282362,0.0000,0,1
2021-09-02,Brazil,203070494,Ceará,8794957,0.6815,32657,5993793,0.2679,73994,2356356,0.0000,0,1
2021-09-03,Brazil,203070494,Ceará,8794957,0.6859,38530,6032323,0.2755,66270,2422626,0.0000,0,1
2021-09-04,Brazil,203070494,Ceará,8794957,0.6896,32692,6065015,0.2777,19411,2442037,0.0000,0,1
2021-09-05,Brazil,203070494,Ceará,8794957,0.6903,5950,6070965,0.2780,2647,2444684,0.0000,0,1
2021-09-06,Brazil,203070494,Ceará,8794957,0.6913,9024,6079989,0.2826,40849,2485533,0.0000,0,1
2021-09-07,Brazil,203070494,Ceará,8794957,0.6922,7947,6087936,0.2832,5427,2490960,0.0000,0,1
2021-09-08,Brazil,203070494,Ceará,8794957,0.6951,25583,6113519,0.2913,70839,2561799,0.0000,0,1
2021-09-09,Brazil,203070494,Ceará,8794957,0.6988,32094,6145613,0.3003,79685,2641484,0.0000,0,1
2021-09-10,Brazil,203070494,Ceará,8794957,0.7024,32000,6177613,0.3079,66545,2708029,0.0000,0,1
2021-09-11,Brazil,203070494,Ceará,8794957,0.7046,19351,6196964,0.3110,27571,2735600,0.0000,0,1
2021-09-12,Brazil,203070494,Ceará,8794957,0.7051,4499,6201463,0.3114,2714,2738314,0.0000,0,1
2021-09-13,Brazil,203070494,Ceará,8794957,0.7082,26750,6228213,0.3170,49460,2787774,0.0000,0,1
2021-09-14,Brazil,203070494,Ceará,8794957,0.7120,33721,6261934,0.3224,47822,2835596,0.0000,0,1
2021-09-15,Brazil,203070494,Ceará,8794957,0.7161,36063,6297997,0.3290,58383,2893979,0.0000,0,1
2021-09-16,Brazil,203070494,Ceará,8794957,0.7200,34791,6332788,0.3357,58653,2952632,0.0000,0,1
2021-09-17,Brazil,203070494,Ceará,8794957,0.7236,30809,6363597,0.3401,38759,2991391,0.0000,0,1
2021-09-18,Brazil,203070494,Ceará,8794957,0.7256,18101,6381698,0.3434,29038,3020429,0.0000,0,1
2021-09-19,Brazil,203070494,Ceará,8794957,0.7259,2176,6383874,0.3442,6702,3027131,0.0000,0,1
2021-09-20,Brazil,203070494,Ceará,8794957,0.7294,30730,6414604,0.3496,47857,3074988,0.0000,0,1
2021-09-21,Brazil,203070494,Ceará,8794957,0.7339,39581,6454185,0.3555,51586,3126574,0.0000,0,1
2021-09-22,Brazil,203070494,Ceará,8794957,0.7384,39733,6493918,0.3625,61713,3188287,0.0000,0,1
2021-09-23,Brazil,203070494,Ceará,8794957,0.7429,39933,6533851,0.3701,66298,3254585,0.0000,0,1
2021-09-24,Brazil,203070494,Ceará,8794957,0.7461,28239,6562090,0.3766,57798,3312383,0.0000,0,1
2021-09-25,Brazil,203070494,Ceará,8794957,0.7478,14391,6576481,0.3793,23268,3335651,0.0000,0,1
2021-09-26,Brazil,203070494,Ceará,8794957,0.7479,1486,6577967,0.3800,6674,3342325,0.0000,0,1
2021-09-27,Brazil,203070494,Ceará,8794957,0.7502,19960,6597927,0.3852,45619,3387944,0.0000,0,1
2021-09-28,Brazil,203070494,Ceará,8794957,0.7531,25578,6623505,0.3915,54980,3442924,0.0000,0,1
2021-09-29,Brazil,203070494,Ceará,8794957,0.7562,27224,6650729,0.3983,60271,3503195,0.0000,0,1
2021-09-30,Brazil,203070494,Ceará,8794957,0.7587,21632,6672361,0.4051,59737,3562932,0.0000,0,1
2021-10-01,Brazil,203070494,Ceará,8794957,0.7610,20650,6693011,0.4099,42104,3605036,0.0000,0,1
2021-10-02,Brazil,203070494,Ceará,8794957,0.7620,8510,6701521,0.4135,31518,3636554,0.0000,0,1
2021-10-03,Brazil,203070494,Ceará,8794957,0.7620,153,6701674,0.4138,2462,3639016,0.0000,0,1
2021-10-04,Brazil,203070494,Ceará,8794957,0.7630,8753,6710427,0.4183,39747,3678763,0.0000,0,1
2021-10-05,Brazil,203070494,Ceará,8794957,0.7644,12402,6722829,0.4257,65137,3743900,0.0000,0,1
2021-10-06,Brazil,203070494,Ceará,8794957,0.7664,17452,6740281,0.4330,64123,3808023,0.0000,0,1
2021-10-07,Brazil,203070494,Ceará,8794957,0.7678,12224,6752505,0.4398,59869,3867892,0.0000,0,1
2021-10-08,Brazil,203070494,Ceará,8794957,0.7691,11637,6764142,0.4457,51969,3919861,0.0000,0,1
2021-10-09,Brazil,203070494,Ceará,8794957,0.7697,5325,6769467,0.4473,14319,3934180,0.0000,1,2
2021-10-10,Brazil,203070494,Ceará,8794957,0.7698,679,6770146,0.4477,2980,3937160,0.0000,0,2
2021-10-11,Brazil,203070494,Ceará,8794957,0.7704,5780,6775926,0.4514,32526,3969686,0.0000,0,2
2021-10-12,Brazil,203070494,Ceará,8794957,0.7705,244,6776170,0.4519,4472,3974158,0.0000,0,2
2021-10-13,Brazil,203070494,Ceará,8794957,0.7713,7617,6783787,0.4589,61803,4035961,0.0000,0,2
2021-10-14,Brazil,203070494,Ceará,8794957,0.7722,7243,6791030,0.4662,64657,4100618,0.0000,1,3
2021-10-15,Brazil,203070494,Ceará,8794957,0.7734,10678,6801708,0.4737,65160,4165778,0.0000,0,3
2021-10-16,Brazil,203070494,Ceará,8794957,0.7739,4565,6806273,0.4749,10698,4176476,0.0000,0,3
2021-10-17,Brazil,203070494,Ceará,8794957,0.7740,739,6807012,0.4756,6230,4182706,0.0000,0,3
2021-10-18,Brazil,203070494,Ceará,8794957,0.7748,7634,6814646,0.4810,47904,4230610,0.0000,0,3
2021-10-19,Brazil,203070494,Ceará,8794957,0.7761,11399,6826045,0.4876,58207,4288817,0.0000,1,4
2021-10-20,Brazil,203070494,Ceará,8794957,0.7774,10980,6837025,0.4942,57947,4346764,0.0000,1,5
2021-10-21,Brazil,203070494,Ceará,8794957,0.7790,14113,6851138,0.5014,63325,4410089,0.0000,0,5
2021-10-22,Brazil,203070494,Ceará,8794957,0.7805,13193,6864331,0.5071,49772,4459861,0.0000,0,5
2021-10-23,Brazil,203070494,Ceará,8794957,0.7810,4745,6869076,0.5085,12458,4472319,0.0000,0,5
2021-10-24,Brazil,203070494,Ceará,8794957,0.7810,69,6869145,0.5086,418,4472737,0.0000,0,5
2021-10-25,Brazil,203070494,Ceará,8794957,0.7822,9867,6879012,0.5140,47758,4520495,0.0000,0,5
2021-10-26,Brazil,203070494,Ceará,8794957,0.7840,15917,6894929,0.5199,52051,4572546,0.0000,0,5
2021-10-27,Brazil,203070494,Ceará,8794957,0.7854,12554,6907483,0.5271,63166,4635712,0.0000,0,5
2021-10-28,Brazil,203070494,Ceará,8794957,0.7869,13497,6920980,0.5336,57678,4693390,0.0000,0,5
2021-10-29,Brazil,203070494,Ceará,8794957,0.7883,11815,6932795,0.5387,44764,4738154,0.0000,0,5
2021-10-30,Brazil,203070494,Ceará,8794957,0.7886,3334,6936129,0.5405,15800,4753954,0.0000,0,5
2021-10-31,Brazil,203070494,Ceará,8794957,0.7887,233,6936362,0.5408,2733,4756687,0.0000,0,5
2021-11-01,Brazil,203070494,Ceará,8794957,0.7888,1436,6937798,0.5418,8299,4764986,0.0000,0,5
2021-11-02,Brazil,203070494,Ceará,8794957,0.7889,907,6938705,0.5422,3842,4768828,0.0000,0,5
2021-11-03,Brazil,203070494,Ceará,8794957,0.7897,6878,6945583,0.5468,40367,4809195,0.0000,1,6
2021-11-04,Brazil,203070494,Ceará,8794957,0.7907,8655,6954238,0.5526,50881,4860076,0.0000,0,6
2021-11-05,Brazil,203070494,Ceará,8794957,0.7921,12671,6966909,0.5581,48195,4908271,0.0000,1,7
2021-11-06,Brazil,203070494,Ceará,8794957,0.7926,3741,6970650,0.5600,16930,4925201,0.0000,1,8
2021-11-07,Brazil,203070494,Ceará,8794957,0.7926,314,6970964,0.5608,6934,4932135,0.0000,0,8
2021-11-08,Brazil,203070494,Ceará,8794957,0.7933,6243,6977207,0.5641,28816,4960951,0.0000,0,8
2021-11-09,Brazil,203070494,Ceará,8794957,0.7943,8623,6985830,0.5679,33749,4994700,0.0000,0,8
2021-11-10,Brazil,203070494,Ceará,8794957,0.7957,12509,6998339,0.5741,54721,5049421,0.0000,0,8
2021-11-11,Brazil,203070494,Ceará,8794957,0.7970,10946,7009285,0.5801,52260,5101681,0.0000,0,8
2021-11-12,Brazil,203070494,Ceará,8794957,0.7982,11006,7020291,0.5853,46253,5147934,0.0000,0,8
2021-11-13,Brazil,203070494,Ceará,8794957,0.7985,2825,7023116,0.5876,19779,5167713,0.0000,0,8
2021-11-14,Brazil,203070494,Ceará,8794957,0.7986,663,7023779,0.5879,2816,5170529,0.0000,0,8
2021-11-15,Brazil,203070494,Ceará,8794957,0.7989,2317,7026096,0.5889,9146,5179675,0.0000,0,8
2021-11-16,Brazil,203070494,Ceará,8794957,0.7998,8033,7034129,0.5940,44693,5224368,0.0000,1,9
2021-11-17,Brazil,203070494,Ceará,8794957,0.8012,12371,7046500,0.5994,46976,5271344,0.0000,0,9
2021-11-18,Brazil,203070494,Ceará,8794957,0.8029,14865,7061365,0.6042,42470,5313814,0.0000,0,9
2021-11-19,Brazil,203070494,Ceará,8794957,0.8040,9947,7071312,0.6083,36149,5349963,0.0000,0,9
2021-11-20,Brazil,203070494,Ceará,8794957,0.8048,6720,7078032,0.6107,21348,5371311,0.0000,0,9
2021-11-21,Brazil,203070494,Ceará,8794957,0.8049,1052,7079084,0.6111,3507,5374818,0.0000,0,9
2021-11-22,Brazil,203070494,Ceará,8794957,0.8057,6884,7085968,0.6147,31429,5406247,0.0000,0,9
2021-11-23,Brazil,203070494,Ceará,8794957,0.8068,9636,7095604,0.6193,40763,5447010,0.0000,0,9
2021-11-24,Brazil,203070494,Ceará,8794957,0.8080,10901,7106505,0.6235,36913,5483923,0.0000,0,9
2021-11-25,Brazil,203070494,Ceará,8794957,0.8090,8976,7115481,0.6279,38484,5522407,0.0000,0,9
2021-11-26,Brazil,203070494,Ceará,8794957,0.8100,8197,7123678,0.6312,29253,5551660,0.0000,0,9
2021-11-27,Brazil,203070494,Ceará,8794957,0.8104,4148,7127826,0.6325,11222,5562882,0.0000,0,9
2021-11-28,Brazil,203070494,Ceará,8794957,0.8105,805,7128631,0.6328,2373,5565255,0.0000,0,9
2021-11-29,Brazil,203070494,Ceará,8794957,0.8113,6669,7135300,0.6356,24431,5589686,0.0000,0,9
2021-11-30,Brazil,203070494,Ceará,8794957,0.8122,7588,7142888,0.6385,26221,5615907,0.0000,1,10
2021-12-01,Brazil,203070494,Ceará,8794957,0.8129,6623,7149511,0.6410,21972,5637879,0.0000,1,11
2021-12-02,Brazil,203070494,Ceará,8794957,0.8138,7941,7157452,0.6438,24739,5662618,0.0000,0,11
2021-12-03,Brazil,203070494,Ceará,8794957,0.8147,7485,7164937,0.6459,17861,5680479,0.0000,0,11
2021-12-04,Brazil,203070494,Ceará,8794957,0.8151,3841,7168778,0.6469,8594,5689073,0.0000,0,11
2021-12-05,Brazil,203070494,Ceará,8794957,0.8152,543,7169321,0.6470,1312,5690385,0.0000,0,11
2021-12-06,Brazil,203070494,Ceará,8794957,0.8158,5859,7175180,0.6487,14529,5704914,0.0000,0,11
2021-12-07,Brazil,203070494,Ceará,8794957,0.8169,9564,7184744,0.6508,19109,5724023,0.0000,1,12
2021-12-08,Brazil,203070494,Ceará,8794957,0.8178,7473,7192217,0.6533,21674,5745697,0.0000,0,12
2021-12-09,Brazil,203070494,Ceará,8794957,0.8188,9392,7201609,0.6557,21478,5767175,0.0000,0,12
2021-12-10,Brazil,203070494,Ceará,8794957,0.8195,5506,7207115,0.6575,15621,5782796,0.0000,2,14
2021-12-11,Brazil,203070494,Ceará,8794957,0.8197,1961,7209076,0.6580,4000,5786796,0.0000,0,14
2021-12-12,Brazil,203070494,Ceará,8794957,0.8197,465,7209541,0.6581,1329,5788125,0.0000,1,15
2021-12-13,Brazil,203070494,Ceará,8794957,0.8204,5462,7215003,0.6595,11725,5799850,0.0000,0,15
2021-12-14,Brazil,203070494,Ceará,8794957,0.8211,6323,7221326,0.6612,15192,5815042,0.0000,1,16
2021-12-15,Brazil,203070494,Ceará,8794957,0.8220,8166,7229492,0.6635,20844,5835886,0.0000,0,16
2021-12-16,Brazil,203070494,Ceará,8794957,0.8231,9447,7238939,0.6662,23099,5858985,0.0000,0,16
2021-12-17,Brazil,203070494,Ceará,8794957,0.8237,5278,7244217,0.6680,16241,5875226,0.0000,0,16
2021-12-18,Brazil,203070494,Ceará,8794957,0.8238,1275,7245492,0.6686,5453,5880679,0.0000,0,16
2021-12-19,Brazil,203070494,Ceará,8794957,0.8239,284,7245776,0.6688,1059,5881738,0.0000,0,16
2021-12-20,Brazil,203070494,Ceará,8794957,0.8244,4782,7250558,0.6704,14775,5896513,0.0000,0,16
2021-12-21,Brazil,203070494,Ceará,8794957,0.8251,6085,7256643,0.6722,15750,5912263,0.0000,1,17
2021-12-22,Brazil,203070494,Ceará,8794957,0.8257,5568,7262211,0.6742,17575,5929838,0.0000,0,17
2021-12-23,Brazil,203070494,Ceará,8794957,0.8261,3195,7265406,0.6754,10218,5940056,0.0000,0,17
2021-12-24,Brazil,203070494,Ceará,8794957,0.8261,86,7265492,0.6754,242,5940298,0.0000,0,17
2021-12-25,Brazil,203070494,Ceará,8794957,0.8261,16,7265508,0.6754,63,5940361,0.0000,0,17
2021-12-26,Brazil,203070494,Ceará,8794957,0.8261,17,7265525,0.6754,45,5940406,0.0000,0,17
2021-12-27,Brazil,203070494,Ceará,8794957,0.8264,2592,7268117,0.6762,7038,5947444,0.0000,0,17
2021-12-28,Brazil,203070494,Ceará,8794957,0.8268,3409,7271526,0.6773,9000,5956444,0.0000,0,17
2021-12-29,Brazil,203070494,Ceará,8794957,0.8271,2915,7274441,0.6782,8411,5964855,0.0000,1,18
2021-12-30,Brazil,203070494,Ceará,8794957,0.8273,1686,7276127,0.6787,4064,5968919,0.0000,0,18
2021-12-31,Brazil,203070494,Ceará,8794957,0.8273,41,7276168,0.6787,73,5968992,0.0000,0,18
2021-01-04,Brazil,203070494,Distrito Federal,2817381,0.0000,0,0,0.0000,2,2,0.0000,0,0
2021-01-05,Brazil,203070494,Distrito Federal,2817381,0.0000,0,0,0.0000,3,5,0.0000,0,0
2021-01-10,Brazil,203070494,Distrito Federal,2817381,0.0000,1,1,0.0000,0,5,0.0000,0,0
2021-01-11,Brazil,203070494,Distrito Federal,2817381,0.0000,1,2,0.0000,0,5,0.0000,0,0
2021-01-17,Brazil,203070494,Distrito Federal,2817381,0.0000,7,9,0.0000,1,6,0.0000,0,0
2021-01-18,Brazil,203070494,Distrito Federal,2817381,0.0000,5,14,0.0000,4,10,0.0000,0,0
2021-01-19,Brazil,203070494,Distrito Federal,2817381,0.0010,2729,2743,0.0000,3,13,0.0000,0,0
2021-01-20,Brazil,203070494,Distrito Federal,2817381,0.0031,5920,8663,0.0000,6,19,0.0000,0,0
2021-01-21,Brazil,203070494,Distrito Federal,2817381,0.0047,4467,13130,0.0000,8,27,0.0000,0,0
2021-01-22,Brazil,203070494,Distrito Federal,2817381,0.0059,3565,16695,0.0000,15,42,0.0000,0,0
2021-01-23,Brazil,203070494,Distrito Federal,2817381,0.0059,19,16714,0.0000,4,46,0.0000,0,0
2021-01-24,Brazil,203070494,Distrito Federal,2817381,0.0059,10,16724,0.0000,0,46,0.0000,0,0
2021-01-25,Brazil,203070494,Distrito Federal,2817381,0.0071,3189,19913,0.0000,12,58,0.0000,0,0
2021-01-26,Brazil,203070494,Distrito Federal,2817381,0.0092,6002,25915,0.0000,17,75,0.0000,0,0
2021-01-27,Brazil,203070494,Distrito Federal,2817381,0.0120,7864,33779,0.0000,9,84,0.0000,0,0
2021-01-28,Brazil,203070494,Distrito Federal,2817381,0.0143,6463,40242,0.0000,6,90,0.0000,0,0
2021-01-29,Brazil,203070494,Distrito Federal,2817381,0.0168,7208,47450,0.0000,6,96,0.0000,0,0
2021-01-30,Brazil,203070494,Distrito Federal,2817381,0.0169,119,47569,0.0000,3,99,0.0000,0,0
2021-01-31,Brazil,203070494,Distrito Federal,2817381,0.0169,32,47601,0.0000,3,102,0.0000,0,0
2021-02-01,Brazil,203070494,Distrito Federal,2817381,0.0219,14217,61818,0.0000,24,126,0.0000,0,0
2021-02-02,Brazil,203070494,Distrito Federal,2817381,0.0284,18257,80075,0.0001,43,169,0.0000,0,0
2021-02-03,Brazil,203070494,Distrito Federal,2817381,0.0313,8092,88167,0.0001,25,194,0.0000,0,0
2021-02-04,Brazil,203070494,Distrito Federal,2817381,0.0335,6135,94302,0.0001,12,206,0.0000,0,0
2021-02-05,Brazil,203070494,Distrito Federal,2817381,0.0351,4582,98884,0.0001,39,245,0.0000,0,0
2021-02-06,Brazil,203070494,Distrito Federal,2817381,0.0351,6,98890,0.0001,0,245,0.0000,0,0
2021-02-07,Brazil,203070494,Distrito Federal,2817381,0.0351,7,98897,0.0001,3,248,0.0000,0,0
2021-02-08,Brazil,203070494,Distrito Federal,2817381,0.0358,2095,100992,0.0003,460,708,0.0000,0,0
2021-02-09,Brazil,203070494,Distrito Federal,2817381,0.0373,3981,104973,0.0009,1694,2402,0.0000,0,0
2021-02-10,Brazil,203070494,Distrito Federal,2817381,0.0382,2783,107756,0.0021,3475,5877,0.0000,0,0
2021-02-11,Brazil,203070494,Distrito Federal,2817381,0.0390,2041,109797,0.0033,3355,9232,0.0000,0,0
2021-02-12,Brazil,203070494,Distrito Federal,2817381,0.0394,1179,110976,0.0044,3180,12412,0.0000,0,0
2021-02-13,Brazil,203070494,Distrito Federal,2817381,0.0394,14,110990,0.0044,63,12475,0.0000,0,0
2021-02-14,Brazil,203070494,Distrito Federal,2817381,0.0394,5,110995,0.0044,34,12509,0.0000,0,0
2021-02-15,Brazil,203070494,Distrito Federal,2817381,0.0394,1,110996,0.0044,4,12513,0.0000,0,0
2021-02-16,Brazil,203070494,Distrito Federal,2817381,0.0394,11,111007,0.0044,12,12525,0.0000,0,0
2021-02-17,Brazil,203070494,Distrito Federal,2817381,0.0396,495,111502,0.0049,1222,13747,0.0000,0,0
2021-02-18,Brazil,203070494,Distrito Federal,2817381,0.0401,1341,112843,0.0066,4756,18503,0.0000,0,0
2021-02-19,Brazil,203070494,Distrito Federal,2817381,0.0404,966,113809,0.0082,4552,23055,0.0000,0,0
2021-02-20,Brazil,203070494,Distrito Federal,2817381,0.0404,15,113824,0.0082,18,23073,0.0000,0,0
2021-02-21,Brazil,203070494,Distrito Federal,2817381,0.0404,19,113843,0.0082,13,23086,0.0000,0,0
2021-02-22,Brazil,203070494,Distrito Federal,2817381,0.0407,942,114785,0.0097,4219,27305,0.0000,0,0
2021-02-23,Brazil,203070494,Distrito Federal,2817381,0.0409,353,115138,0.0114,4792,32097,0.0000,0,0
2021-02-24,Brazil,203070494,Distrito Federal,2817381,0.0410,263,115401,0.0132,5150,37247,0.0000,0,0
2021-02-25,Brazil,203070494,Distrito Federal,2817381,0.0413,860,116261,0.0147,4241,41488,0.0000,0,0
2021-02-26,Brazil,203070494,Distrito Federal,2817381,0.0451,10812,127073,0.0161,3777,45265,0.0000,0,0
2021-02-27,Brazil,203070494,Distrito Federal,2817381,0.0451,13,127086,0.0161,7,45272,0.0000,0,0
2021-02-28,Brazil,203070494,Distrito Federal,2817381,0.0451,13,127099,0.0161,6,45278,0.0000,0,0
2021-03-01,Brazil,203070494,Distrito Federal,2817381,0.0478,7519,134618,0.0181,5694,50972,0.0000,0,0
2021-03-02,Brazil,203070494,Distrito Federal,2817381,0.0492,4061,138679,0.0192,3110,54082,0.0000,0,0
2021-03-03,Brazil,203070494,Distrito Federal,2817381,0.0498,1763,140442,0.0198,1797,55879,0.0000,0,0
2021-03-04,Brazil,203070494,Distrito Federal,2817381,0.0519,5768,146210,0.0204,1722,57601,0.0000,0,0
2021-03-05,Brazil,203070494,Distrito Federal,2817381,0.0536,4938,151148,0.0211,1937,59538,0.0000,0,0
2021-03-06,Brazil,203070494,Distrito Federal,2817381,0.0538,530,151678,0.0211,48,59586,0.0000,0,0
2021-03-07,Brazil,203070494,Distrito Federal,2817381,0.0538,4,151682,0.0212,2,59588,0.0000,0,0
2021-03-08,Brazil,203070494,Distrito Federal,2817381,0.0544,1456,153138,0.0216,1261,60849,0.0000,0,0
2021-03-09,Brazil,203070494,Distrito Federal,2817381,0.0548,1248,154386,0.0224,2207,63056,0.0000,0,0
2021-03-10,Brazil,203070494,Distrito Federal,2817381,0.0551,902,155288,0.0230,1741,64797,0.0000,0,0
2021-03-11,Brazil,203070494,Distrito Federal,2817381,0.0577,7272,162560,0.0235,1482,66279,0.0000,0,0
2021-03-12,Brazil,203070494,Distrito Federal,2817381,0.0588,3182,165742,0.0239,971,67250,0.0000,0,0
2021-03-13,Brazil,203070494,Distrito Federal,2817381,0.0589,210,165952,0.0239,26,67276,0.0000,0,0
2021-03-14,Brazil,203070494,Distrito Federal,2817381,0.0589,12,165964,0.0239,24,67300,0.0000,0,0
2021-03-15,Brazil,203070494,Distrito Federal,2817381,0.0595,1766,167730,0.0240,400,67700,0.0000,0,0
2021-03-16,Brazil,203070494,Distrito Federal,2817381,0.0605,2730,170460,0.0242,485,68185,0.0000,0,0
2021-03-17,Brazil,203070494,Distrito Federal,2817381,0.0611,1576,172036,0.0244,673,68858,0.0000,0,0
2021-03-18,Brazil,203070494,Distrito Federal,2817381,0.0669,16436,188472,0.0247,743,69601,0.0000,0,0
2021-03-19,Brazil,203070494,Distrito Federal,2817381,0.0689,5683,194155,0.0250,785,70386,0.0000,0,0
2021-03-20,Brazil,203070494,Distrito Federal,2817381,0.0691,645,194800,0.0250,59,70445,0.0000,0,0
2021-03-21,Brazil,203070494,Distrito Federal,2817381,0.0693,445,195245,0.0250,63,70508,0.0000,0,0
2021-03-22,Brazil,203070494,Distrito Federal,2817381,0.0766,20668,215913,0.0253,689,71197,0.0000,0,0
2021-03-23,Brazil,203070494,Distrito Federal,2817381,0.0822,15637,231550,0.0255,672,71869,0.0000,0,0
2021-03-24,Brazil,203070494,Distrito Federal,2817381,0.0840,5206,236756,0.0257,608,72477,0.0000,0,0
2021-03-25,Brazil,203070494,Distrito Federal,2817381,0.0849,2479,239235,0.0260,839,73316,0.0000,0,0
2021-03-26,Brazil,203070494,Distrito Federal,2817381,0.0941,25923,265158,0.0263,815,74131,0.0000,0,0
2021-03-27,Brazil,203070494,Distrito Federal,2817381,0.0976,9859,275017,0.0263,80,74211,0.0000,0,0
2021-03-28,Brazil,203070494,Distrito Federal,2817381,0.1002,7353,282370,0.0264,103,74314,0.0000,0,0
2021-03-29,Brazil,203070494,Distrito Federal,2817381,0.1037,9680,292050,0.0268,1303,75617,0.0000,0,0
2021-03-30,Brazil,203070494,Distrito Federal,2817381,0.1065,8071,300121,0.0274,1598,77215,0.0000,0,0
2021-03-31,Brazil,203070494,Distrito Federal,2817381,0.1082,4832,304953,0.0280,1670,78885,0.0000,0,0
2021-04-01,Brazil,203070494,Distrito Federal,2817381,0.1092,2834,307787,0.0295,4344,83229,0.0000,0,0
2021-04-02,Brazil,203070494,Distrito Federal,2817381,0.1095,772,308559,0.0295,10,83239,0.0000,0,0
2021-04-03,Brazil,203070494,Distrito Federal,2817381,0.1107,3224,311783,0.0296,86,83325,0.0000,0,0
2021-04-04,Brazil,203070494,Distrito Federal,2817381,0.1107,54,311837,0.0297,319,83644,0.0000,0,0
2021-04-05,Brazil,203070494,Distrito Federal,2817381,0.1127,5672,317509,0.0305,2364,86008,0.0000,0,0
2021-04-06,Brazil,203070494,Distrito Federal,2817381,0.1132,1406,318915,0.0316,2957,88965,0.0000,0,0
2021-04-07,Brazil,203070494,Distrito Federal,2817381,0.1135,792,319707,0.0325,2522,91487,0.0000,0,0
2021-04-08,Brazil,203070494,Distrito Federal,2817381,0.1136,330,320037,0.0346,5955,97442,0.0000,0,0
2021-04-09,Brazil,203070494,Distrito Federal,2817381,0.1166,8516,328553,0.0359,3720,101162,0.0000,0,0
2021-04-10,Brazil,203070494,Distrito Federal,2817381,0.1169,686,329239,0.0360,262,101424,0.0000,0,0
2021-04-11,Brazil,203070494,Distrito Federal,2817381,0.1169,168,329407,0.0361,290,101714,0.0000,0,0
2021-04-12,Brazil,203070494,Distrito Federal,2817381,0.1180,2915,332322,0.0375,4051,105765,0.0000,0,0
2021-04-13,Brazil,203070494,Distrito Federal,2817381,0.1192,3434,335756,0.0393,4968,110733,0.0000,0,0
2021-04-14,Brazil,203070494,Distrito Federal,2817381,0.1201,2742,338498,0.0417,6760,117493,0.0000,0,0
2021-04-15,Brazil,203070494,Distrito Federal,2817381,0.1209,2082,340580,0.0461,12441,129934,0.0000,0,0
2021-04-16,Brazil,203070494,Distrito Federal,2817381,0.1255,13134,353714,0.0499,10628,140562,0.0000,0,0
2021-04-17,Brazil,203070494,Distrito Federal,2817381,0.1285,8379,362093,0.0508,2443,143005,0.0000,0,0
2021-04-18,Brazil,203070494,Distrito Federal,2817381,0.1294,2517,364610,0.0514,1701,144706,0.0000,0,0
2021-04-19,Brazil,203070494,Distrito Federal,2817381,0.1316,6095,370705,0.0574,16975,161681,0.0000,0,0
2021-04-20,Brazil,203070494,Distrito Federal,2817381,0.1329,3710,374415,0.0635,17109,178790,0.0000,0,0
2021-04-21,Brazil,203070494,Distrito Federal,2817381,0.1331,649,375064,0.0643,2305,181095,0.0000,0,0
2021-04-22,Brazil,203070494,Distrito Federal,2817381,0.1344,3647,378711,0.0687,12551,193646,0.0000,0,0
2021-04-23,Brazil,203070494,Distrito Federal,2817381,0.1397,14891,393602,0.0751,17845,211491,0.0000,0,0
2021-04-24,Brazil,203070494,Distrito Federal,2817381,0.1433,10078,403680,0.0763,3453,214944,0.0000,0,0
2021-04-25,Brazil,203070494,Distrito Federal,2817381,0.1442,2613,406293,0.0770,1945,216889,0.0000,0,0
2021-04-26,Brazil,203070494,Distrito Federal,2817381,0.1478,10140,416433,0.0811,11552,228441,0.0000,0,0
2021-04-27,Brazil,203070494,Distrito Federal,2817381,0.1492,3907,420340,0.0847,10258,238699,0.0000,0,0
2021-04-28,Brazil,203070494,Distrito Federal,2817381,0.1500,2345,422685,0.0869,6218,244917,0.0000,0,0
2021-04-29,Brazil,203070494,Distrito Federal,2817381,0.1506,1570,424255,0.0884,4159,249076,0.0000,0,0
2021-04-30,Brazil,203070494,Distrito Federal,2817381,0.1592,24339,448594,0.0899,4258,253334,0.0000,0,0
2021-05-01,Brazil,203070494,Distrito Federal,2817381,0.1615,6476,455070,0.0902,841,254175,0.0000,0,0
2021-05-02,Brazil,203070494,Distrito Federal,2817381,0.1621,1723,456793,0.0905,936,255111,0.0000,0,0
2021-05-03,Brazil,203070494,Distrito Federal,2817381,0.1647,7224,464017,0.0942,10197,265308,0.0000,0,0
2021-05-04,Brazil,203070494,Distrito Federal,2817381,0.1676,8265,472282,0.0970,7892,273200,0.0000,0,0
2021-05-05,Brazil,203070494,Distrito Federal,2817381,0.1705,8132,480414,0.0986,4640,277840,0.0000,0,0
2021-05-06,Brazil,203070494,Distrito Federal,2817381,0.1749,12391,492805,0.0994,2338,280178,0.0000,0,0
2021-05-07,Brazil,203070494,Distrito Federal,2817381,0.1787,10654,503459,0.0999,1375,281553,0.0000,0,0
2021-05-08,Brazil,203070494,Distrito Federal,2817381,0.1810,6506,509965,0.1000,281,281834,0.0000,0,0
2021-05-09,Brazil,203070494,Distrito Federal,2817381,0.1818,2195,512160,0.1001,96,281930,0.0000,0,0
2021-05-10,Brazil,203070494,Distrito Federal,2817381,0.1850,9026,521186,0.1010,2565,284495,0.0000,0,0
2021-05-11,Brazil,203070494,Distrito Federal,2817381,0.1875,7032,528218,0.1018,2374,286869,0.0000,0,0
2021-05-12,Brazil,203070494,Distrito Federal,2817381,0.1887,3519,531737,0.1025,2038,288907,0.0000,0,0
2021-05-13,Brazil,203070494,Distrito Federal,2817381,0.1921,9534,541271,0.1032,1731,290638,0.0000,0,0
2021-05-14,Brazil,203070494,Distrito Federal,2817381,0.1954,9381,550652,0.1039,2140,292778,0.0000,0,0
2021-05-15,Brazil,203070494,Distrito Federal,2817381,0.1966,3299,553951,0.1042,873,293651,0.0000,0,0
2021-05-16,Brazil,203070494,Distrito Federal,2817381,0.1971,1246,555197,0.1045,692,294343,0.0000,0,0
2021-05-17,Brazil,203070494,Distrito Federal,2817381,0.1987,4658,559855,0.1053,2311,296654,0.0000,0,0
2021-05-18,Brazil,203070494,Distrito Federal,2817381,0.2009,6076,565931,0.1058,1369,298023,0.0000,0,0
2021-05-19,Brazil,203070494,Distrito Federal,2817381,0.2035,7546,573477,0.1061,985,299008,0.0000,0,0
2021-05-20,Brazil,203070494,Distrito Federal,2817381,0.2063,7847,581324,0.1069,2068,301076,0.0000,0,0
2021-05-21,Brazil,203070494,Distrito Federal,2817381,0.2086,6382,587706,0.1081,3508,304584,0.0000,0,0
2021-05-22,Brazil,203070494,Distrito Federal,2817381,0.2090,1176,588882,0.1082,148,304732,0.0000,0,0
2021-05-23,Brazil,203070494,Distrito Federal,2817381,0.2094,1045,589927,0.1082,113,304845,0.0000,0,0
2021-05-24,Brazil,203070494,Distrito Federal,2817381,0.2117,6514,596441,0.1094,3346,308191,0.0000,0,0
2021-05-25,Brazil,203070494,Distrito Federal,2817381,0.2134,4725,601166,0.1101,2138,310329,0.0000,0,0
2021-05-26,Brazil,203070494,Distrito Federal,2817381,0.2156,6301,607467,0.1115,3692,314021,0.0000,0,0
2021-05-27,Brazil,203070494,Distrito Federal,2817381,0.2177,5844,613311,0.1128,3783,317804,0.0000,0,0
2021-05-28,Brazil,203070494,Distrito Federal,2817381,0.2201,6707,620018,0.1137,2507,320311,0.0000,0,0
2021-05-29,Brazil,203070494,Distrito Federal,2817381,0.2212,3107,623125,0.1137,160,320471,0.0000,0,0
2021-05-30,Brazil,203070494,Distrito Federal,2817381,0.2222,2826,625951,0.1138,116,320587,0.0000,0,0
2021-05-31,Brazil,203070494,Distrito Federal,2817381,0.2270,13711,639662,0.1144,1696,322283,0.0000,0,0
2021-06-01,Brazil,203070494,Distrito Federal,2817381,0.2316,12740,652402,0.1153,2439,324722,0.0000,0,0
2021-06-02,Brazil,203070494,Distrito Federal,2817381,0.2362,13177,665579,0.1158,1474,326196,0.0000,0,0
2021-06-03,Brazil,203070494,Distrito Federal,2817381,0.2366,1008,666587,0.1158,51,326247,0.0000,0,0
2021-06-04,Brazil,203070494,Distrito Federal,2817381,0.2407,11580,678167,0.1162,1122,327369,0.0000,0,0
2021-06-05,Brazil,203070494,Distrito Federal,2817381,0.2420,3737,681904,0.1162,63,327432,0.0000,0,0
2021-06-06,Brazil,203070494,Distrito Federal,2817381,0.2432,3391,685295,0.1162,32,327464,0.0000,0,0
2021-06-07,Brazil,203070494,Distrito Federal,2817381,0.2482,14098,699393,0.1164,482,327946,0.0000,0,0
2021-06-08,Brazil,203070494,Distrito Federal,2817381,0.2512,8253,707646,0.1165,331,328277,0.0000,0,0
2021-06-09,Brazil,203070494,Distrito Federal,2817381,0.2564,14764,722410,0.1166,319,328596,0.0000,0,0
2021-06-10,Brazil,203070494,Distrito Federal,2817381,0.2612,13509,735919,0.1167,225,328821,0.0000,0,0
2021-06-11,Brazil,203070494,Distrito Federal,2817381,0.2648,10209,746128,0.1168,252,329073,0.0000,0,0
2021-06-12,Brazil,203070494,Distrito Federal,2817381,0.2671,6303,752431,0.1168,31,329104,0.0000,0,0
2021-06-13,Brazil,203070494,Distrito Federal,2817381,0.2693,6251,758682,0.1168,18,329122,0.0000,0,0
2021-06-14,Brazil,203070494,Distrito Federal,2817381,0.2776,23532,782214,0.1169,229,329351,0.0000,0,0
2021-06-15,Brazil,203070494,Distrito Federal,2817381,0.2860,23430,805644,0.1170,182,329533,0.0000,0,0
2021-06-16,Brazil,203070494,Distrito Federal,2817381,0.2939,22455,828099,0.1171,272,329805,0.0000,0,0
2021-06-17,Brazil,203070494,Distrito Federal,2817381,0.3040,28485,856584,0.1173,535,330340,0.0000,0,0
2021-06-18,Brazil,203070494,Distrito Federal,2817381,0.3138,27485,884069,0.1177,1208,331548,0.0000,0,0
2021-06-19,Brazil,203070494,Distrito Federal,2817381,0.3155,4901,888970,0.1178,201,331749,0.0000,0,0
2021-06-20,Brazil,203070494,Distrito Federal,2817381,0.3173,4846,893816,0.1178,97,331846,0.0000,0,0
2021-06-21,Brazil,203070494,Distrito Federal,2817381,0.3209,10206,904022,0.1183,1358,333204,0.0000,0,0
2021-06-22,Brazil,203070494,Distrito Federal,2817381,0.3245,10316,914338,0.1185,785,333989,0.0000,0,0
2021-06-23,Brazil,203070494,Distrito Federal,2817381,0.3271,7246,921584,0.1189,898,334887,0.0000,0,0
2021-06-24,Brazil,203070494,Distrito Federal,2817381,0.3305,9664,931248,0.1191,723,335610,0.0000,0,0
2021-06-25,Brazil,203070494,Distrito Federal,2817381,0.3338,9061,940309,0.1194,695,336305,0.0000,0,0
2021-06-26,Brazil,203070494,Distrito Federal,2817381,0.3353,4436,944745,0.1194,87,336392,0.0000,0,0
2021-06-27,Brazil,203070494,Distrito Federal,2817381,0.3370,4655,949400,0.1194,53,336445,0.0000,0,0
2021-06-28,Brazil,203070494,Distrito Federal,2817381,0.3441,20199,969599,0.1202,2344,338789,0.0000,0,0
2021-06-29,Brazil,203070494,Distrito Federal,2817381,0.3506,18068,987667,0.1208,1424,340213,0.0000,0,0
2021-06-30,Brazil,203070494,Distrito Federal,2817381,0.3554,13558,1001225,0.1212,1277,341490,0.0000,0,0
2021-07-01,Brazil,203070494,Distrito Federal,2817381,0.3585,8765,1009990,0.1217,1491,342981,0.0000,0,0
2021-07-02,Brazil,203070494,Distrito Federal,2817381,0.3636,14358,1024348,0.1230,3657,346638,0.0000,0,0
2021-07-03,Brazil,203070494,Distrito Federal,2817381,0.3649,3744,1028092,0.1231,290,346928,0.0000,0,0
2021-07-04,Brazil,203070494,Distrito Federal,2817381,0.3666,4745,1032837,0.1232,126,347054,0.0000,0,0
2021-07-05,Brazil,203070494,Distrito Federal,2817381,0.3717,14498,1047335,0.1238,1856,348910,0.0000,0,0
2021-07-06,Brazil,203070494,Distrito Federal,2817381,0.3761,12202,1059537,0.1243,1421,350331,0.0000,0,0
2021-07-07,Brazil,203070494,Distrito Federal,2817381,0.3829,19171,1078708,0.1254,2909,353240,0.0000,1,1
2021-07-08,Brazil,203070494,Distrito Federal,2817381,0.3900,20059,1098767,0.1269,4171,357411,0.0000,0,1
2021-07-09,Brazil,203070494,Distrito Federal,2817381,0.3928,7767,1106534,0.1294,7230,364641,0.0000,0,1
2021-07-10,Brazil,203070494,Distrito Federal,2817381,0.3936,2404,1108938,0.1296,535,365176,0.0000,0,1
2021-07-11,Brazil,203070494,Distrito Federal,2817381,0.3944,2363,1111301,0.1297,296,365472,0.0000,0,1
2021-07-12,Brazil,203070494,Distrito Federal,2817381,0.3972,7659,1118960,0.1319,6054,371526,0.0000,0,1
2021-07-13,Brazil,203070494,Distrito Federal,2817381,0.4011,11068,1130028,0.1334,4270,375796,0.0000,0,1
2021-07-14,Brazil,203070494,Distrito Federal,2817381,0.4053,11756,1141784,0.1344,2760,378556,0.0000,0,1
2021-07-15,Brazil,203070494,Distrito Federal,2817381,0.4074,5999,1147783,0.1364,5642,384198,0.0000,0,1
2021-07-16,Brazil,203070494,Distrito Federal,2817381,0.4082,2364,1150147,0.1406,11803,396001,0.0000,0,1
2021-07-17,Brazil,203070494,Distrito Federal,2817381,0.4089,1924,1152071,0.1413,2136,398137,0.0000,0,1
2021-07-18,Brazil,203070494,Distrito Federal,2817381,0.4097,2273,1154344,0.1421,2222,400359,0.0000,0,1
2021-07-19,Brazil,203070494,Distrito Federal,2817381,0.4127,8298,1162642,0.1468,13216,413575,0.0000,0,1
2021-07-20,Brazil,203070494,Distrito Federal,2817381,0.4165,10691,1173333,0.1492,6731,420306,0.0000,0,1
2021-07-21,Brazil,203070494,Distrito Federal,2817381,0.4214,13899,1187232,0.1514,6244,426550,0.0000,0,1
2021-07-22,Brazil,203070494,Distrito Federal,2817381,0.4266,14539,1201771,0.1545,8659,435209,0.0000,0,1
2021-07-23,Brazil,203070494,Distrito Federal,2817381,0.4495,64741,1266512,0.1598,15111,450320,0.0000,0,1
2021-07-24,Brazil,203070494,Distrito Federal,2817381,0.4622,35690,1302202,0.1615,4695,455015,0.0000,0,1
2021-07-25,Brazil,203070494,Distrito Federal,2817381,0.4676,15179,1317381,0.1625,2747,457762,0.0000,0,1
2021-07-26,Brazil,203070494,Distrito Federal,2817381,0.4687,3138,1320519,0.1666,11692,469454,0.0000,0,1
2021-07-27,Brazil,203070494,Distrito Federal,2817381,0.4694,2100,1322619,0.1727,17221,486675,0.0000,0,1
2021-07-28,Brazil,203070494,Distrito Federal,2817381,0.4700,1675,1324294,0.1782,15453,502128,0.0000,0,1
2021-07-29,Brazil,203070494,Distrito Federal,2817381,0.4831,36655,1360949,0.1831,13808,515936,0.0000,0,1
2021-07-30,Brazil,203070494,Distrito Federal,2817381,0.4864,9366,1370315,0.1885,15267,531203,0.0000,0,1
2021-07-31,Brazil,203070494,Distrito Federal,2817381,0.4865,412,1370727,0.1916,8606,539809,0.0000,0,1
2021-08-01,Brazil,203070494,Distrito Federal,2817381,0.4866,342,1371069,0.1930,4007,543816,0.0000,0,1
2021-08-02,Brazil,203070494,Distrito Federal,2817381,0.4872,1473,1372542,0.1983,14776,558592,0.0000,0,1
2021-08-03,Brazil,203070494,Distrito Federal,2817381,0.5156,79962,1452504,0.2013,8588,567180,0.0000,0,1
2021-08-04,Brazil,203070494,Distrito Federal,2817381,0.5320,46275,1498779,0.2040,7684,574864,0.0000,0,1
2021-08-05,Brazil,203070494,Distrito Federal,2817381,0.5409,25199,1523978,0.2069,8082,582946,0.0000,0,1
2021-08-06,Brazil,203070494,Distrito Federal,2817381,0.5472,17606,1541584,0.2095,7415,590361,0.0000,0,1
2021-08-07,Brazil,203070494,Distrito Federal,2817381,0.5487,4240,1545824,0.2103,2094,592455,0.0000,0,1
2021-08-08,Brazil,203070494,Distrito Federal,2817381,0.5492,1411,1547235,0.2106,1025,593480,0.0000,0,1
2021-08-09,Brazil,203070494,Distrito Federal,2817381,0.5540,13460,1560695,0.2140,9475,602955,0.0000,0,1
2021-08-10,Brazil,203070494,Distrito Federal,2817381,0.5821,79402,1640097,0.2169,8228,611183,0.0000,0,1
2021-08-11,Brazil,203070494,Distrito Federal,2817381,0.5980,44712,1684809,0.2202,9304,620487,0.0000,0,1
2021-08-12,Brazil,203070494,Distrito Federal,2817381,0.6319,95365,1780174,0.2230,7885,628372,0.0000,0,1
2021-08-13,Brazil,203070494,Distrito Federal,2817381,0.6511,54362,1834536,0.2258,7931,636303,0.0000,0,1
2021-08-14,Brazil,203070494,Distrito Federal,2817381,0.6556,12555,1847091,0.2267,2389,638692,0.0000,0,1
2021-08-15,Brazil,203070494,Distrito Federal,2817381,0.6569,3601,1850692,0.2272,1336,640028,0.0000,0,1
2021-08-16,Brazil,203070494,Distrito Federal,2817381,0.6681,31484,1882176,0.2299,7677,647705,0.0000,0,1
2021-08-17,Brazil,203070494,Distrito Federal,2817381,0.6875,54798,1936974,0.2323,6705,654410,0.0000,0,1
2021-08-18,Brazil,203070494,Distrito Federal,2817381,0.6988,31932,1968906,0.2348,7086,661496,0.0000,0,1
2021-08-19,Brazil,203070494,Distrito Federal,2817381,0.7050,17381,1986287,0.2402,15293,676789,0.0000,0,1
2021-08-20,Brazil,203070494,Distrito Federal,2817381,0.7089,11013,1997300,0.2455,14776,691565,0.0000,0,1
2021-08-21,Brazil,203070494,Distrito Federal,2817381,0.7090,253,1997553,0.2468,3781,695346,0.0000,0,1
2021-08-22,Brazil,203070494,Distrito Federal,2817381,0.7091,131,1997684,0.2476,2366,697712,0.0000,0,1
2021-08-23,Brazil,203070494,Distrito Federal,2817381,0.7108,4887,2002571,0.2528,14443,712155,0.0000,0,1
2021-08-24,Brazil,203070494,Distrito Federal,2817381,0.7209,28424,2030995,0.2571,12147,724302,0.0000,0,1
2021-08-25,Brazil,203070494,Distrito Federal,2817381,0.7257,13684,2044679,0.2607,10105,734407,0.0000,0,1
2021-08-26,Brazil,203070494,Distrito Federal,2817381,0.7285,7703,2052382,0.2662,15582,749989,0.0000,0,1
2021-08-27,Brazil,203070494,Distrito Federal,2817381,0.7310,7224,2059606,0.2706,12316,762305,0.0000,0,1
2021-08-28,Brazil,203070494,Distrito Federal,2817381,0.7315,1230,2060836,0.2714,2434,764739,0.0000,0,1
2021-08-29,Brazil,203070494,Distrito Federal,2817381,0.7317,666,2061502,0.2718,1097,765836,0.0000,0,1
2021-08-30,Brazil,203070494,Distrito Federal,2817381,0.7344,7566,2069068,0.2758,11225,777061,0.0000,0,1
2021-08-31,Brazil,203070494,Distrito Federal,2817381,0.7366,6086,2075154,0.2830,20315,797376,0.0000,0,1
2021-09-01,Brazil,203070494,Distrito Federal,2817381,0.7381,4435,2079589,0.2893,17782,815158,0.0000,0,1
2021-09-02,Brazil,203070494,Distrito Federal,2817381,0.7396,4007,2083596,0.2946,14919,830077,0.0000,0,1
2021-09-03,Brazil,203070494,Distrito Federal,2817381,0.7409,3897,2087493,0.2991,12663,842740,0.0000,0,1
2021-09-04,Brazil,203070494,Distrito Federal,2817381,0.7411,483,2087976,0.2999,2310,845050,0.0000,0,1
2021-09-05,Brazil,203070494,Distrito Federal,2817381,0.7412,222,2088198,0.3005,1622,846672,0.0000,0,1
2021-09-06,Brazil,203070494,Distrito Federal,2817381,0.7421,2537,2090735,0.3050,12523,859195,0.0000,0,1
2021-09-07,Brazil,203070494,Distrito Federal,2817381,0.7422,383,2091118,0.3053,963,860158,0.0000,0,1
2021-09-08,Brazil,203070494,Distrito Federal,2817381,0.7427,1474,2092592,0.3191,38977,899135,0.0000,0,1
2021-09-09,Brazil,203070494,Distrito Federal,2817381,0.7432,1272,2093864,0.3327,38158,937293,0.0000,0,1
2021-09-10,Brazil,203070494,Distrito Federal,2817381,0.7484,14535,2108399,0.3421,26429,963722,0.0000,0,1
2021-09-11,Brazil,203070494,Distrito Federal,2817381,0.7491,1996,2110395,0.3442,6016,969738,0.0000,0,1
2021-09-12,Brazil,203070494,Distrito Federal,2817381,0.7493,798,2111193,0.3451,2540,972278,0.0000,0,1
2021-09-13,Brazil,203070494,Distrito Federal,2817381,0.7523,8460,2119653,0.3520,19504,991782,0.0000,0,1
2021-09-14,Brazil,203070494,Distrito Federal,2817381,0.7546,6479,2126132,0.3582,17370,1009152,0.0000,0,1
2021-09-15,Brazil,203070494,Distrito Federal,2817381,0.7644,27513,2153645,0.3624,11857,1021009,0.0000,0,1
2021-09-16,Brazil,203070494,Distrito Federal,2817381,0.7710,18659,2172304,0.3659,9864,1030873,0.0000,0,1
2021-09-17,Brazil,203070494,Distrito Federal,2817381,0.7748,10695,2182999,0.3693,9476,1040349,0.0000,0,1
2021-09-18,Brazil,203070494,Distrito Federal,2817381,0.7756,2105,2185104,0.3699,1937,1042286,0.0000,0,1
2021-09-19,Brazil,203070494,Distrito Federal,2817381,0.7758,552,2185656,0.3702,793,1043079,0.0000,0,1
2021-09-20,Brazil,203070494,Distrito Federal,2817381,0.7783,7199,2192855,0.3734,8861,1051940,0.0000,0,1
2021-09-21,Brazil,203070494,Distrito Federal,2817381,0.7839,15676,2208531,0.3771,10375,1062315,0.0000,0,1
2021-09-22,Brazil,203070494,Distrito Federal,2817381,0.7873,9530,2218061,0.3802,8830,1071145,0.0000,0,1
2021-09-23,Brazil,203070494,Distrito Federal,2817381,0.7895,6157,2224218,0.3904,28825,1099970,0.0000,0,1
2021-09-24,Brazil,203070494,Distrito Federal,2817381,0.7914,5408,2229626,0.3979,21137,1121107,0.0000,0,1
2021-09-25,Brazil,203070494,Distrito Federal,2817381,0.7917,870,2230496,0.3999,5587,1126694,0.0000,0,1
2021-09-26,Brazil,203070494,Distrito Federal,2817381,0.7918,358,2230854,0.4008,2424,1129118,0.0000,0,1
2021-09-27,Brazil,203070494,Distrito Federal,2817381,0.7932,3905,2234759,0.4087,22474,1151592,0.0000,0,1
2021-09-28,Brazil,203070494,Distrito Federal,2817381,0.7979,13343,2248102,0.4162,21114,1172706,0.0000,0,1
2021-09-29,Brazil,203070494,Distrito Federal,2817381,0.8011,9011,2257113,0.4233,19776,1192482,0.0000,0,1
2021-09-30,Brazil,203070494,Distrito Federal,2817381,0.8034,6346,2263459,0.4288,15735,1208217,0.0000,0,1
2021-10-01,Brazil,203070494,Distrito Federal,2817381,0.8050,4614,2268073,0.4326,10718,1218935,0.0000,1,2
2021-10-02,Brazil,203070494,Distrito Federal,2817381,0.8052,447,2268520,0.4335,2434,1221369,0.0000,0,2
2021-10-03,Brazil,203070494,Distrito Federal,2817381,0.8052,118,2268638,0.4339,1143,1222512,0.0000,0,2
2021-10-04,Brazil,203070494,Distrito Federal,2817381,0.8065,3441,2272079,0.4377,10518,1233030,0.0000,0,2
2021-10-05,Brazil,203070494,Distrito Federal,2817381,0.8074,2814,2274893,0.4428,14436,1247466,0.0000,0,2
2021-10-06,Brazil,203070494,Distrito Federal,2817381,0.8084,2569,2277462,0.4493,18257,1265723,0.0000,0,2
2021-10-07,Brazil,203070494,Distrito Federal,2817381,0.8090,1661,2279123,0.4545,14687,1280410,0.0000,0,2
2021-10-08,Brazil,203070494,Distrito Federal,2817381,0.8093,1012,2280135,0.4660,32503,1312913,0.0000,0,2
2021-10-09,Brazil,203070494,Distrito Federal,2817381,0.8094,136,2280271,0.4683,6339,1319252,0.0000,0,2
2021-10-10,Brazil,203070494,Distrito Federal,2817381,0.8094,51,2280322,0.4694,3250,1322502,0.0000,0,2
2021-10-11,Brazil,203070494,Distrito Federal,2817381,0.8098,1186,2281508,0.4788,26478,1348980,0.0000,0,2
2021-10-12,Brazil,203070494,Distrito Federal,2817381,0.8098,39,2281547,0.4795,1971,1350951,0.0000,0,2
2021-10-13,Brazil,203070494,Distrito Federal,2817381,0.8102,980,2282527,0.4873,21862,1372813,0.0000,2,4
2021-10-14,Brazil,203070494,Distrito Federal,2817381,0.8106,1217,2283744,0.4958,24168,1396981,0.0000,0,4
2021-10-15,Brazil,203070494,Distrito Federal,2817381,0.8109,923,2284667,0.5044,24211,1421192,0.0000,0,4
2021-10-16,Brazil,203070494,Distrito Federal,2817381,0.8109,85,2284752,0.5059,4201,1425393,0.0000,0,4
2021-10-17,Brazil,203070494,Distrito Federal,2817381,0.8110,48,2284800,0.5067,2239,1427632,0.0000,0,4
2021-10-18,Brazil,203070494,Distrito Federal,2817381,0.8114,1153,2285953,0.5146,22062,1449694,0.0000,0,4
2021-10-19,Brazil,203070494,Distrito Federal,2817381,0.8118,1116,2287069,0.5216,19840,1469534,0.0000,0,4
2021-10-20,Brazil,203070494,Distrito Federal,2817381,0.8128,2944,2290013,0.5276,16858,1486392,0.0000,0,4
2021-10-21,Brazil,203070494,Distrito Federal,2817381,0.8137,2576,2292589,0.5322,13143,1499535,0.0000,0,4
2021-10-22,Brazil,203070494,Distrito Federal,2817381,0.8146,2514,2295103,0.5388,18407,1517942,0.0000,0,4
2021-10-23,Brazil,203070494,Distrito Federal,2817381,0.8148,376,2295479,0.5399,3255,1521197,0.0000,0,4
2021-10-24,Brazil,203070494,Distrito Federal,2817381,0.8149,271,2295750,0.5407,2163,1523360,0.0000,0,4
2021-10-25,Brazil,203070494,Distrito Federal,2817381,0.8157,2444,2298194,0.5474,18976,1542336,0.0000,0,4
2021-10-26,Brazil,203070494,Distrito Federal,2817381,0.8166,2395,2300589,0.5550,21335,1563671,0.0000,0,4
2021-10-27,Brazil,203070494,Distrito Federal,2817381,0.8174,2308,2302897,0.5619,19386,1583057,0.0000,0,4
2021-10-28,Brazil,203070494,Distrito Federal,2817381,0.8181,2027,2304924,0.5680,17204,1600261,0.0000,0,4
2021-10-29,Brazil,203070494,Distrito Federal,2817381,0.8189,2142,2307066,0.5736,15858,1616119,0.0000,0,4
2021-10-30,Brazil,203070494,Distrito Federal,2817381,0.8189,200,2307266,0.5744,2239,1618358,0.0000,0,4
2021-10-31,Brazil,203070494,Distrito Federal,2817381,0.8190,98,2307364,0.5749,1265,1619623,0.0000,0,4
2021-11-01,Brazil,203070494,Distrito Federal,2817381,0.8191,235,2307599,0.5754,1513,1621136,0.0000,0,4
2021-11-02,Brazil,203070494,Distrito Federal,2817381,0.8191,240,2307839,0.5759,1299,1622435,0.0000,0,4
2021-11-03,Brazil,203070494,Distrito Federal,2817381,0.8199,2112,2309951,0.5826,19031,1641466,0.0000,0,4
2021-11-04,Brazil,203070494,Distrito Federal,2817381,0.8204,1508,2311459,0.5892,18648,1660114,0.0000,0,4
2021-11-05,Brazil,203070494,Distrito Federal,2817381,0.8210,1656,2313115,0.5960,18937,1679051,0.0000,0,4
2021-11-06,Brazil,203070494,Distrito Federal,2817381,0.8211,191,2313306,0.5969,2764,1681815,0.0000,0,4
2021-11-07,Brazil,203070494,Distrito Federal,2817381,0.8211,81,2313387,0.5974,1357,1683172,0.0000,0,4
2021-11-08,Brazil,203070494,Distrito Federal,2817381,0.8217,1578,2314965,0.6038,17892,1701064,0.0000,0,4
2021-11-09,Brazil,203070494,Distrito Federal,2817381,0.8222,1610,2316575,0.6116,22024,1723088,0.0000,0,4
2021-11-10,Brazil,203070494,Distrito Federal,2817381,0.8227,1218,2317793,0.6181,18216,1741304,0.0000,0,4
2021-11-11,Brazil,203070494,Distrito Federal,2817381,0.8231,1116,2318909,0.6240,16771,1758075,0.0000,0,4
2021-11-12,Brazil,203070494,Distrito Federal,2817381,0.8235,1205,2320114,0.6286,13038,1771113,0.0000,0,4
2021-11-13,Brazil,203070494,Distrito Federal,2817381,0.8236,185,2320299,0.6296,2610,1773723,0.0000,0,4
2021-11-14,Brazil,203070494,Distrito Federal,2817381,0.8236,107,2320406,0.6300,1356,1775079,0.0000,0,4
2021-11-15,Brazil,203070494,Distrito Federal,2817381,0.8237,148,2320554,0.6306,1518,1776597,0.0000,0,4
2021-11-16,Brazil,203070494,Distrito Federal,2817381,0.8241,1337,2321891,0.6364,16330,1792927,0.0000,0,4
2021-11-17,Brazil,203070494,Distrito Federal,2817381,0.8246,1246,2323137,0.6419,15489,1808416,0.0000,0,4
2021-11-18,Brazil,203070494,Distrito Federal,2817381,0.8249,1041,2324178,0.6460,11582,1819998,0.0000,0,4
2021-11-19,Brazil,203070494,Distrito Federal,2817381,0.8254,1237,2325415,0.6509,13818,1833816,0.0000,0,4
2021-11-20,Brazil,203070494,Distrito Federal,2817381,0.8261,2062,2327477,0.6537,7837,1841653,0.0000,0,4
2021-11-21,Brazil,203070494,Distrito Federal,2817381,0.8261,44,2327521,0.6539,536,1842189,0.0000,0,4
2021-11-22,Brazil,203070494,Distrito Federal,2817381,0.8266,1365,2328886,0.6586,13374,1855563,0.0000,0,4
2021-11-23,Brazil,203070494,Distrito Federal,2817381,0.8270,1184,2330070,0.6636,14105,1869668,0.0000,0,4
2021-11-24,Brazil,203070494,Distrito Federal,2817381,0.8275,1210,2331280,0.6681,12618,1882286,0.0000,0,4
2021-11-25,Brazil,203070494,Distrito Federal,2817381,0.8279,1155,2332435,0.6721,11221,1893507,0.0000,0,4
2021-11-26,Brazil,203070494,Distrito Federal,2817381,0.8283,1179,2333614,0.6756,10001,1903508,0.0000,0,4
2021-11-27,Brazil,203070494,Distrito Federal,2817381,0.8285,562,2334176,0.6767,3140,1906648,0.0000,0,4
2021-11-28,Brazil,203070494,Distrito Federal,2817381,0.8285,70,2334246,0.6769,508,1907156,0.0000,0,4
2021-11-29,Brazil,203070494,Distrito Federal,2817381,0.8290,1245,2335491,0.6805,10140,1917296,0.0000,0,4
2021-11-30,Brazil,203070494,Distrito Federal,2817381,0.8290,53,2335544,0.6807,451,1917747,0.0000,0,4
2021-12-01,Brazil,203070494,Distrito Federal,2817381,0.8295,1518,2337062,0.6847,11411,1929158,0.0000,0,4
2021-12-02,Brazil,203070494,Distrito Federal,2817381,0.8300,1251,2338313,0.6883,10020,1939178,0.0000,0,4
2021-12-03,Brazil,203070494,Distrito Federal,2817381,0.8304,1142,2339455,0.6918,9778,1948956,0.0000,0,4
2021-12-04,Brazil,203070494,Distrito Federal,2817381,0.8304,150,2339605,0.6922,1191,1950147,0.0000,0,4
2021-12-05,Brazil,203070494,Distrito Federal,2817381,0.8304,48,2339653,0.6924,497,1950644,0.0000,0,4
2021-12-06,Brazil,203070494,Distrito Federal,2817381,0.8309,1270,2340923,0.6956,9249,1959893,0.0000,0,4
2021-12-07,Brazil,203070494,Distrito Federal,2817381,0.8314,1409,2342332,0.6990,9478,1969371,0.0000,0,4
2021-12-08,Brazil,203070494,Distrito Federal,2817381,0.8319,1307,2343639,0.7026,10185,1979556,0.0000,0,4
2021-12-09,Brazil,203070494,Distrito Federal,2817381,0.8323,1139,2344778,0.7064,10510,1990066,0.0000,0,4
2021-12-10,Brazil,203070494,Distrito Federal,2817381,0.8326,963,2345741,0.7092,7932,1997998,0.0000,0,4
2021-12-11,Brazil,203070494,Distrito Federal,2817381,0.8326,89,2345830,0.7095,832,1998830,0.0000,0,4
2021-12-12,Brazil,203070494,Distrito Federal,2817381,0.8327,181,2346011,0.7098,935,1999765,0.0000,0,4
2021-12-13,Brazil,203070494,Distrito Federal,2817381,0.8331,1062,2347073,0.7125,7708,2007473,0.0000,0,4
2021-12-14,Brazil,203070494,Distrito Federal,2817381,0.8334,1066,2348139,0.7156,8680,2016153,0.0000,0,4
2021-12-15,Brazil,203070494,Distrito Federal,2817381,0.8338,867,2349006,0.7178,6047,2022200,0.0000,0,4
2021-12-16,Brazil,203070494,Distrito Federal,2817381,0.8340,778,2349784,0.7199,6061,2028261,0.0000,1,5
2021-12-17,Brazil,203070494,Distrito Federal,2817381,0.8343,723,2350507,0.7218,5391,2033652,0.0000,0,5
2021-12-18,Brazil,203070494,Distrito Federal,2817381,0.8344,196,2350703,0.7221,816,2034468,0.0000,0,5
2021-12-19,Brazil,203070494,Distrito Federal,2817381,0.8344,27,2350730,0.7222,190,2034658,0.0000,0,5
2021-12-20,Brazil,203070494,Distrito Federal,2817381,0.8346,787,2351517,0.7241,5394,2040052,0.0000,0,5
2021-12-21,Brazil,203070494,Distrito Federal,2817381,0.8349,612,2352129,0.7259,4991,2045043,0.0000,0,5
2021-12-22,Brazil,203070494,Distrito Federal,2817381,0.8351,559,2352688,0.7275,4509,2049552,0.0000,0,5
2021-12-23,Brazil,203070494,Distrito Federal,2817381,0.8352,481,2353169,0.7288,3630,2053182,0.0000,0,5
2021-12-24,Brazil,203070494,Distrito Federal,2817381,0.8353,112,2353281,0.7290,741,2053923,0.0000,0,5
2021-12-25,Brazil,203070494,Distrito Federal,2817381,0.8353,1,2353282,0.7290,0,2053923,0.0000,0,5
2021-12-26,Brazil,203070494,Distrito Federal,2817381,0.8353,1,2353283,0.7290,5,2053928,0.0000,0,5
2021-12-27,Brazil,203070494,Distrito Federal,2817381,0.8355,636,2353919,0.7305,4051,2057979,0.0000,0,5
2021-12-28,Brazil,203070494,Distrito Federal,2817381,0.8358,723,2354642,0.7321,4658,2062637,0.0000,0,5
2021-12-29,Brazil,203070494,Distrito Federal,2817381,0.8360,675,2355317,0.7335,4010,2066647,0.0000,0,5
2021-12-30,Brazil,203070494,Distrito Federal,2817381,0.8362,461,2355778,0.7345,2858,2069505,0.0000,2,7
2021-12-31,Brazil,203070494,Distrito Federal,2817381,0.8362,126,2355904,0.7348,701,2070206,0.0000,0,7
2021-01-01,Brazil,203070494,Espírito Santo,3833712,0.0000,4,4,0.0000,3,3,0.0000,0,0
2021-01-02,Brazil,203070494,Espírito Santo,3833712,0.0000,0,4,0.0000,3,6,0.0000,0,0
2021-01-03,Brazil,203070494,Espírito Santo,3833712,0.0000,2,6,0.0000,3,9,0.0000,0,0
2021-01-04,Brazil,203070494,Espírito Santo,3833712,0.0000,3,9,0.0000,4,13,0.0000,0,0
2021-01-05,Brazil,203070494,Espírito Santo,3833712,0.0000,5,14,0.0000,8,21,0.0000,0,0
2021-01-06,Brazil,203070494,Espírito Santo,3833712,0.0000,3,17,0.0000,1,22,0.0000,0,0
2021-01-07,Brazil,203070494,Espírito Santo,3833712,0.0000,1,18,0.0000,5,27,0.0000,0,0
2021-01-08,Brazil,203070494,Espírito Santo,3833712,0.0000,3,21,0.0000,0,27,0.0000,0,0
2021-01-09,Brazil,203070494,Espírito Santo,3833712,0.0000,0,21,0.0000,4,31,0.0000,0,0
2021-01-10,Brazil,203070494,Espírito Santo,3833712,0.0000,1,22,0.0000,6,37,0.0000,0,0
2021-01-11,Brazil,203070494,Espírito Santo,3833712,0.0000,4,26,0.0000,6,43,0.0000,0,0
2021-01-12,Brazil,203070494,Espírito Santo,3833712,0.0000,4,30,0.0000,2,45,0.0000,0,0
2021-01-13,Brazil,203070494,Espírito Santo,3833712,0.0000,1,31,0.0000,1,46,0.0000,0,0
2021-01-14,Brazil,203070494,Espírito Santo,3833712,0.0000,1,32,0.0000,0,46,0.0000,0,0
2021-01-15,Brazil,203070494,Espírito Santo,3833712,0.0000,2,34,0.0000,2,48,0.0000,0,0
2021-01-16,Brazil,203070494,Espírito Santo,3833712,0.0000,1,35,0.0000,1,49,0.0000,0,0
2021-01-17,Brazil,203070494,Espírito Santo,3833712,0.0000,4,39,0.0000,4,53,0.0000,0,0
2021-01-18,Brazil,203070494,Espírito Santo,3833712,0.0000,68,107,0.0000,2,55,0.0000,0,0
2021-01-19,Brazil,203070494,Espírito Santo,3833712,0.0002,630,737,0.0000,8,63,0.0000,0,0
2021-01-20,Brazil,203070494,Espírito Santo,3833712,0.0017,5774,6511,0.0000,10,73,0.0000,0,0
2021-01-21,Brazil,203070494,Espírito Santo,3833712,0.0035,6858,13369,0.0000,12,85,0.0000,0,0
2021-01-22,Brazil,203070494,Espírito Santo,3833712,0.0048,5194,18563,0.0000,16,101,0.0000,0,0
2021-01-23,Brazil,203070494,Espírito Santo,3833712,0.0053,1873,20436,0.0000,8,109,0.0000,0,0
2021-01-24,Brazil,203070494,Espírito Santo,3833712,0.0055,622,21058,0.0000,2,111,0.0000,0,0
2021-01-25,Brazil,203070494,Espírito Santo,3833712,0.0066,4409,25467,0.0000,6,117,0.0000,0,0
2021-01-26,Brazil,203070494,Espírito Santo,3833712,0.0088,8255,33722,0.0000,27,144,0.0000,0,0
2021-01-27,Brazil,203070494,Espírito Santo,3833712,0.0112,9392,43114,0.0000,8,152,0.0000,0,0
2021-01-28,Brazil,203070494,Espírito Santo,3833712,0.0134,8135,51249,0.0000,5,157,0.0000,0,0
2021-01-29,Brazil,203070494,Espírito Santo,3833712,0.0151,6819,58068,0.0000,6,163,0.0000,0,0
2021-01-30,Brazil,203070494,Espírito Santo,3833712,0.0152,23,58091,0.0000,2,165,0.0000,0,0
2021-01-31,Brazil,203070494,Espírito Santo,3833712,0.0152,24,58115,0.0000,1,166,0.0000,0,0
2021-02-01,Brazil,203070494,Espírito Santo,3833712,0.0164,4609,62724,0.0000,13,179,0.0000,0,0
2021-02-02,Brazil,203070494,Espírito Santo,3833712,0.0176,4825,67549,0.0000,9,188,0.0000,0,0
2021-02-03,Brazil,203070494,Espírito Santo,3833712,0.0187,4189,71738,0.0001,19,207,0.0000,0,0
2021-02-04,Brazil,203070494,Espírito Santo,3833712,0.0199,4366,76104,0.0001,3,210,0.0000,0,0
2021-02-05,Brazil,203070494,Espírito Santo,3833712,0.0213,5688,81792,0.0001,12,222,0.0000,0,0
2021-02-06,Brazil,203070494,Espírito Santo,3833712,0.0217,1267,83059,0.0001,2,224,0.0000,0,0
2021-02-07,Brazil,203070494,Espírito Santo,3833712,0.0218,660,83719,0.0001,3,227,0.0000,0,0
2021-02-08,Brazil,203070494,Espírito Santo,3833712,0.0227,3421,87140,0.0001,5,232,0.0000,0,0
2021-02-09,Brazil,203070494,Espírito Santo,3833712,0.0240,4851,91991,0.0001,10,242,0.0000,0,0
2021-02-10,Brazil,203070494,Espírito Santo,3833712,0.0254,5319,97310,0.0001,92,334,0.0000,0,0
2021-02-11,Brazil,203070494,Espírito Santo,3833712,0.0265,4178,101488,0.0001,43,377,0.0000,0,0
2021-02-12,Brazil,203070494,Espírito Santo,3833712,0.0274,3731,105219,0.0002,205,582,0.0000,0,0
2021-02-13,Brazil,203070494,Espírito Santo,3833712,0.0278,1194,106413,0.0002,25,607,0.0000,0,0
2021-02-14,Brazil,203070494,Espírito Santo,3833712,0.0278,9,106422,0.0002,11,618,0.0000,0,0
2021-02-15,Brazil,203070494,Espírito Santo,3833712,0.0278,342,106764,0.0002,20,638,0.0000,0,0
2021-02-16,Brazil,203070494,Espírito Santo,3833712,0.0280,533,107297,0.0002,8,646,0.0000,0,0
2021-02-17,Brazil,203070494,Espírito Santo,3833712,0.0284,1709,109006,0.0004,930,1576,0.0000,0,0
2021-02-18,Brazil,203070494,Espírito Santo,3833712,0.0291,2422,111428,0.0022,6861,8437,0.0000,0,0
2021-02-19,Brazil,203070494,Espírito Santo,3833712,0.0299,3361,114789,0.0041,7219,15656,0.0000,0,0
2021-02-20,Brazil,203070494,Espírito Santo,3833712,0.0304,1669,116458,0.0042,440,16096,0.0000,0,0
2021-02-21,Brazil,203070494,Espírito Santo,3833712,0.0304,98,116556,0.0042,21,16117,0.0000,1,1
2021-02-22,Brazil,203070494,Espírito Santo,3833712,0.0312,2931,119487,0.0055,5002,21119,0.0000,0,1
2021-02-23,Brazil,203070494,Espírito Santo,3833712,0.0323,4243,123730,0.0066,4295,25414,0.0000,0,1
2021-02-24,Brazil,203070494,Espírito Santo,3833712,0.0335,4607,128337,0.0077,4052,29466,0.0000,0,1
2021-02-25,Brazil,203070494,Espírito Santo,3833712,0.0344,3419,131756,0.0086,3572,33038,0.0000,0,1
2021-02-26,Brazil,203070494,Espírito Santo,3833712,0.0356,4738,136494,0.0094,2853,35891,0.0000,0,1
2021-02-27,Brazil,203070494,Espírito Santo,3833712,0.0363,2744,139238,0.0094,163,36054,0.0000,0,1
2021-02-28,Brazil,203070494,Espírito Santo,3833712,0.0364,135,139373,0.0094,23,36077,0.0000,0,1
2021-03-01,Brazil,203070494,Espírito Santo,3833712,0.0374,4152,143525,0.0100,2317,38394,0.0000,0,1
2021-03-02,Brazil,203070494,Espírito Santo,3833712,0.0393,7202,150727,0.0109,3384,41778,0.0000,0,1
2021-03-03,Brazil,203070494,Espírito Santo,3833712,0.0417,9035,159762,0.0117,3235,45013,0.0000,0,1
2021-03-04,Brazil,203070494,Espírito Santo,3833712,0.0432,5886,165648,0.0124,2461,47474,0.0000,0,1
2021-03-05,Brazil,203070494,Espírito Santo,3833712,0.0447,5721,171369,0.0130,2291,49765,0.0000,0,1
2021-03-06,Brazil,203070494,Espírito Santo,3833712,0.0453,2479,173848,0.0134,1673,51438,0.0000,0,1
2021-03-07,Brazil,203070494,Espírito Santo,3833712,0.0453,8,173856,0.0134,6,51444,0.0000,0,1
2021-03-08,Brazil,203070494,Espírito Santo,3833712,0.0463,3634,177490,0.0141,2571,54015,0.0000,0,1
2021-03-09,Brazil,203070494,Espírito Santo,3833712,0.0471,2955,180445,0.0149,3263,57278,0.0000,0,1
2021-03-10,Brazil,203070494,Espírito Santo,3833712,0.0479,3238,183683,0.0158,3344,60622,0.0000,0,1
2021-03-11,Brazil,203070494,Espírito Santo,3833712,0.0489,3717,187400,0.0166,3044,63666,0.0000,0,1
2021-03-12,Brazil,203070494,Espírito Santo,3833712,0.0500,4130,191530,0.0174,3162,66828,0.0000,0,1
2021-03-13,Brazil,203070494,Espírito Santo,3833712,0.0518,6963,198493,0.0175,315,67143,0.0000,0,1
2021-03-14,Brazil,203070494,Espírito Santo,3833712,0.0518,16,198509,0.0175,3,67146,0.0000,0,1
2021-03-15,Brazil,203070494,Espírito Santo,3833712,0.0529,4293,202802,0.0179,1542,68688,0.0000,0,1
2021-03-16,Brazil,203070494,Espírito Santo,3833712,0.0543,5375,208177,0.0183,1529,70217,0.0000,0,1
2021-03-17,Brazil,203070494,Espírito Santo,3833712,0.0555,4650,212827,0.0188,1958,72175,0.0000,0,1
2021-03-18,Brazil,203070494,Espírito Santo,3833712,0.0567,4581,217408,0.0193,1691,73866,0.0000,0,1
2021-03-19,Brazil,203070494,Espírito Santo,3833712,0.0593,9784,227192,0.0199,2594,76460,0.0000,0,1
2021-03-20,Brazil,203070494,Espírito Santo,3833712,0.0622,11209,238401,0.0203,1201,77661,0.0000,0,1
2021-03-21,Brazil,203070494,Espírito Santo,3833712,0.0622,171,238572,0.0203,12,77673,0.0000,0,1
2021-03-22,Brazil,203070494,Espírito Santo,3833712,0.0634,4374,242946,0.0209,2519,80192,0.0000,0,1
2021-03-23,Brazil,203070494,Espírito Santo,3833712,0.0660,10104,253050,0.0219,3846,84038,0.0000,0,1
2021-03-24,Brazil,203070494,Espírito Santo,3833712,0.0709,18820,271870,0.0230,4079,88117,0.0000,0,1
2021-03-25,Brazil,203070494,Espírito Santo,3833712,0.0771,23868,295738,0.0238,3099,91216,0.0000,0,1
2021-03-26,Brazil,203070494,Espírito Santo,3833712,0.0823,19866,315604,0.0245,2858,94074,0.0000,0,1
2021-03-27,Brazil,203070494,Espírito Santo,3833712,0.0890,25465,341069,0.0247,744,94818,0.0000,0,1
2021-03-28,Brazil,203070494,Espírito Santo,3833712,0.0897,2823,343892,0.0248,214,95032,0.0000,0,1
2021-03-29,Brazil,203070494,Espírito Santo,3833712,0.0927,11554,355446,0.0254,2448,97480,0.0000,0,1
2021-03-30,Brazil,203070494,Espírito Santo,3833712,0.0992,24779,380225,0.0261,2582,100062,0.0000,0,1
2021-03-31,Brazil,203070494,Espírito Santo,3833712,0.1062,27056,407281,0.0268,2869,102931,0.0000,0,1
2021-04-01,Brazil,203070494,Espírito Santo,3833712,0.1096,12950,420231,0.0272,1296,104227,0.0000,0,1
2021-04-02,Brazil,203070494,Espírito Santo,3833712,0.1109,4804,425035,0.0272,147,104374,0.0000,0,1
2021-04-03,Brazil,203070494,Espírito Santo,3833712,0.1168,22816,447851,0.0273,422,104796,0.0000,0,1
2021-04-04,Brazil,203070494,Espírito Santo,3833712,0.1173,1971,449822,0.0273,51,104847,0.0000,0,1
2021-04-05,Brazil,203070494,Espírito Santo,3833712,0.1206,12558,462380,0.0283,3639,108486,0.0000,0,1
2021-04-06,Brazil,203070494,Espírito Santo,3833712,0.1254,18299,480679,0.0293,3804,112290,0.0000,0,1
2021-04-07,Brazil,203070494,Espírito Santo,3833712,0.1291,14388,495067,0.0301,3167,115457,0.0000,0,1
2021-04-08,Brazil,203070494,Espírito Santo,3833712,0.1319,10699,505766,0.0313,4359,119816,0.0000,0,1
2021-04-09,Brazil,203070494,Espírito Santo,3833712,0.1353,12990,518756,0.0325,4620,124436,0.0000,0,1
2021-04-10,Brazil,203070494,Espírito Santo,3833712,0.1447,35992,554748,0.0329,1821,126257,0.0000,0,1
2021-04-11,Brazil,203070494,Espírito Santo,3833712,0.1447,87,554835,0.0329,35,126292,0.0000,0,1
2021-04-12,Brazil,203070494,Espírito Santo,3833712,0.1466,7097,561932,0.0332,1089,127381,0.0000,0,1
2021-04-13,Brazil,203070494,Espírito Santo,3833712,0.1495,11134,573066,0.0348,6190,133571,0.0000,0,1
2021-04-14,Brazil,203070494,Espírito Santo,3833712,0.1528,12652,585718,0.0363,5421,138992,0.0000,0,1
2021-04-15,Brazil,203070494,Espírito Santo,3833712,0.1555,10235,595953,0.0380,6566,145558,0.0000,0,1
2021-04-16,Brazil,203070494,Espírito Santo,3833712,0.1579,9566,605519,0.0403,9051,154609,0.0000,0,1
2021-04-17,Brazil,203070494,Espírito Santo,3833712,0.1641,23520,629039,0.0428,9607,164216,0.0000,0,1
2021-04-18,Brazil,203070494,Espírito Santo,3833712,0.1647,2365,631404,0.0429,212,164428,0.0000,0,1
2021-04-19,Brazil,203070494,Espírito Santo,3833712,0.1674,10286,641690,0.0451,8340,172768,0.0000,0,1
2021-04-20,Brazil,203070494,Espírito Santo,3833712,0.1707,12819,654509,0.0488,14201,186969,0.0000,0,1
2021-04-21,Brazil,203070494,Espírito Santo,3833712,0.1717,3798,658307,0.0505,6523,193492,0.0000,0,1
2021-04-22,Brazil,203070494,Espírito Santo,3833712,0.1740,8753,667060,0.0553,18337,211829,0.0000,0,1
2021-04-23,Brazil,203070494,Espírito Santo,3833712,0.1760,7830,674890,0.0589,13840,225669,0.0000,0,1
2021-04-24,Brazil,203070494,Espírito Santo,3833712,0.1775,5668,680558,0.0607,7136,232805,0.0000,0,1
2021-04-25,Brazil,203070494,Espírito Santo,3833712,0.1776,181,680739,0.0608,368,233173,0.0000,0,1
2021-04-26,Brazil,203070494,Espírito Santo,3833712,0.1790,5609,686348,0.0635,10193,243366,0.0000,0,1
2021-04-27,Brazil,203070494,Espírito Santo,3833712,0.1810,7563,693911,0.0657,8402,251768,0.0000,0,1
2021-04-28,Brazil,203070494,Espírito Santo,3833712,0.1823,5092,699003,0.0673,6218,257986,0.0000,0,1
2021-04-29,Brazil,203070494,Espírito Santo,3833712,0.1836,4818,703821,0.0686,4927,262913,0.0000,0,1
2021-04-30,Brazil,203070494,Espírito Santo,3833712,0.1845,3687,707508,0.0697,4440,267353,0.0000,0,1
2021-05-01,Brazil,203070494,Espírito Santo,3833712,0.1852,2621,710129,0.0701,1578,268931,0.0000,0,1
2021-05-02,Brazil,203070494,Espírito Santo,3833712,0.1853,110,710239,0.0702,38,268969,0.0000,0,1
2021-05-03,Brazil,203070494,Espírito Santo,3833712,0.1866,5089,715328,0.0711,3437,272406,0.0000,0,1
2021-05-04,Brazil,203070494,Espírito Santo,3833712,0.1885,7314,722642,0.0718,2932,275338,0.0000,0,1
2021-05-05,Brazil,203070494,Espírito Santo,3833712,0.1907,8468,731110,0.0729,4263,279601,0.0000,0,1
2021-05-06,Brazil,203070494,Espírito Santo,3833712,0.1939,12271,743381,0.0736,2506,282107,0.0000,0,1
2021-05-07,Brazil,203070494,Espírito Santo,3833712,0.1974,13343,756724,0.0746,3769,285876,0.0000,0,1
2021-05-08,Brazil,203070494,Espírito Santo,3833712,0.2014,15249,771973,0.0748,1077,286953,0.0000,0,1
2021-05-09,Brazil,203070494,Espírito Santo,3833712,0.2014,91,772064,0.0749,133,287086,0.0000,0,1
2021-05-10,Brazil,203070494,Espírito Santo,3833712,0.2050,13765,785829,0.0753,1664,288750,0.0000,0,1
2021-05-11,Brazil,203070494,Espírito Santo,3833712,0.2094,16991,802820,0.0769,5981,294731,0.0000,0,1
2021-05-12,Brazil,203070494,Espírito Santo,3833712,0.2141,18142,820962,0.0784,5755,300486,0.0000,0,1
2021-05-13,Brazil,203070494,Espírito Santo,3833712,0.2192,19317,840279,0.0794,3772,304258,0.0000,0,1
2021-05-14,Brazil,203070494,Espírito Santo,3833712,0.2240,18425,858704,0.0804,4132,308390,0.0000,0,1
2021-05-15,Brazil,203070494,Espírito Santo,3833712,0.2272,12421,871125,0.0825,7753,316143,0.0000,0,1
2021-05-16,Brazil,203070494,Espírito Santo,3833712,0.2273,158,871283,0.0825,147,316290,0.0000,0,1
2021-05-17,Brazil,203070494,Espírito Santo,3833712,0.2311,14620,885903,0.0838,4791,321081,0.0000,0,1
2021-05-18,Brazil,203070494,Espírito Santo,3833712,0.2352,15766,901669,0.0877,15154,336235,0.0000,0,1
2021-05-19,Brazil,203070494,Espírito Santo,3833712,0.2399,18027,919696,0.0919,16162,352397,0.0000,0,1
2021-05-20,Brazil,203070494,Espírito Santo,3833712,0.2448,18726,938422,0.0974,20991,373388,0.0000,0,1
2021-05-21,Brazil,203070494,Espírito Santo,3833712,0.2497,18968,957390,0.1027,20410,393798,0.0000,0,1
2021-05-22,Brazil,203070494,Espírito Santo,3833712,0.2520,8726,966116,0.1082,20998,414796,0.0000,0,1
2021-05-23,Brazil,203070494,Espírito Santo,3833712,0.2520,100,966216,0.1092,3813,418609,0.0000,0,1
2021-05-24,Brazil,203070494,Espírito Santo,3833712,0.2548,10725,976941,0.1114,8470,427079,0.0000,0,1
2021-05-25,Brazil,203070494,Espírito Santo,3833712,0.2585,13927,990868,0.1132,6994,434073,0.0000,0,1
2021-05-26,Brazil,203070494,Espírito Santo,3833712,0.2620,13549,1004417,0.1155,8707,442780,0.0000,0,1
2021-05-27,Brazil,203070494,Espírito Santo,3833712,0.2670,19175,1023592,0.1172,6526,449306,0.0000,0,1
2021-05-28,Brazil,203070494,Espírito Santo,3833712,0.2715,17313,1040905,0.1186,5483,454789,0.0000,0,1
2021-05-29,Brazil,203070494,Espírito Santo,3833712,0.2748,12502,1053407,0.1196,3853,458642,0.0000,0,1
2021-05-30,Brazil,203070494,Espírito Santo,3833712,0.2749,668,1054075,0.1198,736,459378,0.0000,0,1
2021-05-31,Brazil,203070494,Espírito Santo,3833712,0.2784,13225,1067300,0.1206,2939,462317,0.0000,0,1
2021-06-01,Brazil,203070494,Espírito Santo,3833712,0.2830,17787,1085087,0.1217,4295,466612,0.0000,0,1
2021-06-02,Brazil,203070494,Espírito Santo,3833712,0.2899,26282,1111369,0.1231,5418,472030,0.0000,0,1
2021-06-03,Brazil,203070494,Espírito Santo,3833712,0.2973,28446,1139815,0.1239,2858,474888,0.0000,0,1
2021-06-04,Brazil,203070494,Espírito Santo,3833712,0.3037,24399,1164214,0.1247,3140,478028,0.0000,0,1
2021-06-05,Brazil,203070494,Espírito Santo,3833712,0.3076,15021,1179235,0.1249,966,478994,0.0000,0,1
2021-06-06,Brazil,203070494,Espírito Santo,3833712,0.3077,293,1179528,0.1249,23,479017,0.0000,0,1
2021-06-07,Brazil,203070494,Espírito Santo,3833712,0.3124,17979,1197507,0.1256,2451,481468,0.0000,0,1
2021-06-08,Brazil,203070494,Espírito Santo,3833712,0.3185,23678,1221185,0.1262,2528,483996,0.0000,0,1
2021-06-09,Brazil,203070494,Espírito Santo,3833712,0.3255,26722,1247907,0.1267,1612,485608,0.0000,0,1
2021-06-10,Brazil,203070494,Espírito Santo,3833712,0.3319,24681,1272588,0.1271,1732,487340,0.0000,0,1
2021-06-11,Brazil,203070494,Espírito Santo,3833712,0.3389,26573,1299161,0.1275,1373,488713,0.0000,0,1
2021-06-12,Brazil,203070494,Espírito Santo,3833712,0.3473,32204,1331365,0.1278,1272,489985,0.0000,0,1
2021-06-13,Brazil,203070494,Espírito Santo,3833712,0.3505,12530,1343895,0.1278,50,490035,0.0000,0,1
2021-06-14,Brazil,203070494,Espírito Santo,3833712,0.3559,20548,1364443,0.1281,1126,491161,0.0000,0,1
2021-06-15,Brazil,203070494,Espírito Santo,3833712,0.3622,24251,1388694,0.1284,1228,492389,0.0000,0,1
2021-06-16,Brazil,203070494,Espírito Santo,3833712,0.3679,21824,1410518,0.1287,1131,493520,0.0000,0,1
2021-06-17,Brazil,203070494,Espírito Santo,3833712,0.3740,23303,1433821,0.1290,1093,494613,0.0000,0,1
2021-06-18,Brazil,203070494,Espírito Santo,3833712,0.3787,17970,1451791,0.1294,1322,495935,0.0000,0,1
2021-06-19,Brazil,203070494,Espírito Santo,3833712,0.3872,32563,1484354,0.1310,6162,502097,0.0000,0,1
2021-06-20,Brazil,203070494,Espírito Santo,3833712,0.3884,4722,1489076,0.1311,464,502561,0.0000,0,1
2021-06-21,Brazil,203070494,Espírito Santo,3833712,0.3915,11667,1500743,0.1326,5739,508300,0.0000,0,1
2021-06-22,Brazil,203070494,Espírito Santo,3833712,0.3962,18270,1519013,0.1346,7754,516054,0.0000,0,1
2021-06-23,Brazil,203070494,Espírito Santo,3833712,0.4012,18946,1537959,0.1362,6120,522174,0.0000,0,1
2021-06-24,Brazil,203070494,Espírito Santo,3833712,0.4087,28822,1566781,0.1382,7558,529732,0.0000,0,1
2021-06-25,Brazil,203070494,Espírito Santo,3833712,0.4140,20388,1587169,0.1392,3893,533625,0.0000,0,1
2021-06-26,Brazil,203070494,Espírito Santo,3833712,0.4215,28882,1616051,0.1432,15313,548938,0.0000,0,1
2021-06-27,Brazil,203070494,Espírito Santo,3833712,0.4216,72,1616123,0.1433,261,549199,0.0000,0,1
2021-06-28,Brazil,203070494,Espírito Santo,3833712,0.4256,15539,1631662,0.1454,8064,557263,0.0000,0,1
2021-06-29,Brazil,203070494,Espírito Santo,3833712,0.4315,22624,1654286,0.1476,8578,565841,0.0000,0,1
2021-06-30,Brazil,203070494,Espírito Santo,3833712,0.4371,21407,1675693,0.1498,8584,574425,0.0000,0,1
2021-07-01,Brazil,203070494,Espírito Santo,3833712,0.4416,17176,1692869,0.1516,6585,581010,0.0000,0,1
2021-07-02,Brazil,203070494,Espírito Santo,3833712,0.4479,24305,1717174,0.1529,5278,586288,0.0000,0,1
2021-07-03,Brazil,203070494,Espírito Santo,3833712,0.4601,46624,1763798,0.1534,1975,588263,0.0000,0,1
2021-07-04,Brazil,203070494,Espírito Santo,3833712,0.4605,1703,1765501,0.1535,128,588391,0.0000,0,1
2021-07-05,Brazil,203070494,Espírito Santo,3833712,0.4650,17350,1782851,0.1558,8876,597267,0.0000,0,1
2021-07-06,Brazil,203070494,Espírito Santo,3833712,0.4762,42800,1825651,0.1572,5228,602495,0.0000,0,1
2021-07-07,Brazil,203070494,Espírito Santo,3833712,0.4867,40082,1865733,0.1585,5134,607629,0.0000,0,1
2021-07-08,Brazil,203070494,Espírito Santo,3833712,0.4926,22771,1888504,0.1604,7362,614991,0.0000,0,1
2021-07-09,Brazil,203070494,Espírito Santo,3833712,0.4978,20090,1908594,0.1629,9683,624674,0.0000,0,1
2021-07-10,Brazil,203070494,Espírito Santo,3833712,0.5082,39517,1948111,0.1637,2890,627564,0.0000,0,1
2021-07-11,Brazil,203070494,Espírito Santo,3833712,0.5086,1768,1949879,0.1637,46,627610,0.0000,0,1
2021-07-12,Brazil,203070494,Espírito Santo,3833712,0.5116,11538,1961417,0.1651,5509,633119,0.0000,0,1
2021-07-13,Brazil,203070494,Espírito Santo,3833712,0.5182,25373,1986790,0.1672,7872,640991,0.0000,0,1
2021-07-14,Brazil,203070494,Espírito Santo,3833712,0.5220,14231,2001021,0.1690,6811,647802,0.0000,0,1
2021-07-15,Brazil,203070494,Espírito Santo,3833712,0.5249,11272,2012293,0.1708,7142,654944,0.0000,0,1
2021-07-16,Brazil,203070494,Espírito Santo,3833712,0.5269,7502,2019795,0.1725,6223,661167,0.0000,0,1
2021-07-17,Brazil,203070494,Espírito Santo,3833712,0.5315,17955,2037750,0.1732,2878,664045,0.0000,0,1
2021-07-18,Brazil,203070494,Espírito Santo,3833712,0.5315,12,2037762,0.1732,134,664179,0.0000,0,1
2021-07-19,Brazil,203070494,Espírito Santo,3833712,0.5324,3488,2041250,0.1756,8993,673172,0.0000,0,1
2021-07-20,Brazil,203070494,Espírito Santo,3833712,0.5336,4519,2045769,0.1781,9793,682965,0.0000,0,1
2021-07-21,Brazil,203070494,Espírito Santo,3833712,0.5356,7639,2053408,0.1808,10138,693103,0.0000,0,1
2021-07-22,Brazil,203070494,Espírito Santo,3833712,0.5392,13606,2067014,0.1840,12290,705393,0.0000,0,1
2021-07-23,Brazil,203070494,Espírito Santo,3833712,0.5428,13772,2080786,0.1864,9350,714743,0.0000,0,1
2021-07-24,Brazil,203070494,Espírito Santo,3833712,0.5466,14899,2095685,0.1876,4474,719217,0.0000,0,1
2021-07-25,Brazil,203070494,Espírito Santo,3833712,0.5467,291,2095976,0.1876,29,719246,0.0000,0,1
2021-07-26,Brazil,203070494,Espírito Santo,3833712,0.5482,5822,2101798,0.1911,13424,732670,0.0000,0,1
2021-07-27,Brazil,203070494,Espírito Santo,3833712,0.5494,4586,2106384,0.1950,14789,747459,0.0000,0,1
2021-07-28,Brazil,203070494,Espírito Santo,3833712,0.5508,5306,2111690,0.1985,13483,760942,0.0000,0,1
2021-07-29,Brazil,203070494,Espírito Santo,3833712,0.5539,11814,2123504,0.2013,10935,771877,0.0000,0,1
2021-07-30,Brazil,203070494,Espírito Santo,3833712,0.5563,9154,2132658,0.2055,15846,787723,0.0000,0,1
2021-07-31,Brazil,203070494,Espírito Santo,3833712,0.5597,13102,2145760,0.2068,4919,792642,0.0000,0,1
2021-08-01,Brazil,203070494,Espírito Santo,3833712,0.5597,159,2145919,0.2068,201,792843,0.0000,0,1
2021-08-02,Brazil,203070494,Espírito Santo,3833712,0.5608,3944,2149863,0.2102,13078,805921,0.0000,0,1
2021-08-03,Brazil,203070494,Espírito Santo,3833712,0.5642,13271,2163134,0.2135,12458,818379,0.0000,0,1
2021-08-04,Brazil,203070494,Espírito Santo,3833712,0.5695,20036,2183170,0.2172,14222,832601,0.0000,0,1
2021-08-05,Brazil,203070494,Espírito Santo,3833712,0.5747,19934,2203104,0.2210,14563,847164,0.0000,0,1
2021-08-06,Brazil,203070494,Espírito Santo,3833712,0.5791,16971,2220075,0.2254,16972,864136,0.0000,0,1
2021-08-07,Brazil,203070494,Espírito Santo,3833712,0.5843,20014,2240089,0.2267,4857,868993,0.0000,0,1
2021-08-08,Brazil,203070494,Espírito Santo,3833712,0.5843,140,2240229,0.2292,9544,878537,0.0000,0,1
2021-08-09,Brazil,203070494,Espírito Santo,3833712,0.5862,7193,2247422,0.2335,16625,895162,0.0000,0,1
2021-08-10,Brazil,203070494,Espírito Santo,3833712,0.5909,17897,2265319,0.2378,16530,911692,0.0000,0,1
2021-08-11,Brazil,203070494,Espírito Santo,3833712,0.5968,22681,2288000,0.2431,20341,932033,0.0000,0,1
2021-08-12,Brazil,203070494,Espírito Santo,3833712,0.6036,26056,2314056,0.2489,22228,954261,0.0000,0,1
2021-08-13,Brazil,203070494,Espírito Santo,3833712,0.6094,22218,2336274,0.2542,20190,974451,0.0000,0,1
2021-08-14,Brazil,203070494,Espírito Santo,3833712,0.6164,26985,2363259,0.2586,16899,991350,0.0000,0,1
2021-08-15,Brazil,203070494,Espírito Santo,3833712,0.6164,20,2363279,0.2587,294,991644,0.0000,0,1
2021-08-16,Brazil,203070494,Espírito Santo,3833712,0.6202,14345,2377624,0.2625,14525,1006169,0.0000,0,1
2021-08-17,Brazil,203070494,Espírito Santo,3833712,0.6263,23329,2400953,0.2668,16842,1023011,0.0000,0,1
2021-08-18,Brazil,203070494,Espírito Santo,3833712,0.6353,34637,2435590,0.2729,23307,1046318,0.0000,0,1
2021-08-19,Brazil,203070494,Espírito Santo,3833712,0.6461,41488,2477078,0.2780,19612,1065930,0.0000,0,1
2021-08-20,Brazil,203070494,Espírito Santo,3833712,0.6519,22035,2499113,0.2831,19544,1085474,0.0000,0,1
2021-08-21,Brazil,203070494,Espírito Santo,3833712,0.6846,125629,2624742,0.2859,10709,1096183,0.0000,0,1
2021-08-22,Brazil,203070494,Espírito Santo,3833712,0.6848,499,2625241,0.2860,106,1096289,0.0000,0,1
2021-08-23,Brazil,203070494,Espírito Santo,3833712,0.6872,9361,2634602,0.2903,16590,1112879,0.0000,0,1
2021-08-24,Brazil,203070494,Espírito Santo,3833712,0.6903,11876,2646478,0.2967,24460,1137339,0.0000,0,1
2021-08-25,Brazil,203070494,Espírito Santo,3833712,0.6938,13168,2659646,0.3027,23230,1160569,0.0000,0,1
2021-08-26,Brazil,203070494,Espírito Santo,3833712,0.6967,11409,2671055,0.3086,22639,1183208,0.0000,0,1
2021-08-27,Brazil,203070494,Espírito Santo,3833712,0.6989,8278,2679333,0.3153,25402,1208610,0.0000,0,1
2021-08-28,Brazil,203070494,Espírito Santo,3833712,0.7045,21650,2700983,0.3249,36781,1245391,0.0000,1,2
2021-08-29,Brazil,203070494,Espírito Santo,3833712,0.7046,217,2701200,0.3251,832,1246223,0.0000,0,2
2021-08-30,Brazil,203070494,Espírito Santo,3833712,0.7062,6261,2707461,0.3305,20755,1266978,0.0000,0,2
2021-08-31,Brazil,203070494,Espírito Santo,3833712,0.7083,7848,2715309,0.3362,21919,1288897,0.0000,0,2
2021-09-01,Brazil,203070494,Espírito Santo,3833712,0.7101,6927,2722236,0.3427,24973,1313870,0.0000,0,2
2021-09-02,Brazil,203070494,Espírito Santo,3833712,0.7125,9363,2731599,0.3493,25202,1339072,0.0000,0,2
2021-09-03,Brazil,203070494,Espírito Santo,3833712,0.7140,5565,2737164,0.3562,26528,1365600,0.0000,0,2
2021-09-04,Brazil,203070494,Espírito Santo,3833712,0.7164,9301,2746465,0.3616,20666,1386266,0.0000,0,2
2021-09-05,Brazil,203070494,Espírito Santo,3833712,0.7164,109,2746574,0.3616,191,1386457,0.0000,0,2
2021-09-06,Brazil,203070494,Espírito Santo,3833712,0.7170,2367,2748941,0.3639,8482,1394939,0.0000,0,2
2021-09-07,Brazil,203070494,Espírito Santo,3833712,0.7171,395,2749336,0.3641,936,1395875,0.0000,0,2
2021-09-08,Brazil,203070494,Espírito Santo,3833712,0.7187,5842,2755178,0.3705,24360,1420235,0.0000,0,2
2021-09-09,Brazil,203070494,Espírito Santo,3833712,0.7204,6777,2761955,0.3773,26376,1446611,0.0000,0,2
2021-09-10,Brazil,203070494,Espírito Santo,3833712,0.7217,4654,2766609,0.3837,24420,1471031,0.0000,0,2
2021-09-11,Brazil,203070494,Espírito Santo,3833712,0.7239,8590,2775199,0.3876,15106,1486137,0.0000,1,3
2021-09-12,Brazil,203070494,Espírito Santo,3833712,0.7239,90,2775289,0.3879,1131,1487268,0.0000,0,3
2021-09-13,Brazil,203070494,Espírito Santo,3833712,0.7248,3501,2778790,0.3922,16259,1503527,0.0000,0,3
2021-09-14,Brazil,203070494,Espírito Santo,3833712,0.7266,6954,2785744,0.3976,20627,1524154,0.0000,0,3
2021-09-15,Brazil,203070494,Espírito Santo,3833712,0.7297,11905,2797649,0.4022,17804,1541958,0.0000,0,3
2021-09-16,Brazil,203070494,Espírito Santo,3833712,0.7357,22996,2820645,0.4067,17251,1559209,0.0000,0,3
2021-09-17,Brazil,203070494,Espírito Santo,3833712,0.7392,13355,2834000,0.4113,17773,1576982,0.0000,0,3
2021-09-18,Brazil,203070494,Espírito Santo,3833712,0.7447,20920,2854920,0.4155,15923,1592905,0.0000,0,3
2021-09-19,Brazil,203070494,Espírito Santo,3833712,0.7448,571,2855491,0.4158,996,1593901,0.0000,0,3
2021-09-20,Brazil,203070494,Espírito Santo,3833712,0.7466,6600,2862091,0.4195,14520,1608421,0.0000,1,4
2021-09-21,Brazil,203070494,Espírito Santo,3833712,0.7503,14180,2876271,0.4240,17035,1625456,0.0000,0,4
2021-09-22,Brazil,203070494,Espírito Santo,3833712,0.7561,22419,2898690,0.4286,17557,1643013,0.0000,0,4
2021-09-23,Brazil,203070494,Espírito Santo,3833712,0.7618,21925,2920615,0.4344,22178,1665191,0.0000,0,4
2021-09-24,Brazil,203070494,Espírito Santo,3833712,0.7692,28184,2948799,0.4399,21223,1686414,0.0000,0,4
2021-09-25,Brazil,203070494,Espírito Santo,3833712,0.7813,46372,2995171,0.4448,18939,1705353,0.0000,0,4
2021-09-26,Brazil,203070494,Espírito Santo,3833712,0.7816,1345,2996516,0.4450,675,1706028,0.0000,0,4
2021-09-27,Brazil,203070494,Espírito Santo,3833712,0.7843,10323,3006839,0.4484,12866,1718894,0.0000,1,5
2021-09-28,Brazil,203070494,Espírito Santo,3833712,0.7872,11121,3017960,0.4526,16295,1735189,0.0000,0,5
2021-09-29,Brazil,203070494,Espírito Santo,3833712,0.7903,11804,3029764,0.4565,14721,1749910,0.0000,0,5
2021-09-30,Brazil,203070494,Espírito Santo,3833712,0.7930,10199,3039963,0.4608,16700,1766610,0.0000,0,5
2021-10-01,Brazil,203070494,Espírito Santo,3833712,0.7947,6749,3046712,0.4652,16890,1783500,0.0000,0,5
2021-10-02,Brazil,203070494,Espírito Santo,3833712,0.7969,8204,3054916,0.4714,23830,1807330,0.0000,0,5
2021-10-03,Brazil,203070494,Espírito Santo,3833712,0.7970,661,3055577,0.4715,114,1807444,0.0000,0,5
2021-10-04,Brazil,203070494,Espírito Santo,3833712,0.7983,4915,3060492,0.4750,13719,1821163,0.0000,0,5
2021-10-05,Brazil,203070494,Espírito Santo,3833712,0.7999,6095,3066587,0.4788,14576,1835739,0.0000,0,5
2021-10-06,Brazil,203070494,Espírito Santo,3833712,0.8013,5528,3072115,0.4828,15033,1850772,0.0000,0,5
2021-10-07,Brazil,203070494,Espírito Santo,3833712,0.8030,6328,3078443,0.4876,18529,1869301,0.0000,1,6
2021-10-08,Brazil,203070494,Espírito Santo,3833712,0.8041,4254,3082697,0.4919,16425,1885726,0.0000,0,6
2021-10-09,Brazil,203070494,Espírito Santo,3833712,0.8048,2823,3085520,0.4978,22813,1908539,0.0000,0,6
2021-10-10,Brazil,203070494,Espírito Santo,3833712,0.8048,41,3085561,0.4979,157,1908696,0.0000,0,6
2021-10-11,Brazil,203070494,Espírito Santo,3833712,0.8053,1645,3087206,0.4991,4877,1913573,0.0000,1,7
2021-10-12,Brazil,203070494,Espírito Santo,3833712,0.8053,64,3087270,0.4992,133,1913706,0.0000,1,8
2021-10-13,Brazil,203070494,Espírito Santo,3833712,0.8062,3481,3090751,0.5036,17056,1930762,0.0000,0,8
2021-10-14,Brazil,203070494,Espírito Santo,3833712,0.8075,5098,3095849,0.5087,19256,1950018,0.0000,0,8
2021-10-15,Brazil,203070494,Espírito Santo,3833712,0.8087,4490,3100339,0.5131,17226,1967244,0.0000,4,12
2021-10-16,Brazil,203070494,Espírito Santo,3833712,0.8101,5492,3105831,0.5187,21442,1988686,0.0000,0,12
2021-10-17,Brazil,203070494,Espírito Santo,3833712,0.8102,128,3105959,0.5189,595,1989281,0.0000,0,12
2021-10-18,Brazil,203070494,Espírito Santo,3833712,0.8111,3533,3109492,0.5232,16348,2005629,0.0000,0,12
2021-10-19,Brazil,203070494,Espírito Santo,3833712,0.8120,3451,3112943,0.5274,16419,2022048,0.0000,0,12
2021-10-20,Brazil,203070494,Espírito Santo,3833712,0.8129,3392,3116335,0.5327,20035,2042083,0.0000,1,13
2021-10-21,Brazil,203070494,Espírito Santo,3833712,0.8138,3673,3120008,0.5390,24290,2066373,0.0000,0,13
2021-10-22,Brazil,203070494,Espírito Santo,3833712,0.8146,2840,3122848,0.5433,16563,2082936,0.0000,0,13
2021-10-23,Brazil,203070494,Espírito Santo,3833712,0.8151,2019,3124867,0.5481,18436,2101372,0.0000,0,13
2021-10-24,Brazil,203070494,Espírito Santo,3833712,0.8151,35,3124902,0.5482,258,2101630,0.0000,0,13
2021-10-25,Brazil,203070494,Espírito Santo,3833712,0.8157,2259,3127161,0.5515,12690,2114320,0.0000,0,13
2021-10-26,Brazil,203070494,Espírito Santo,3833712,0.8165,2895,3130056,0.5555,15256,2129576,0.0000,0,13
2021-10-27,Brazil,203070494,Espírito Santo,3833712,0.8172,2905,3132961,0.5599,16910,2146486,0.0000,2,15
2021-10-28,Brazil,203070494,Espírito Santo,3833712,0.8180,2975,3135936,0.5638,15137,2161623,0.0000,0,15
2021-10-29,Brazil,203070494,Espírito Santo,3833712,0.8185,2108,3138044,0.5667,11108,2172731,0.0000,0,15
2021-10-30,Brazil,203070494,Espírito Santo,3833712,0.8191,2019,3140063,0.5694,10114,2182845,0.0000,0,15
2021-10-31,Brazil,203070494,Espírito Santo,3833712,0.8191,6,3140069,0.5694,111,2182956,0.0000,0,15
2021-11-01,Brazil,203070494,Espírito Santo,3833712,0.8191,199,3140268,0.5696,582,2183538,0.0000,0,15
2021-11-02,Brazil,203070494,Espírito Santo,3833712,0.8191,48,3140316,0.5696,162,2183700,0.0000,0,15
2021-11-03,Brazil,203070494,Espírito Santo,3833712,0.8198,2380,3142696,0.5727,12046,2195746,0.0000,1,16
2021-11-04,Brazil,203070494,Espírito Santo,3833712,0.8206,3086,3145782,0.5769,15773,2211519,0.0000,2,18
2021-11-05,Brazil,203070494,Espírito Santo,3833712,0.8213,2801,3148583,0.5806,14300,2225819,0.0000,0,18
2021-11-06,Brazil,203070494,Espírito Santo,3833712,0.8218,1834,3150417,0.5841,13541,2239360,0.0000,0,18
2021-11-07,Brazil,203070494,Espírito Santo,3833712,0.8218,166,3150583,0.5843,655,2240015,0.0000,0,18
2021-11-08,Brazil,203070494,Espírito Santo,3833712,0.8222,1623,3152206,0.5868,9764,2249779,0.0000,0,18
2021-11-09,Brazil,203070494,Espírito Santo,3833712,0.8227,1766,3153972,0.5898,11294,2261073,0.0000,1,19
2021-11-10,Brazil,203070494,Espírito Santo,3833712,0.8233,2148,3156120,0.5933,13486,2274559,0.0000,0,19
2021-11-11,Brazil,203070494,Espírito Santo,3833712,0.8237,1723,3157843,0.5968,13278,2287837,0.0000,1,20
2021-11-12,Brazil,203070494,Espírito Santo,3833712,0.8242,1715,3159558,0.5997,11149,2298986,0.0000,0,20
2021-11-13,Brazil,203070494,Espírito Santo,3833712,0.8245,1512,3161070,0.6031,13240,2312226,0.0000,0,20
2021-11-14,Brazil,203070494,Espírito Santo,3833712,0.8246,63,3161133,0.6033,598,2312824,0.0000,0,20
2021-11-15,Brazil,203070494,Espírito Santo,3833712,0.8246,75,3161208,0.6035,776,2313600,0.0000,0,20
2021-11-16,Brazil,203070494,Espírito Santo,3833712,0.8251,1813,3163021,0.6069,13010,2326610,0.0000,0,20
2021-11-17,Brazil,203070494,Espírito Santo,3833712,0.8256,1912,3164933,0.6115,17700,2344310,0.0000,0,20
2021-11-18,Brazil,203070494,Espírito Santo,3833712,0.8261,2063,3166996,0.6157,16143,2360453,0.0000,1,21
2021-11-19,Brazil,203070494,Espírito Santo,3833712,0.8266,1846,3168842,0.6196,14807,2375260,0.0000,0,21
2021-11-20,Brazil,203070494,Espírito Santo,3833712,0.8272,2226,3171068,0.6248,20219,2395479,0.0000,0,21
2021-11-21,Brazil,203070494,Espírito Santo,3833712,0.8272,77,3171145,0.6250,716,2396195,0.0000,0,21
2021-11-22,Brazil,203070494,Espírito Santo,3833712,0.8276,1511,3172656,0.6285,13264,2409459,0.0000,0,21
2021-11-23,Brazil,203070494,Espírito Santo,3833712,0.8281,1872,3174528,0.6328,16410,2425869,0.0000,0,21
2021-11-24,Brazil,203070494,Espírito Santo,3833712,0.8284,1469,3175997,0.6358,11649,2437518,0.0000,0,21
2021-11-25,Brazil,203070494,Espírito Santo,3833712,0.8290,2185,3178182,0.6405,18091,2455609,0.0000,0,21
2021-11-26,Brazil,203070494,Espírito Santo,3833712,0.8296,2211,3180393,0.6447,16065,2471674,0.0000,0,21
2021-11-27,Brazil,203070494,Espírito Santo,3833712,0.8300,1759,3182152,0.6473,9895,2481569,0.0000,1,22
2021-11-28,Brazil,203070494,Espírito Santo,3833712,0.8301,121,3182273,0.6475,899,2482468,0.0000,0,22
2021-11-29,Brazil,203070494,Espírito Santo,3833712,0.8305,1557,3183830,0.6503,10655,2493123,0.0000,0,22
2021-11-30,Brazil,203070494,Espírito Santo,3833712,0.8310,2000,3185830,0.6537,13137,2506260,0.0000,0,22
2021-12-01,Brazil,203070494,Espírito Santo,3833712,0.8315,1766,3187596,0.6573,13691,2519951,0.0000,0,22
2021-12-02,Brazil,203070494,Espírito Santo,3833712,0.8316,461,3188057,0.6580,2598,2522549,0.0000,0,22
2021-12-03,Brazil,203070494,Espírito Santo,3833712,0.8319,1079,3189136,0.6600,7563,2530112,0.0000,0,22
2021-12-04,Brazil,203070494,Espírito Santo,3833712,0.8323,1634,3190770,0.6625,9838,2539950,0.0000,0,22
2021-12-05,Brazil,203070494,Espírito Santo,3833712,0.8323,116,3190886,0.6626,441,2540391,0.0000,0,22
2021-12-06,Brazil,203070494,Espírito Santo,3833712,0.8327,1504,3192390,0.6650,8853,2549244,0.0000,0,22
2021-12-07,Brazil,203070494,Espírito Santo,3833712,0.8331,1600,3193990,0.6672,8491,2557735,0.0000,0,22
2021-12-08,Brazil,203070494,Espírito Santo,3833712,0.8334,1095,3195085,0.6689,6564,2564299,0.0000,0,22
2021-12-09,Brazil,203070494,Espírito Santo,3833712,0.8336,541,3195626,0.6697,3088,2567387,0.0000,0,22
2021-12-10,Brazil,203070494,Espírito Santo,3833712,0.8339,1336,3196962,0.6718,8056,2575443,0.0000,0,22
2021-12-11,Brazil,203070494,Espírito Santo,3833712,0.8341,913,3197875,0.6731,5003,2580446,0.0000,0,22
2021-12-12,Brazil,203070494,Espírito Santo,3833712,0.8342,271,3198146,0.6734,1052,2581498,0.0000,0,22
2021-12-13,Brazil,203070494,Espírito Santo,3833712,0.8345,1096,3199242,0.6751,6709,2588207,0.0000,0,22
2021-12-14,Brazil,203070494,Espírito Santo,3833712,0.8349,1349,3200591,0.6770,7249,2595456,0.0000,0,22
2021-12-15,Brazil,203070494,Espírito Santo,3833712,0.8352,1439,3202030,0.6792,8245,2603701,0.0000,0,22
2021-12-16,Brazil,203070494,Espírito Santo,3833712,0.8356,1565,3203595,0.6816,9310,2613011,0.0000,0,22
2021-12-17,Brazil,203070494,Espírito Santo,3833712,0.8359,1160,3204755,0.6834,7094,2620105,0.0000,0,22
2021-12-18,Brazil,203070494,Espírito Santo,3833712,0.8361,723,3205478,0.6847,4740,2624845,0.0000,0,22
2021-12-19,Brazil,203070494,Espírito Santo,3833712,0.8361,65,3205543,0.6848,467,2625312,0.0000,0,22
2021-12-20,Brazil,203070494,Espírito Santo,3833712,0.8364,865,3206408,0.6862,5232,2630544,0.0000,1,23
2021-12-21,Brazil,203070494,Espírito Santo,3833712,0.8367,1069,3207477,0.6876,5447,2635991,0.0000,0,23
2021-12-22,Brazil,203070494,Espírito Santo,3833712,0.8370,1247,3208724,0.6892,6359,2642350,0.0000,0,23
2021-12-23,Brazil,203070494,Espírito Santo,3833712,0.8373,1131,3209855,0.6907,5508,2647858,0.0000,0,23
2021-12-24,Brazil,203070494,Espírito Santo,3833712,0.8373,113,3209968,0.6908,528,2648386,0.0000,0,23
2021-12-25,Brazil,203070494,Espírito Santo,3833712,0.8373,19,3209987,0.6908,106,2648492,0.0000,0,23
2021-12-26,Brazil,203070494,Espírito Santo,3833712,0.8373,6,3209993,0.6909,32,2648524,0.0000,0,23
2021-12-27,Brazil,203070494,Espírito Santo,3833712,0.8375,760,3210753,0.6919,4124,2652648,0.0000,1,24
2021-12-28,Brazil,203070494,Espírito Santo,3833712,0.8378,1202,3211955,0.6934,5562,2658210,0.0000,1,25
2021-12-29,Brazil,203070494,Espírito Santo,3833712,0.8381,1178,3213133,0.6947,5207,2663417,0.0000,2,27
2021-12-30,Brazil,203070494,Espírito Santo,3833712,0.8384,875,3214008,0.6958,4117,2667534,0.0000,0,27
2021-12-31,Brazil,203070494,Espírito Santo,3833712,0.8384,88,3214096,0.6959,398,2667932,0.0000,0,27
2021-01-01,Brazil,203070494,Goiás,7056495,0.0000,8,8,0.0000,0,0,0.0000,0,0
2021-01-04,Brazil,203070494,Goiás,7056495,0.0000,1,9,0.0000,0,0,0.0000,0,0
2021-01-06,Brazil,203070494,Goiás,7056495,0.0000,0,9,0.0000,1,1,0.0000,0,0
2021-01-11,Brazil,203070494,Goiás,7056495,0.0000,0,9,0.0000,1,2,0.0000,0,0
2021-01-12,Brazil,203070494,Goiás,7056495,0.0000,22,31,0.0000,0,2,0.0000,0,0
2021-01-17,Brazil,203070494,Goiás,7056495,0.0000,23,54,0.0000,5,7,0.0000,0,0
2021-01-18,Brazil,203070494,Goiás,7056495,0.0000,143,197,0.0000,7,14,0.0000,0,0
2021-01-19,Brazil,203070494,Goiás,7056495,0.0003,1949,2146,0.0000,8,22,0.0000,0,0
2021-01-20,Brazil,203070494,Goiás,7056495,0.0026,16350,18496,0.0000,8,30,0.0000,0,0
2021-01-21,Brazil,203070494,Goiás,7056495,0.0046,14171,32667,0.0000,18,48,0.0000,0,0
2021-01-22,Brazil,203070494,Goiás,7056495,0.0058,8421,41088,0.0000,45,93,0.0000,0,0
2021-01-23,Brazil,203070494,Goiás,7056495,0.0060,1279,42367,0.0000,7,100,0.0000,0,0
2021-01-24,Brazil,203070494,Goiás,7056495,0.0060,136,42503,0.0000,10,110,0.0000,0,0
2021-01-25,Brazil,203070494,Goiás,7056495,0.0067,5095,47598,0.0000,9,119,0.0000,0,0
2021-01-26,Brazil,203070494,Goiás,7056495,0.0080,8563,56161,0.0000,11,130,0.0000,0,0
2021-01-27,Brazil,203070494,Goiás,7056495,0.0099,13472,69633,0.0000,28,158,0.0000,0,0
2021-01-28,Brazil,203070494,Goiás,7056495,0.0115,11737,81370,0.0000,15,173,0.0000,0,0
2021-01-29,Brazil,203070494,Goiás,7056495,0.0130,10377,91747,0.0000,20,193,0.0000,0,0
2021-01-30,Brazil,203070494,Goiás,7056495,0.0133,1873,93620,0.0000,3,196,0.0000,0,0
2021-01-31,Brazil,203070494,Goiás,7056495,0.0137,2873,96493,0.0000,2,198,0.0000,0,0
2021-02-01,Brazil,203070494,Goiás,7056495,0.0146,6410,102903,0.0000,120,318,0.0000,0,0
2021-02-02,Brazil,203070494,Goiás,7056495,0.0155,6227,109130,0.0000,25,343,0.0000,0,0
2021-02-03,Brazil,203070494,Goiás,7056495,0.0166,7839,116969,0.0001,37,380,0.0000,0,0
2021-02-04,Brazil,203070494,Goiás,7056495,0.0181,10533,127502,0.0001,25,405,0.0000,0,0
2021-02-05,Brazil,203070494,Goiás,7056495,0.0192,7911,135413,0.0001,17,422,0.0000,0,0
2021-02-06,Brazil,203070494,Goiás,7056495,0.0194,1546,136959,0.0001,99,521,0.0000,0,0
2021-02-07,Brazil,203070494,Goiás,7056495,0.0197,2012,138971,0.0001,49,570,0.0000,0,0
2021-02-08,Brazil,203070494,Goiás,7056495,0.0201,3057,142028,0.0001,88,658,0.0000,0,0
2021-02-09,Brazil,203070494,Goiás,7056495,0.0206,3476,145504,0.0001,337,995,0.0000,0,0
2021-02-10,Brazil,203070494,Goiás,7056495,0.0223,12061,157565,0.0003,1353,2348,0.0000,0,0
2021-02-11,Brazil,203070494,Goiás,7056495,0.0238,10649,168214,0.0005,1278,3626,0.0000,0,0
2021-02-12,Brazil,203070494,Goiás,7056495,0.0247,6336,174550,0.0008,1726,5352,0.0000,0,0
2021-02-13,Brazil,203070494,Goiás,7056495,0.0249,1033,175583,0.0008,28,5380,0.0000,0,0
2021-02-14,Brazil,203070494,Goiás,7056495,0.0249,109,175692,0.0008,15,5395,0.0000,0,0
2021-02-15,Brazil,203070494,Goiás,7056495,0.0257,5710,181402,0.0010,1559,6954,0.0000,0,0
2021-02-16,Brazil,203070494,Goiás,7056495,0.0261,2432,183834,0.0015,3295,10249,0.0000,0,0
2021-02-17,Brazil,203070494,Goiás,7056495,0.0268,5310,189144,0.0027,9006,19255,0.0000,0,0
2021-02-18,Brazil,203070494,Goiás,7056495,0.0272,3143,192287,0.0043,11283,30538,0.0000,0,0
2021-02-19,Brazil,203070494,Goiás,7056495,0.0276,2507,194794,0.0056,8930,39468,0.0000,0,0
2021-02-20,Brazil,203070494,Goiás,7056495,0.0277,609,195403,0.0057,795,40263,0.0000,0,0
2021-02-21,Brazil,203070494,Goiás,7056495,0.0277,158,195561,0.0057,171,40434,0.0000,0,0
2021-02-22,Brazil,203070494,Goiás,7056495,0.0281,2502,198063,0.0067,6839,47273,0.0000,0,0
2021-02-23,Brazil,203070494,Goiás,7056495,0.0284,2288,200351,0.0074,4895,52168,0.0000,0,0
2021-02-24,Brazil,203070494,Goiás,7056495,0.0287,2138,202489,0.0084,7188,59356,0.0000,0,0
2021-02-25,Brazil,203070494,Goiás,7056495,0.0289,1293,203782,0.0091,4998,64354,0.0000,0,0
2021-02-26,Brazil,203070494,Goiás,7056495,0.0307,12537,216319,0.0099,5734,70088,0.0000,0,0
2021-02-27,Brazil,203070494,Goiás,7056495,0.0318,8210,224529,0.0100,356,70444,0.0000,0,0
2021-02-28,Brazil,203070494,Goiás,7056495,0.0323,3067,227596,0.0101,611,71055,0.0000,0,0
2021-03-01,Brazil,203070494,Goiás,7056495,0.0341,13068,240664,0.0104,2249,73304,0.0000,0,0
2021-03-02,Brazil,203070494,Goiás,7056495,0.0357,11328,251992,0.0107,2399,75703,0.0000,0,0
2021-03-03,Brazil,203070494,Goiás,7056495,0.0373,11102,263094,0.0110,1736,77439,0.0000,0,0
2021-03-04,Brazil,203070494,Goiás,7056495,0.0390,12237,275331,0.0112,1301,78740,0.0000,0,0
2021-03-05,Brazil,203070494,Goiás,7056495,0.0405,10269,285600,0.0116,3209,81949,0.0000,0,0
2021-03-06,Brazil,203070494,Goiás,7056495,0.0407,1713,287313,0.0117,394,82343,0.0000,0,0
2021-03-07,Brazil,203070494,Goiás,7056495,0.0407,212,287525,0.0117,29,82372,0.0000,0,0
2021-03-08,Brazil,203070494,Goiás,7056495,0.0423,10770,298295,0.0120,2457,84829,0.0000,0,0
2021-03-09,Brazil,203070494,Goiás,7056495,0.0429,4196,302491,0.0125,3101,87930,0.0000,0,0
2021-03-10,Brazil,203070494,Goiás,7056495,0.0432,2412,304903,0.0138,9760,97690,0.0000,0,0
2021-03-11,Brazil,203070494,Goiás,7056495,0.0439,5165,310068,0.0151,8796,106486,0.0000,0,0
2021-03-12,Brazil,203070494,Goiás,7056495,0.0453,9510,319578,0.0155,3039,109525,0.0000,0,0
2021-03-13,Brazil,203070494,Goiás,7056495,0.0455,1276,320854,0.0156,711,110236,0.0000,0,0
2021-03-14,Brazil,203070494,Goiás,7056495,0.0455,232,321086,0.0156,109,110345,0.0000,0,0
2021-03-15,Brazil,203070494,Goiás,7056495,0.0471,11007,332093,0.0165,5980,116325,0.0000,0,0
2021-03-16,Brazil,203070494,Goiás,7056495,0.0483,8543,340636,0.0170,3534,119859,0.0000,0,0
2021-03-17,Brazil,203070494,Goiás,7056495,0.0487,3046,343682,0.0176,4608,124467,0.0000,0,0
2021-03-18,Brazil,203070494,Goiás,7056495,0.0502,10385,354067,0.0181,3252,127719,0.0000,0,0
2021-03-19,Brazil,203070494,Goiás,7056495,0.0522,14449,368516,0.0184,2329,130048,0.0000,0,0
2021-03-20,Brazil,203070494,Goiás,7056495,0.0528,3750,372266,0.0184,91,130139,0.0000,0,0
2021-03-21,Brazil,203070494,Goiás,7056495,0.0528,463,372729,0.0185,80,130219,0.0000,0,0
2021-03-22,Brazil,203070494,Goiás,7056495,0.0559,21604,394333,0.0188,2544,132763,0.0000,0,0
2021-03-23,Brazil,203070494,Goiás,7056495,0.0607,33764,428097,0.0191,1945,134708,0.0000,0,0
2021-03-24,Brazil,203070494,Goiás,7056495,0.0670,45037,473134,0.0196,3426,138134,0.0000,0,0
2021-03-25,Brazil,203070494,Goiás,7056495,0.0729,41127,514261,0.0202,4071,142205,0.0000,0,0
2021-03-26,Brazil,203070494,Goiás,7056495,0.0761,22916,537177,0.0208,4779,146984,0.0000,0,0
2021-03-27,Brazil,203070494,Goiás,7056495,0.0774,9311,546488,0.0210,1131,148115,0.0000,0,0
2021-03-28,Brazil,203070494,Goiás,7056495,0.0775,248,546736,0.0210,105,148220,0.0000,0,0
2021-03-29,Brazil,203070494,Goiás,7056495,0.0815,28057,574793,0.0217,4808,153028,0.0000,0,0
2021-03-30,Brazil,203070494,Goiás,7056495,0.0868,37830,612623,0.0222,3308,156336,0.0000,0,0
2021-03-31,Brazil,203070494,Goiás,7056495,0.0924,39219,651842,0.0227,4097,160433,0.0000,0,0
2021-04-01,Brazil,203070494,Goiás,7056495,0.0947,16628,668470,0.0231,2635,163068,0.0000,0,0
2021-04-02,Brazil,203070494,Goiás,7056495,0.0949,1515,669985,0.0232,910,163978,0.0000,0,0
2021-04-03,Brazil,203070494,Goiás,7056495,0.0951,1070,671055,0.0233,409,164387,0.0000,0,0
2021-04-04,Brazil,203070494,Goiás,7056495,0.0951,254,671309,0.0233,109,164496,0.0000,0,0
2021-04-05,Brazil,203070494,Goiás,7056495,0.0968,11489,682798,0.0250,12178,176674,0.0000,0,0
2021-04-06,Brazil,203070494,Goiás,7056495,0.0978,7410,690208,0.0259,6363,183037,0.0000,0,0
2021-04-07,Brazil,203070494,Goiás,7056495,0.0985,4630,694838,0.0269,6986,190023,0.0000,0,0
2021-04-08,Brazil,203070494,Goiás,7056495,0.0994,6659,701497,0.0280,7294,197317,0.0000,0,0
2021-04-09,Brazil,203070494,Goiás,7056495,0.1006,8216,709713,0.0293,9615,206932,0.0000,0,0
2021-04-10,Brazil,203070494,Goiás,7056495,0.1033,19080,728793,0.0300,4467,211399,0.0000,0,0
2021-04-11,Brazil,203070494,Goiás,7056495,0.1034,842,729635,0.0300,205,211604,0.0000,0,0
2021-04-12,Brazil,203070494,Goiás,7056495,0.1054,13917,743552,0.0315,10890,222494,0.0000,0,0
2021-04-13,Brazil,203070494,Goiás,7056495,0.1068,10100,753652,0.0327,8585,231079,0.0000,0,0
2021-04-14,Brazil,203070494,Goiás,7056495,0.1077,6268,759920,0.0337,6830,237909,0.0000,0,0
2021-04-15,Brazil,203070494,Goiás,7056495,0.1083,4253,764173,0.0349,8211,246120,0.0000,0,0
2021-04-16,Brazil,203070494,Goiás,7056495,0.1092,6673,770846,0.0376,18961,265081,0.0000,0,0
2021-04-17,Brazil,203070494,Goiás,7056495,0.1132,28178,799024,0.0386,7229,272310,0.0000,0,0
2021-04-18,Brazil,203070494,Goiás,7056495,0.1137,3093,802117,0.0387,861,273171,0.0000,0,0
2021-04-19,Brazil,203070494,Goiás,7056495,0.1174,26415,828532,0.0429,29705,302876,0.0000,0,0
2021-04-20,Brazil,203070494,Goiás,7056495,0.1213,27112,855644,0.0499,49565,352441,0.0000,0,0
2021-04-21,Brazil,203070494,Goiás,7056495,0.1221,6096,861740,0.0524,17327,369768,0.0000,0,0
2021-04-22,Brazil,203070494,Goiás,7056495,0.1235,10040,871780,0.0577,37082,406850,0.0000,0,0
2021-04-23,Brazil,203070494,Goiás,7056495,0.1248,9016,880796,0.0612,24794,431644,0.0000,0,0
2021-04-24,Brazil,203070494,Goiás,7056495,0.1272,17027,897823,0.0626,9781,441425,0.0000,0,0
2021-04-25,Brazil,203070494,Goiás,7056495,0.1275,1702,899525,0.0627,1062,442487,0.0000,0,0
2021-04-26,Brazil,203070494,Goiás,7056495,0.1308,23606,923131,0.0670,30314,472801,0.0000,0,0
2021-04-27,Brazil,203070494,Goiás,7056495,0.1339,21603,944734,0.0712,29498,502299,0.0000,0,0
2021-04-28,Brazil,203070494,Goiás,7056495,0.1356,12164,956898,0.0748,25576,527875,0.0000,0,0
2021-04-29,Brazil,203070494,Goiás,7056495,0.1367,7721,964619,0.0768,14206,542081,0.0000,0,0
2021-04-30,Brazil,203070494,Goiás,7056495,0.1401,23953,988572,0.0778,6689,548770,0.0000,0,0
2021-05-01,Brazil,203070494,Goiás,7056495,0.1419,12906,1001478,0.0779,882,549652,0.0000,0,0
2021-05-02,Brazil,203070494,Goiás,7056495,0.1421,1520,1002998,0.0779,225,549877,0.0000,0,0
2021-05-03,Brazil,203070494,Goiás,7056495,0.1461,28084,1031082,0.0790,7690,557567,0.0000,0,0
2021-05-04,Brazil,203070494,Goiás,7056495,0.1496,24750,1055832,0.0799,6316,563883,0.0000,0,0
2021-05-05,Brazil,203070494,Goiás,7056495,0.1530,23586,1079418,0.0811,8471,572354,0.0000,0,0
2021-05-06,Brazil,203070494,Goiás,7056495,0.1561,22425,1101843,0.0824,8799,581153,0.0000,0,0
2021-05-07,Brazil,203070494,Goiás,7056495,0.1592,21569,1123412,0.0835,8333,589486,0.0000,0,0
2021-05-08,Brazil,203070494,Goiás,7056495,0.1601,6261,1129673,0.0842,5012,594498,0.0000,0,0
2021-05-09,Brazil,203070494,Goiás,7056495,0.1601,95,1129768,0.0843,80,594578,0.0000,0,0
2021-05-10,Brazil,203070494,Goiás,7056495,0.1625,17154,1146922,0.0854,7874,602452,0.0000,0,0
2021-05-11,Brazil,203070494,Goiás,7056495,0.1649,16704,1163626,0.0861,5337,607789,0.0000,0,0
2021-05-12,Brazil,203070494,Goiás,7056495,0.1673,16920,1180546,0.0868,4726,612515,0.0000,0,0
2021-05-13,Brazil,203070494,Goiás,7056495,0.1702,20241,1200787,0.0871,2355,614870,0.0000,0,0
2021-05-14,Brazil,203070494,Goiás,7056495,0.1733,21791,1222578,0.0882,7798,622668,0.0000,0,0
2021-05-15,Brazil,203070494,Goiás,7056495,0.1755,15851,1238429,0.0896,9644,632312,0.0000,0,0
2021-05-16,Brazil,203070494,Goiás,7056495,0.1757,1291,1239720,0.0896,199,632511,0.0000,0,0
2021-05-17,Brazil,203070494,Goiás,7056495,0.1790,23617,1263337,0.0905,6276,638787,0.0000,0,0
2021-05-18,Brazil,203070494,Goiás,7056495,0.1829,27577,1290914,0.0911,3952,642739,0.0000,0,0
2021-05-19,Brazil,203070494,Goiás,7056495,0.1865,25165,1316079,0.0915,2872,645611,0.0000,0,0
2021-05-20,Brazil,203070494,Goiás,7056495,0.1905,28267,1344346,0.0919,2627,648238,0.0000,0,0
2021-05-21,Brazil,203070494,Goiás,7056495,0.1941,25604,1369950,0.0924,3609,651847,0.0000,0,0
2021-05-22,Brazil,203070494,Goiás,7056495,0.1952,7171,1377121,0.0925,1001,652848,0.0000,0,0
2021-05-23,Brazil,203070494,Goiás,7056495,0.1952,596,1377717,0.0926,262,653110,0.0000,0,0
2021-05-24,Brazil,203070494,Goiás,7056495,0.1976,16314,1394031,0.0934,5705,658815,0.0000,0,0
2021-05-25,Brazil,203070494,Goiás,7056495,0.2000,17294,1411325,0.0943,6496,665311,0.0000,0,0
2021-05-26,Brazil,203070494,Goiás,7056495,0.2028,19865,1431190,0.0951,5642,670953,0.0000,0,0
2021-05-27,Brazil,203070494,Goiás,7056495,0.2064,25390,1456580,0.0956,3479,674432,0.0000,0,0
2021-05-28,Brazil,203070494,Goiás,7056495,0.2113,34194,1490774,0.0959,2207,676639,0.0000,0,0
2021-05-29,Brazil,203070494,Goiás,7056495,0.2141,19736,1510510,0.0959,337,676976,0.0000,0,0
2021-05-30,Brazil,203070494,Goiás,7056495,0.2143,1901,1512411,0.0959,76,677052,0.0000,0,0
2021-05-31,Brazil,203070494,Goiás,7056495,0.2182,27188,1539599,0.0964,2957,680009,0.0000,0,0
2021-06-01,Brazil,203070494,Goiás,7056495,0.2236,38369,1577968,0.0972,5869,685878,0.0000,0,0
2021-06-02,Brazil,203070494,Goiás,7056495,0.2286,34797,1612765,0.0979,4915,690793,0.0000,0,0
2021-06-03,Brazil,203070494,Goiás,7056495,0.2298,8702,1621467,0.0980,682,691475,0.0000,0,0
2021-06-04,Brazil,203070494,Goiás,7056495,0.2331,23281,1644748,0.0983,1919,693394,0.0000,0,0
2021-06-05,Brazil,203070494,Goiás,7056495,0.2348,12366,1657114,0.0984,663,694057,0.0000,0,0
2021-06-06,Brazil,203070494,Goiás,7056495,0.2351,1673,1658787,0.0984,60,694117,0.0000,0,0
2021-06-07,Brazil,203070494,Goiás,7056495,0.2420,49013,1707800,0.0988,3373,697490,0.0000,0,0
2021-06-08,Brazil,203070494,Goiás,7056495,0.2509,62493,1770293,0.0992,2735,700225,0.0000,0,0
2021-06-09,Brazil,203070494,Goiás,7056495,0.2583,52327,1822620,0.0995,1903,702128,0.0000,0,0
2021-06-10,Brazil,203070494,Goiás,7056495,0.2665,58106,1880726,0.0997,1483,703611,0.0000,0,0
2021-06-11,Brazil,203070494,Goiás,7056495,0.2747,58043,1938769,0.0999,1121,704732,0.0000,0,0
2021-06-12,Brazil,203070494,Goiás,7056495,0.2781,23418,1962187,0.0999,155,704887,0.0000,0,0
2021-06-13,Brazil,203070494,Goiás,7056495,0.2784,1991,1964178,0.0999,25,704912,0.0000,0,0
2021-06-14,Brazil,203070494,Goiás,7056495,0.2864,56961,2021139,0.1001,1745,706657,0.0000,0,0
2021-06-15,Brazil,203070494,Goiás,7056495,0.2934,49319,2070458,0.1004,1904,708561,0.0000,0,0
2021-06-16,Brazil,203070494,Goiás,7056495,0.2975,29042,2099500,0.1007,1989,710550,0.0000,0,0
2021-06-17,Brazil,203070494,Goiás,7056495,0.3007,22461,2121961,0.1009,1710,712260,0.0000,0,0
2021-06-18,Brazil,203070494,Goiás,7056495,0.3035,19801,2141762,0.1011,1366,713626,0.0000,0,0
2021-06-19,Brazil,203070494,Goiás,7056495,0.3062,18586,2160348,0.1012,283,713909,0.0000,0,0
2021-06-20,Brazil,203070494,Goiás,7056495,0.3071,6562,2166910,0.1012,54,713963,0.0000,0,0
2021-06-21,Brazil,203070494,Goiás,7056495,0.3121,35557,2202467,0.1015,2092,716055,0.0000,0,0
2021-06-22,Brazil,203070494,Goiás,7056495,0.3180,41799,2244266,0.1021,4116,720171,0.0000,0,0
2021-06-23,Brazil,203070494,Goiás,7056495,0.3210,20944,2265210,0.1030,6443,726614,0.0000,0,0
2021-06-24,Brazil,203070494,Goiás,7056495,0.3234,16931,2282141,0.1034,3292,729906,0.0000,0,0
2021-06-25,Brazil,203070494,Goiás,7056495,0.3276,29318,2311459,0.1040,4129,734035,0.0000,0,0
2021-06-26,Brazil,203070494,Goiás,7056495,0.3310,24225,2335684,0.1041,268,734303,0.0000,0,0
2021-06-27,Brazil,203070494,Goiás,7056495,0.3316,4284,2339968,0.1041,53,734356,0.0000,0,0
2021-06-28,Brazil,203070494,Goiás,7056495,0.3389,51815,2391783,0.1046,3541,737897,0.0000,0,0
2021-06-29,Brazil,203070494,Goiás,7056495,0.3456,47086,2438869,0.1053,5435,743332,0.0000,0,0
2021-06-30,Brazil,203070494,Goiás,7056495,0.3493,26298,2465167,0.1060,4598,747930,0.0000,0,0
2021-07-01,Brazil,203070494,Goiás,7056495,0.3515,15145,2480312,0.1067,5004,752934,0.0000,0,0
2021-07-02,Brazil,203070494,Goiás,7056495,0.3566,36239,2516551,0.1073,3963,756897,0.0000,0,0
2021-07-03,Brazil,203070494,Goiás,7056495,0.3584,12482,2529033,0.1074,679,757576,0.0000,0,0
2021-07-04,Brazil,203070494,Goiás,7056495,0.3591,4939,2533972,0.1074,50,757626,0.0000,0,0
2021-07-05,Brazil,203070494,Goiás,7056495,0.3667,53817,2587789,0.1088,10450,768076,0.0000,0,0
2021-07-06,Brazil,203070494,Goiás,7056495,0.3761,65938,2653727,0.1102,9403,777479,0.0000,0,0
2021-07-07,Brazil,203070494,Goiás,7056495,0.3845,59705,2713432,0.1113,8173,785652,0.0000,0,0
2021-07-08,Brazil,203070494,Goiás,7056495,0.3902,39822,2753254,0.1125,8241,793893,0.0000,0,0
2021-07-09,Brazil,203070494,Goiás,7056495,0.3952,35498,2788752,0.1139,9870,803763,0.0000,0,0
2021-07-10,Brazil,203070494,Goiás,7056495,0.3983,21698,2810450,0.1144,3813,807576,0.0000,0,0
2021-07-11,Brazil,203070494,Goiás,7056495,0.3990,5153,2815603,0.1145,112,807688,0.0000,0,0
2021-07-12,Brazil,203070494,Goiás,7056495,0.4052,43425,2859028,0.1174,20608,828296,0.0000,0,0
2021-07-13,Brazil,203070494,Goiás,7056495,0.4102,35840,2894868,0.1201,19498,847794,0.0000,0,0
2021-07-14,Brazil,203070494,Goiás,7056495,0.4143,28759,2923627,0.1220,13215,861009,0.0000,0,0
2021-07-15,Brazil,203070494,Goiás,7056495,0.4163,14079,2937706,0.1239,13143,874152,0.0000,0,0
2021-07-16,Brazil,203070494,Goiás,7056495,0.4182,13171,2950877,0.1257,13048,887200,0.0000,0,0
2021-07-17,Brazil,203070494,Goiás,7056495,0.4219,25985,2976862,0.1263,3987,891187,0.0000,0,0
2021-07-18,Brazil,203070494,Goiás,7056495,0.4228,6666,2983528,0.1263,393,891580,0.0000,0,0
2021-07-19,Brazil,203070494,Goiás,7056495,0.4288,42000,3025528,0.1302,26836,918416,0.0000,0,0
2021-07-20,Brazil,203070494,Goiás,7056495,0.4330,30062,3055590,0.1337,25286,943702,0.0000,0,0
2021-07-21,Brazil,203070494,Goiás,7056495,0.4371,28632,3084222,0.1365,19413,963115,0.0000,0,0
2021-07-22,Brazil,203070494,Goiás,7056495,0.4422,35929,3120151,0.1390,17491,980606,0.0000,0,0
2021-07-23,Brazil,203070494,Goiás,7056495,0.4490,48243,3168394,0.1421,22454,1003060,0.0000,0,0
2021-07-24,Brazil,203070494,Goiás,7056495,0.4529,27681,3196075,0.1426,3549,1006609,0.0000,0,0
2021-07-25,Brazil,203070494,Goiás,7056495,0.4534,3423,3199498,0.1428,1072,1007681,0.0000,0,0
2021-07-26,Brazil,203070494,Goiás,7056495,0.4588,38374,3237872,0.1467,27343,1035024,0.0000,0,0
2021-07-27,Brazil,203070494,Goiás,7056495,0.4634,32347,3270219,0.1520,37737,1072761,0.0000,0,0
2021-07-28,Brazil,203070494,Goiás,7056495,0.4664,20776,3290995,0.1562,29740,1102501,0.0000,0,0
2021-07-29,Brazil,203070494,Goiás,7056495,0.4700,25357,3316352,0.1596,23856,1126357,0.0000,0,0
2021-07-30,Brazil,203070494,Goiás,7056495,0.4757,40542,3356894,0.1624,19598,1145955,0.0000,0,0
2021-07-31,Brazil,203070494,Goiás,7056495,0.4776,13323,3370217,0.1630,4602,1150557,0.0000,0,0
2021-08-01,Brazil,203070494,Goiás,7056495,0.4781,3242,3373459,0.1633,1755,1152312,0.0000,0,0
2021-08-02,Brazil,203070494,Goiás,7056495,0.4831,35495,3408954,0.1663,21519,1173831,0.0000,0,0
2021-08-03,Brazil,203070494,Goiás,7056495,0.4899,47902,3456856,0.1697,23461,1197292,0.0000,0,0
2021-08-04,Brazil,203070494,Goiás,7056495,0.4971,51192,3508048,0.1726,20640,1217932,0.0000,0,0
2021-08-05,Brazil,203070494,Goiás,7056495,0.5014,30324,3538372,0.1761,24757,1242689,0.0000,0,0
2021-08-06,Brazil,203070494,Goiás,7056495,0.5066,36569,3574941,0.1790,20454,1263143,0.0000,0,0
2021-08-07,Brazil,203070494,Goiás,7056495,0.5111,31338,3606279,0.1799,6513,1269656,0.0000,0,0
2021-08-08,Brazil,203070494,Goiás,7056495,0.5122,8137,3614416,0.1800,650,1270306,0.0000,0,0
2021-08-09,Brazil,203070494,Goiás,7056495,0.5195,51587,3666003,0.1837,25671,1295977,0.0000,0,0
2021-08-10,Brazil,203070494,Goiás,7056495,0.5280,59922,3725925,0.1876,27651,1323628,0.0000,0,0
2021-08-11,Brazil,203070494,Goiás,7056495,0.5356,53861,3779786,0.1908,22925,1346553,0.0000,0,0
2021-08-12,Brazil,203070494,Goiás,7056495,0.5424,47902,3827688,0.1942,23639,1370192,0.0000,0,0
2021-08-13,Brazil,203070494,Goiás,7056495,0.5495,50128,3877816,0.1971,20854,1391046,0.0000,0,0
2021-08-14,Brazil,203070494,Goiás,7056495,0.5539,30823,3908639,0.1979,5116,1396162,0.0000,0,0
2021-08-15,Brazil,203070494,Goiás,7056495,0.5549,7113,3915752,0.1980,1200,1397362,0.0000,0,0
2021-08-16,Brazil,203070494,Goiás,7056495,0.5608,41706,3957458,0.2012,22242,1419604,0.0000,0,0
2021-08-17,Brazil,203070494,Goiás,7056495,0.5687,55663,4013121,0.2044,22632,1442236,0.0000,0,0
2021-08-18,Brazil,203070494,Goiás,7056495,0.5760,51620,4064741,0.2084,28054,1470290,0.0000,0,0
2021-08-19,Brazil,203070494,Goiás,7056495,0.5842,57970,4122711,0.2123,27807,1498097,0.0000,0,0
2021-08-20,Brazil,203070494,Goiás,7056495,0.5903,42858,4165569,0.2165,29535,1527632,0.0000,0,0
2021-08-21,Brazil,203070494,Goiás,7056495,0.5950,32851,4198420,0.2180,10598,1538230,0.0000,0,0
2021-08-22,Brazil,203070494,Goiás,7056495,0.5954,3166,4201586,0.2181,778,1539008,0.0000,0,0
2021-08-23,Brazil,203070494,Goiás,7056495,0.5997,30451,4232037,0.2221,28172,1567180,0.0000,0,0
2021-08-24,Brazil,203070494,Goiás,7056495,0.6031,23967,4256004,0.2262,29142,1596322,0.0000,0,0
2021-08-25,Brazil,203070494,Goiás,7056495,0.6064,23401,4279405,0.2304,29200,1625522,0.0000,0,0
2021-08-26,Brazil,203070494,Goiás,7056495,0.6158,65797,4345202,0.2349,31791,1657313,0.0000,0,0
2021-08-27,Brazil,203070494,Goiás,7056495,0.6241,58823,4404025,0.2402,37655,1694968,0.0000,0,0
2021-08-28,Brazil,203070494,Goiás,7056495,0.6292,35970,4439995,0.2417,10318,1705286,0.0000,0,0
2021-08-29,Brazil,203070494,Goiás,7056495,0.6295,2308,4442303,0.2418,1327,1706613,0.0000,0,0
2021-08-30,Brazil,203070494,Goiás,7056495,0.6346,35931,4478234,0.2499,56855,1763468,0.0000,0,0
2021-08-31,Brazil,203070494,Goiás,7056495,0.6389,30471,4508705,0.2571,50968,1814436,0.0000,0,0
2021-09-01,Brazil,203070494,Goiás,7056495,0.6423,23834,4532539,0.2636,45851,1860287,0.0000,0,0
2021-09-02,Brazil,203070494,Goiás,7056495,0.6474,35606,4568145,0.2701,45799,1906086,0.0000,0,0
2021-09-03,Brazil,203070494,Goiás,7056495,0.6504,21224,4589369,0.2778,53870,1959956,0.0000,0,0
2021-09-04,Brazil,203070494,Goiás,7056495,0.6514,7349,4596718,0.2800,15814,1975770,0.0000,0,0
2021-09-05,Brazil,203070494,Goiás,7056495,0.6515,598,4597316,0.2804,2956,1978726,0.0000,0,0
2021-09-06,Brazil,203070494,Goiás,7056495,0.6520,3545,4600861,0.2821,11752,1990478,0.0000,0,0
2021-09-07,Brazil,203070494,Goiás,7056495,0.6521,475,4601336,0.2825,3136,1993614,0.0000,0,0
2021-09-08,Brazil,203070494,Goiás,7056495,0.6544,16306,4617642,0.2906,56925,2050539,0.0000,0,0
2021-09-09,Brazil,203070494,Goiás,7056495,0.6591,33346,4650988,0.2974,48072,2098611,0.0000,0,0
2021-09-10,Brazil,203070494,Goiás,7056495,0.6636,31487,4682475,0.3025,35701,2134312,0.0000,0,0
2021-09-11,Brazil,203070494,Goiás,7056495,0.6650,9985,4692460,0.3043,12827,2147139,0.0000,0,0
2021-09-12,Brazil,203070494,Goiás,7056495,0.6651,866,4693326,0.3048,3644,2150783,0.0000,0,0
2021-09-13,Brazil,203070494,Goiás,7056495,0.6676,17279,4710605,0.3110,43587,2194370,0.0000,0,0
2021-09-14,Brazil,203070494,Goiás,7056495,0.6697,14946,4725551,0.3177,47250,2241620,0.0000,0,0
2021-09-15,Brazil,203070494,Goiás,7056495,0.6725,19648,4745199,0.3224,33063,2274683,0.0000,0,0
2021-09-16,Brazil,203070494,Goiás,7056495,0.6774,34914,4780113,0.3263,28084,2302767,0.0000,0,0
2021-09-17,Brazil,203070494,Goiás,7056495,0.6825,36232,4816345,0.3302,27047,2329814,0.0000,0,0
2021-09-18,Brazil,203070494,Goiás,7056495,0.6844,13243,4829588,0.3319,12275,2342089,0.0000,0,0
2021-09-19,Brazil,203070494,Goiás,7056495,0.6847,2102,4831690,0.3323,2846,2344935,0.0000,0,0
2021-09-20,Brazil,203070494,Goiás,7056495,0.6877,21358,4853048,0.3368,31791,2376726,0.0000,0,0
2021-09-21,Brazil,203070494,Goiás,7056495,0.6905,19535,4872583,0.3417,34561,2411287,0.0000,0,0
2021-09-22,Brazil,203070494,Goiás,7056495,0.6932,19176,4891759,0.3454,25846,2437133,0.0000,0,0
2021-09-23,Brazil,203070494,Goiás,7056495,0.6966,23657,4915416,0.3495,29255,2466388,0.0000,0,0
2021-09-24,Brazil,203070494,Goiás,7056495,0.6995,20747,4936163,0.3537,29347,2495735,0.0000,0,0
2021-09-25,Brazil,203070494,Goiás,7056495,0.7025,20672,4956835,0.3569,22667,2518402,0.0000,0,0
2021-09-26,Brazil,203070494,Goiás,7056495,0.7027,1938,4958773,0.3571,1748,2520150,0.0000,0,0
2021-09-27,Brazil,203070494,Goiás,7056495,0.7050,15776,4974549,0.3626,38760,2558910,0.0000,0,0
2021-09-28,Brazil,203070494,Goiás,7056495,0.7076,18663,4993212,0.3681,38764,2597674,0.0000,0,0
2021-09-29,Brazil,203070494,Goiás,7056495,0.7101,17597,5010809,0.3733,36654,2634328,0.0000,0,0
2021-09-30,Brazil,203070494,Goiás,7056495,0.7135,23757,5034566,0.3779,32295,2666623,0.0000,0,0
2021-10-01,Brazil,203070494,Goiás,7056495,0.7163,19873,5054439,0.3818,27756,2694379,0.0000,0,0
2021-10-02,Brazil,203070494,Goiás,7056495,0.7176,9223,5063662,0.3830,8261,2702640,0.0000,0,0
2021-10-03,Brazil,203070494,Goiás,7056495,0.7177,927,5064589,0.3833,1876,2704516,0.0000,0,0
2021-10-04,Brazil,203070494,Goiás,7056495,0.7200,16207,5080796,0.3874,29430,2733946,0.0000,0,0
2021-10-05,Brazil,203070494,Goiás,7056495,0.7221,14551,5095347,0.3917,30089,2764035,0.0000,0,0
2021-10-06,Brazil,203070494,Goiás,7056495,0.7240,13531,5108878,0.3960,30381,2794416,0.0000,0,0
2021-10-07,Brazil,203070494,Goiás,7056495,0.7261,14529,5123407,0.4006,32565,2826981,0.0000,0,0
2021-10-08,Brazil,203070494,Goiás,7056495,0.7280,13654,5137061,0.4049,30333,2857314,0.0000,0,0
2021-10-09,Brazil,203070494,Goiás,7056495,0.7287,4998,5142059,0.4062,8827,2866141,0.0000,0,0
2021-10-10,Brazil,203070494,Goiás,7056495,0.7288,424,5142483,0.4064,1374,2867515,0.0000,0,0
2021-10-11,Brazil,203070494,Goiás,7056495,0.7294,4418,5146901,0.4076,8450,2875965,0.0000,0,0
2021-10-12,Brazil,203070494,Goiás,7056495,0.7294,314,5147215,0.4077,1008,2876973,0.0000,0,0
2021-10-13,Brazil,203070494,Goiás,7056495,0.7309,10548,5157763,0.4142,45726,2922699,0.0000,0,0
2021-10-14,Brazil,203070494,Goiás,7056495,0.7326,12068,5169831,0.4203,42909,2965608,0.0000,0,0
2021-10-15,Brazil,203070494,Goiás,7056495,0.7343,11490,5181321,0.4253,35422,3001030,0.0000,0,0
2021-10-16,Brazil,203070494,Goiás,7056495,0.7354,7867,5189188,0.4271,12938,3013968,0.0000,0,0
2021-10-17,Brazil,203070494,Goiás,7056495,0.7354,366,5189554,0.4274,1822,3015790,0.0000,0,0
2021-10-18,Brazil,203070494,Goiás,7056495,0.7365,7465,5197019,0.4327,37755,3053545,0.0000,0,0
2021-10-19,Brazil,203070494,Goiás,7056495,0.7377,8211,5205230,0.4379,36337,3089882,0.0000,0,0
2021-10-20,Brazil,203070494,Goiás,7056495,0.7386,6721,5211951,0.4424,32192,3122074,0.0000,0,0
2021-10-21,Brazil,203070494,Goiás,7056495,0.7409,16449,5228400,0.4467,29779,3151853,0.0000,0,0
2021-10-22,Brazil,203070494,Goiás,7056495,0.7429,14208,5242608,0.4503,25990,3177843,0.0000,0,0
2021-10-23,Brazil,203070494,Goiás,7056495,0.7434,3083,5245691,0.4520,11849,3189692,0.0000,0,0
2021-10-24,Brazil,203070494,Goiás,7056495,0.7435,539,5246230,0.4523,1912,3191604,0.0000,0,0
2021-10-25,Brazil,203070494,Goiás,7056495,0.7453,12744,5258974,0.4570,33213,3224817,0.0000,0,0
2021-10-26,Brazil,203070494,Goiás,7056495,0.7465,8361,5267335,0.4624,37903,3262720,0.0000,0,0
2021-10-27,Brazil,203070494,Goiás,7056495,0.7476,8336,5275671,0.4675,36485,3299205,0.0000,0,0
2021-10-28,Brazil,203070494,Goiás,7056495,0.7488,8166,5283837,0.4721,32177,3331382,0.0000,0,0
2021-10-29,Brazil,203070494,Goiás,7056495,0.7495,5280,5289117,0.4760,27390,3358772,0.0000,0,0
2021-10-30,Brazil,203070494,Goiás,7056495,0.7498,2187,5291304,0.4773,8972,3367744,0.0000,0,0
2021-10-31,Brazil,203070494,Goiás,7056495,0.7499,290,5291594,0.4774,1205,3368949,0.0000,0,0
2021-11-01,Brazil,203070494,Goiás,7056495,0.7500,948,5292542,0.4780,3767,3372716,0.0000,0,0
2021-11-02,Brazil,203070494,Goiás,7056495,0.7501,595,5293137,0.4783,2083,3374799,0.0000,0,0
2021-11-03,Brazil,203070494,Goiás,7056495,0.7511,6649,5299786,0.4846,44748,3419547,0.0000,0,0
2021-11-04,Brazil,203070494,Goiás,7056495,0.7520,6525,5306311,0.4905,41888,3461435,0.0000,0,0
2021-11-05,Brazil,203070494,Goiás,7056495,0.7527,5338,5311649,0.4958,36893,3498328,0.0000,0,0
2021-11-06,Brazil,203070494,Goiás,7056495,0.7529,1533,5313182,0.4972,9972,3508300,0.0000,0,0
2021-11-07,Brazil,203070494,Goiás,7056495,0.7530,218,5313400,0.4974,1683,3509983,0.0000,0,0
2021-11-08,Brazil,203070494,Goiás,7056495,0.7536,4567,5317967,0.5024,34956,3544939,0.0000,0,0
2021-11-09,Brazil,203070494,Goiás,7056495,0.7542,3962,5321929,0.5072,34039,3578978,0.0000,0,0
2021-11-10,Brazil,203070494,Goiás,7056495,0.7549,5247,5327176,0.5127,38777,3617755,0.0000,0,0
2021-11-11,Brazil,203070494,Goiás,7056495,0.7562,9079,5336255,0.5181,38060,3655815,0.0000,0,0
2021-11-12,Brazil,203070494,Goiás,7056495,0.7576,9508,5345763,0.5228,33515,3689330,0.0000,0,0
2021-11-13,Brazil,203070494,Goiás,7056495,0.7578,1612,5347375,0.5243,10267,3699597,0.0000,0,0
2021-11-14,Brazil,203070494,Goiás,7056495,0.7578,147,5347522,0.5245,1320,3700917,0.0000,0,0
2021-11-15,Brazil,203070494,Goiás,7056495,0.7579,277,5347799,0.5248,2222,3703139,0.0000,0,0
2021-11-16,Brazil,203070494,Goiás,7056495,0.7588,6955,5354754,0.5301,37254,3740393,0.0000,0,0
2021-11-17,Brazil,203070494,Goiás,7056495,0.7598,6702,5361456,0.5353,37286,3777679,0.0000,0,0
2021-11-18,Brazil,203070494,Goiás,7056495,0.7609,7836,5369292,0.5410,40230,3817909,0.0000,0,0
2021-11-19,Brazil,203070494,Goiás,7056495,0.7617,5895,5375187,0.5466,39164,3857073,0.0000,0,0
2021-11-20,Brazil,203070494,Goiás,7056495,0.7620,1786,5376973,0.5482,11139,3868212,0.0000,0,0
2021-11-21,Brazil,203070494,Goiás,7056495,0.7621,441,5377414,0.5484,1858,3870070,0.0000,0,0
2021-11-22,Brazil,203070494,Goiás,7056495,0.7628,5413,5382827,0.5536,36560,3906630,0.0000,0,0
2021-11-23,Brazil,203070494,Goiás,7056495,0.7636,5436,5388263,0.5586,34874,3941504,0.0000,0,0
2021-11-24,Brazil,203070494,Goiás,7056495,0.7643,5046,5393309,0.5629,30380,3971884,0.0000,0,0
2021-11-25,Brazil,203070494,Goiás,7056495,0.7651,5571,5398880,0.5678,34702,4006586,0.0000,0,0
2021-11-26,Brazil,203070494,Goiás,7056495,0.7658,5249,5404129,0.5719,29073,4035659,0.0000,0,0
2021-11-27,Brazil,203070494,Goiás,7056495,0.7660,1111,5405240,0.5729,7230,4042889,0.0000,0,0
2021-11-28,Brazil,203070494,Goiás,7056495,0.7660,87,5405327,0.5730,545,4043434,0.0000,0,0
2021-11-29,Brazil,203070494,Goiás,7056495,0.7667,4589,5409916,0.5768,27053,4070487,0.0000,0,0
2021-11-30,Brazil,203070494,Goiás,7056495,0.7673,4668,5414584,0.5810,29263,4099750,0.0000,0,0
2021-12-01,Brazil,203070494,Goiás,7056495,0.7681,5777,5420361,0.5848,26888,4126638,0.0000,1,1
2021-12-02,Brazil,203070494,Goiás,7056495,0.7689,5566,5425927,0.5891,30227,4156865,0.0000,0,1
2021-12-03,Brazil,203070494,Goiás,7056495,0.7696,4911,5430838,0.5930,27833,4184698,0.0000,0,1
2021-12-04,Brazil,203070494,Goiás,7056495,0.7698,1167,5432005,0.5938,5796,4190494,0.0000,0,1
2021-12-05,Brazil,203070494,Goiás,7056495,0.7698,110,5432115,0.5939,498,4190992,0.0000,0,1
2021-12-06,Brazil,203070494,Goiás,7056495,0.7706,5422,5437537,0.5974,24407,4215399,0.0000,0,1
2021-12-07,Brazil,203070494,Goiás,7056495,0.7713,4902,5442439,0.6006,22723,4238122,0.0000,0,1
2021-12-08,Brazil,203070494,Goiás,7056495,0.7719,4628,5447067,0.6035,20491,4258613,0.0000,0,1
2021-12-09,Brazil,203070494,Goiás,7056495,0.7727,5249,5452316,0.6070,24921,4283534,0.0000,0,1
2021-12-10,Brazil,203070494,Goiás,7056495,0.7731,3406,5455722,0.6098,19653,4303187,0.0000,0,1
2021-12-11,Brazil,203070494,Goiás,7056495,0.7734,1467,5457189,0.6106,5253,4308440,0.0000,0,1
2021-12-12,Brazil,203070494,Goiás,7056495,0.7734,285,5457474,0.6107,1286,4309726,0.0000,0,1
2021-12-13,Brazil,203070494,Goiás,7056495,0.7739,3387,5460861,0.6135,19336,4329062,0.0000,0,1
2021-12-14,Brazil,203070494,Goiás,7056495,0.7743,3175,5464036,0.6164,20276,4349338,0.0000,0,1
2021-12-15,Brazil,203070494,Goiás,7056495,0.7748,3148,5467184,0.6188,17088,4366426,0.0000,0,1
2021-12-16,Brazil,203070494,Goiás,7056495,0.7752,3213,5470397,0.6219,21919,4388345,0.0000,0,1
2021-12-17,Brazil,203070494,Goiás,7056495,0.7756,2957,5473354,0.6246,19037,4407382,0.0000,0,1
2021-12-18,Brazil,203070494,Goiás,7056495,0.7757,715,5474069,0.6251,3851,4411233,0.0000,0,1
2021-12-19,Brazil,203070494,Goiás,7056495,0.7758,209,5474278,0.6253,996,4412229,0.0000,0,1
2021-12-20,Brazil,203070494,Goiás,7056495,0.7762,3055,5477333,0.6274,15094,4427323,0.0000,0,1
2021-12-21,Brazil,203070494,Goiás,7056495,0.7766,2401,5479734,0.6294,14222,4441545,0.0000,0,1
2021-12-22,Brazil,203070494,Goiás,7056495,0.7768,1865,5481599,0.6311,11794,4453339,0.0000,0,1
2021-12-23,Brazil,203070494,Goiás,7056495,0.7770,1362,5482961,0.6323,8742,4462081,0.0000,0,1
2021-12-24,Brazil,203070494,Goiás,7056495,0.7770,47,5483008,0.6324,312,4462393,0.0000,0,1
2021-12-25,Brazil,203070494,Goiás,7056495,0.7770,7,5483015,0.6324,62,4462455,0.0000,0,1
2021-12-26,Brazil,203070494,Goiás,7056495,0.7770,30,5483045,0.6324,114,4462569,0.0000,0,1
2021-12-27,Brazil,203070494,Goiás,7056495,0.7772,1353,5484398,0.6336,8240,4470809,0.0000,0,1
2021-12-28,Brazil,203070494,Goiás,7056495,0.7774,1674,5486072,0.6349,9470,4480279,0.0000,0,1
2021-12-29,Brazil,203070494,Goiás,7056495,0.7777,1509,5487581,0.6360,7717,4487996,0.0000,0,1
2021-12-30,Brazil,203070494,Goiás,7056495,0.7779,1435,5489016,0.6369,6100,4494096,0.0000,0,1
2021-12-31,Brazil,203070494,Goiás,7056495,0.7779,38,5489054,0.6369,383,4494479,0.0000,0,1
2021-01-02,Brazil,203070494,Maranhão,6775805,0.0000,1,1,0.0000,0,0,0.0000,0,0
2021-01-03,Brazil,203070494,Maranhão,6775805,0.0000,1,2,0.0000,3,3,0.0000,0,0
2021-01-04,Brazil,203070494,Maranhão,6775805,0.0000,0,2,0.0000,1,4,0.0000,0,0
2021-01-05,Brazil,203070494,Maranhão,6775805,0.0000,10,12,0.0000,0,4,0.0000,0,0
2021-01-08,Brazil,203070494,Maranhão,6775805,0.0000,2,14,0.0000,0,4,0.0000,0,0
2021-01-15,Brazil,203070494,Maranhão,6775805,0.0000,9,23,0.0000,0,4,0.0000,0,0
2021-01-17,Brazil,203070494,Maranhão,6775805,0.0000,42,65,0.0000,16,20,0.0000,0,0
2021-01-18,Brazil,203070494,Maranhão,6775805,0.0000,30,95,0.0000,4,24,0.0000,0,0
2021-01-19,Brazil,203070494,Maranhão,6775805,0.0001,857,952,0.0000,6,30,0.0000,0,0
2021-01-20,Brazil,203070494,Maranhão,6775805,0.0011,6692,7644,0.0000,7,37,0.0000,0,0
2021-01-21,Brazil,203070494,Maranhão,6775805,0.0028,11115,18759,0.0000,16,53,0.0000,0,0
2021-01-22,Brazil,203070494,Maranhão,6775805,0.0043,10104,28863,0.0000,27,80,0.0000,0,0
2021-01-23,Brazil,203070494,Maranhão,6775805,0.0047,3038,31901,0.0000,12,92,0.0000,0,0
2021-01-24,Brazil,203070494,Maranhão,6775805,0.0049,1181,33082,0.0000,7,99,0.0000,0,0
2021-01-25,Brazil,203070494,Maranhão,6775805,0.0062,8730,41812,0.0000,10,109,0.0000,0,0
2021-01-26,Brazil,203070494,Maranhão,6775805,0.0075,8820,50632,0.0000,16,125,0.0000,0,0
2021-01-27,Brazil,203070494,Maranhão,6775805,0.0086,7370,58002,0.0000,8,133,0.0000,0,0
2021-01-28,Brazil,203070494,Maranhão,6775805,0.0094,5636,63638,0.0000,23,156,0.0000,0,0
2021-01-29,Brazil,203070494,Maranhão,6775805,0.0102,5566,69204,0.0000,9,165,0.0000,0,0
2021-01-30,Brazil,203070494,Maranhão,6775805,0.0105,2205,71409,0.0000,5,170,0.0000,0,0
2021-01-31,Brazil,203070494,Maranhão,6775805,0.0106,167,71576,0.0000,2,172,0.0000,0,0
2021-02-01,Brazil,203070494,Maranhão,6775805,0.0114,5594,77170,0.0000,18,190,0.0000,0,0
2021-02-02,Brazil,203070494,Maranhão,6775805,0.0122,5369,82539,0.0000,27,217,0.0000,0,0
2021-02-03,Brazil,203070494,Maranhão,6775805,0.0131,5950,88489,0.0000,70,287,0.0000,0,0
2021-02-04,Brazil,203070494,Maranhão,6775805,0.0137,4443,92932,0.0001,98,385,0.0000,0,0
2021-02-05,Brazil,203070494,Maranhão,6775805,0.0142,3357,96289,0.0001,462,847,0.0000,0,0
2021-02-06,Brazil,203070494,Maranhão,6775805,0.0144,1501,97790,0.0001,49,896,0.0000,0,0
2021-02-07,Brazil,203070494,Maranhão,6775805,0.0145,186,97976,0.0001,58,954,0.0000,0,0
2021-02-08,Brazil,203070494,Maranhão,6775805,0.0149,3252,101228,0.0002,650,1604,0.0000,0,0
2021-02-09,Brazil,203070494,Maranhão,6775805,0.0155,3606,104834,0.0005,1582,3186,0.0000,0,0
2021-02-10,Brazil,203070494,Maranhão,6775805,0.0161,4423,109257,0.0011,4454,7640,0.0000,0,0
2021-02-11,Brazil,203070494,Maranhão,6775805,0.0170,5756,115013,0.0021,6909,14549,0.0000,0,0
2021-02-12,Brazil,203070494,Maranhão,6775805,0.0177,5114,120127,0.0031,6494,21043,0.0000,0,0
2021-02-13,Brazil,203070494,Maranhão,6775805,0.0179,1478,121605,0.0034,1881,22924,0.0000,0,0
2021-02-14,Brazil,203070494,Maranhão,6775805,0.0180,92,121697,0.0034,202,23126,0.0000,0,0
2021-02-15,Brazil,203070494,Maranhão,6775805,0.0185,3982,125679,0.0044,6889,30015,0.0000,0,0
2021-02-16,Brazil,203070494,Maranhão,6775805,0.0191,3763,129442,0.0051,4250,34265,0.0000,0,0
2021-02-17,Brazil,203070494,Maranhão,6775805,0.0198,4935,134377,0.0056,3499,37764,0.0000,0,0
2021-02-18,Brazil,203070494,Maranhão,6775805,0.0205,4551,138928,0.0062,4269,42033,0.0000,0,0
2021-02-19,Brazil,203070494,Maranhão,6775805,0.0211,3892,142820,0.0067,3545,45578,0.0000,0,0
2021-02-20,Brazil,203070494,Maranhão,6775805,0.0212,1120,143940,0.0068,427,46005,0.0000,0,0
2021-02-21,Brazil,203070494,Maranhão,6775805,0.0213,179,144119,0.0069,415,46420,0.0000,0,0
2021-02-22,Brazil,203070494,Maranhão,6775805,0.0217,2664,146783,0.0073,2761,49181,0.0000,0,0
2021-02-23,Brazil,203070494,Maranhão,6775805,0.0222,3582,150365,0.0076,2121,51302,0.0000,0,0
2021-02-24,Brazil,203070494,Maranhão,6775805,0.0226,2548,152913,0.0078,1764,53066,0.0000,0,0
2021-02-25,Brazil,203070494,Maranhão,6775805,0.0231,3312,156225,0.0082,2828,55894,0.0000,0,0
2021-02-26,Brazil,203070494,Maranhão,6775805,0.0236,3925,160150,0.0085,1905,57799,0.0000,0,0
2021-02-27,Brazil,203070494,Maranhão,6775805,0.0240,2802,162952,0.0087,1091,58890,0.0000,0,0
2021-02-28,Brazil,203070494,Maranhão,6775805,0.0242,1143,164095,0.0087,99,58989,0.0000,0,0
2021-03-01,Brazil,203070494,Maranhão,6775805,0.0252,6444,170539,0.0089,1434,60423,0.0000,0,0
2021-03-02,Brazil,203070494,Maranhão,6775805,0.0266,9877,180416,0.0092,1759,62182,0.0000,0,0
2021-03-03,Brazil,203070494,Maranhão,6775805,0.0283,11049,191465,0.0095,2207,64389,0.0000,0,0
2021-03-04,Brazil,203070494,Maranhão,6775805,0.0298,10760,202225,0.0100,3040,67429,0.0000,0,0
2021-03-05,Brazil,203070494,Maranhão,6775805,0.0311,8658,210883,0.0105,3474,70903,0.0000,0,0
2021-03-06,Brazil,203070494,Maranhão,6775805,0.0315,2610,213493,0.0106,817,71720,0.0000,0,0
2021-03-07,Brazil,203070494,Maranhão,6775805,0.0317,1077,214570,0.0106,57,71777,0.0000,0,0
2021-03-08,Brazil,203070494,Maranhão,6775805,0.0328,7586,222156,0.0111,3319,75096,0.0000,0,0
2021-03-09,Brazil,203070494,Maranhão,6775805,0.0337,6367,228523,0.0115,2938,78034,0.0000,0,0
2021-03-10,Brazil,203070494,Maranhão,6775805,0.0350,8619,237142,0.0120,3502,81536,0.0000,0,0
2021-03-11,Brazil,203070494,Maranhão,6775805,0.0362,7836,244978,0.0124,2497,84033,0.0000,0,0
2021-03-12,Brazil,203070494,Maranhão,6775805,0.0369,5246,250224,0.0128,2755,86788,0.0000,0,0
2021-03-13,Brazil,203070494,Maranhão,6775805,0.0372,1525,251749,0.0129,375,87163,0.0000,0,0
2021-03-14,Brazil,203070494,Maranhão,6775805,0.0372,81,251830,0.0129,70,87233,0.0000,0,0
2021-03-15,Brazil,203070494,Maranhão,6775805,0.0377,3948,255778,0.0133,2927,90160,0.0000,0,0
2021-03-16,Brazil,203070494,Maranhão,6775805,0.0385,5060,260838,0.0137,2938,93098,0.0000,0,0
2021-03-17,Brazil,203070494,Maranhão,6775805,0.0399,9454,270292,0.0140,2004,95102,0.0000,0,0
2021-03-18,Brazil,203070494,Maranhão,6775805,0.0414,10232,280524,0.0144,2233,97335,0.0000,0,0
2021-03-19,Brazil,203070494,Maranhão,6775805,0.0424,6583,287107,0.0146,1842,99177,0.0000,0,0
2021-03-20,Brazil,203070494,Maranhão,6775805,0.0427,2207,289314,0.0147,222,99399,0.0000,0,0
2021-03-21,Brazil,203070494,Maranhão,6775805,0.0427,241,289555,0.0147,121,99520,0.0000,0,0
2021-03-22,Brazil,203070494,Maranhão,6775805,0.0443,10554,300109,0.0151,2972,102492,0.0000,0,0
2021-03-23,Brazil,203070494,Maranhão,6775805,0.0472,19874,319983,0.0156,3236,105728,0.0000,0,0
2021-03-24,Brazil,203070494,Maranhão,6775805,0.0500,19021,339004,0.0160,2995,108723,0.0000,0,0
2021-03-25,Brazil,203070494,Maranhão,6775805,0.0525,16923,355927,0.0166,3824,112547,0.0000,0,0
2021-03-26,Brazil,203070494,Maranhão,6775805,0.0537,7834,363761,0.0170,2526,115073,0.0000,0,0
2021-03-27,Brazil,203070494,Maranhão,6775805,0.0549,8014,371775,0.0172,1577,116650,0.0000,0,0
2021-03-28,Brazil,203070494,Maranhão,6775805,0.0551,1382,373157,0.0173,835,117485,0.0000,0,0
2021-03-29,Brazil,203070494,Maranhão,6775805,0.0583,21701,394858,0.0180,4400,121885,0.0000,0,0
2021-03-30,Brazil,203070494,Maranhão,6775805,0.0632,33678,428536,0.0185,3798,125683,0.0000,0,0
2021-03-31,Brazil,203070494,Maranhão,6775805,0.0672,26786,455322,0.0193,4884,130567,0.0000,0,0
2021-04-01,Brazil,203070494,Maranhão,6775805,0.0695,15931,471253,0.0196,2091,132658,0.0000,0,0
2021-04-02,Brazil,203070494,Maranhão,6775805,0.0700,3257,474510,0.0197,811,133469,0.0000,0,0
2021-04-03,Brazil,203070494,Maranhão,6775805,0.0709,6067,480577,0.0199,1252,134721,0.0000,0,0
2021-04-04,Brazil,203070494,Maranhão,6775805,0.0711,1294,481871,0.0199,117,134838,0.0000,0,0
2021-04-05,Brazil,203070494,Maranhão,6775805,0.0744,22130,504001,0.0208,5844,140682,0.0000,0,0
2021-04-06,Brazil,203070494,Maranhão,6775805,0.0791,31883,535884,0.0215,5180,145862,0.0000,0,0
2021-04-07,Brazil,203070494,Maranhão,6775805,0.0834,29476,565360,0.0229,9471,155333,0.0000,0,0
2021-04-08,Brazil,203070494,Maranhão,6775805,0.0879,30450,595810,0.0245,10522,165855,0.0000,0,0
2021-04-09,Brazil,203070494,Maranhão,6775805,0.0913,22991,618801,0.0255,7005,172860,0.0000,0,0
2021-04-10,Brazil,203070494,Maranhão,6775805,0.0930,11053,629854,0.0259,2699,175559,0.0000,0,0
2021-04-11,Brazil,203070494,Maranhão,6775805,0.0937,4844,634698,0.0259,185,175744,0.0000,0,0
2021-04-12,Brazil,203070494,Maranhão,6775805,0.0965,19160,653858,0.0276,10973,186717,0.0000,0,0
2021-04-13,Brazil,203070494,Maranhão,6775805,0.0994,19336,673194,0.0299,16173,202890,0.0000,0,0
2021-04-14,Brazil,203070494,Maranhão,6775805,0.1031,25489,698683,0.0324,16352,219242,0.0000,0,0
2021-04-15,Brazil,203070494,Maranhão,6775805,0.1061,20508,719191,0.0346,15093,234335,0.0000,0,0
2021-04-16,Brazil,203070494,Maranhão,6775805,0.1075,9411,728602,0.0361,10432,244767,0.0000,0,0
2021-04-17,Brazil,203070494,Maranhão,6775805,0.1079,2299,730901,0.0368,4323,249090,0.0000,0,0
2021-04-18,Brazil,203070494,Maranhão,6775805,0.1084,3305,734206,0.0369,905,249995,0.0000,0,0
2021-04-19,Brazil,203070494,Maranhão,6775805,0.1112,19081,753287,0.0391,14784,264779,0.0000,0,0
2021-04-20,Brazil,203070494,Maranhão,6775805,0.1151,26740,780027,0.0420,19869,284648,0.0000,0,0
2021-04-21,Brazil,203070494,Maranhão,6775805,0.1172,13789,793816,0.0434,9743,294391,0.0000,0,0
2021-04-22,Brazil,203070494,Maranhão,6775805,0.1206,23580,817396,0.0457,15034,309425,0.0000,0,0
2021-04-23,Brazil,203070494,Maranhão,6775805,0.1226,13033,830429,0.0467,7293,316718,0.0000,0,0
2021-04-24,Brazil,203070494,Maranhão,6775805,0.1234,5384,835813,0.0477,6292,323010,0.0000,0,0
2021-04-25,Brazil,203070494,Maranhão,6775805,0.1238,2698,838511,0.0477,410,323420,0.0000,0,0
2021-04-26,Brazil,203070494,Maranhão,6775805,0.1263,17161,855672,0.0511,23097,346517,0.0000,0,0
2021-04-27,Brazil,203070494,Maranhão,6775805,0.1290,18691,874363,0.0547,24137,370654,0.0000,0,0
2021-04-28,Brazil,203070494,Maranhão,6775805,0.1316,17180,891543,0.0580,22629,393283,0.0000,0,0
2021-04-29,Brazil,203070494,Maranhão,6775805,0.1339,16005,907548,0.0606,17066,410349,0.0000,0,0
2021-04-30,Brazil,203070494,Maranhão,6775805,0.1361,14407,921955,0.0624,12572,422921,0.0000,0,0
2021-05-01,Brazil,203070494,Maranhão,6775805,0.1368,5303,927258,0.0628,2342,425263,0.0000,0,0
2021-05-02,Brazil,203070494,Maranhão,6775805,0.1371,1567,928825,0.0630,1331,426594,0.0000,0,0
2021-05-03,Brazil,203070494,Maranhão,6775805,0.1397,17459,946284,0.0646,11428,438022,0.0000,0,0
2021-05-04,Brazil,203070494,Maranhão,6775805,0.1423,18013,964297,0.0662,10675,448697,0.0000,0,0
2021-05-05,Brazil,203070494,Maranhão,6775805,0.1453,20508,984805,0.0678,10830,459527,0.0000,0,0
2021-05-06,Brazil,203070494,Maranhão,6775805,0.1488,23680,1008485,0.0687,6226,465753,0.0000,0,0
2021-05-07,Brazil,203070494,Maranhão,6775805,0.1520,21402,1029887,0.0695,5274,471027,0.0000,0,0
2021-05-08,Brazil,203070494,Maranhão,6775805,0.1533,9180,1039067,0.0697,1069,472096,0.0000,0,0
2021-05-09,Brazil,203070494,Maranhão,6775805,0.1535,1298,1040365,0.0697,81,472177,0.0000,0,0
2021-05-10,Brazil,203070494,Maranhão,6775805,0.1571,24356,1064721,0.0705,5490,477667,0.0000,0,0
2021-05-11,Brazil,203070494,Maranhão,6775805,0.1608,25057,1089778,0.0712,4665,482332,0.0000,0,0
2021-05-12,Brazil,203070494,Maranhão,6775805,0.1644,24383,1114161,0.0717,3653,485985,0.0000,0,0
2021-05-13,Brazil,203070494,Maranhão,6775805,0.1678,22941,1137102,0.0725,5595,491580,0.0000,0,0
2021-05-14,Brazil,203070494,Maranhão,6775805,0.1705,18209,1155311,0.0729,2204,493784,0.0000,0,0
2021-05-15,Brazil,203070494,Maranhão,6775805,0.1712,4591,1159902,0.0730,775,494559,0.0000,0,0
2021-05-16,Brazil,203070494,Maranhão,6775805,0.1712,417,1160319,0.0730,50,494609,0.0000,0,0
2021-05-17,Brazil,203070494,Maranhão,6775805,0.1736,16060,1176379,0.0734,2884,497493,0.0000,0,0
2021-05-18,Brazil,203070494,Maranhão,6775805,0.1762,17540,1193919,0.0739,3104,500597,0.0000,0,0
2021-05-19,Brazil,203070494,Maranhão,6775805,0.1786,16334,1210253,0.0749,6608,507205,0.0000,0,0
2021-05-20,Brazil,203070494,Maranhão,6775805,0.1805,13107,1223360,0.0761,8167,515372,0.0000,0,0
2021-05-21,Brazil,203070494,Maranhão,6775805,0.1822,11488,1234848,0.0768,4948,520320,0.0000,0,0
2021-05-22,Brazil,203070494,Maranhão,6775805,0.1829,4123,1238971,0.0771,2148,522468,0.0000,0,0
2021-05-23,Brazil,203070494,Maranhão,6775805,0.1832,2045,1241016,0.0772,612,523080,0.0000,0,0
2021-05-24,Brazil,203070494,Maranhão,6775805,0.1848,11391,1252407,0.0780,5460,528540,0.0000,0,0
2021-05-25,Brazil,203070494,Maranhão,6775805,0.1869,13863,1266270,0.0789,5948,534488,0.0000,0,0
2021-05-26,Brazil,203070494,Maranhão,6775805,0.1891,14938,1281208,0.0797,5551,540039,0.0000,0,0
2021-05-27,Brazil,203070494,Maranhão,6775805,0.1914,15901,1297109,0.0803,4153,544192,0.0000,0,0
2021-05-28,Brazil,203070494,Maranhão,6775805,0.1935,13964,1311073,0.0808,3430,547622,0.0000,0,0
2021-05-29,Brazil,203070494,Maranhão,6775805,0.1951,11086,1322159,0.0809,555,548177,0.0000,0,0
2021-05-30,Brazil,203070494,Maranhão,6775805,0.1961,6754,1328913,0.0809,151,548328,0.0000,0,0
2021-05-31,Brazil,203070494,Maranhão,6775805,0.2003,28441,1357354,0.0813,2363,550691,0.0000,0,0
2021-06-01,Brazil,203070494,Maranhão,6775805,0.2085,55179,1412533,0.0817,2640,553331,0.0000,0,0
2021-06-02,Brazil,203070494,Maranhão,6775805,0.2157,48854,1461387,0.0822,3349,556680,0.0000,0,0
2021-06-03,Brazil,203070494,Maranhão,6775805,0.2203,30998,1492385,0.0823,996,557676,0.0000,0,0
2021-06-04,Brazil,203070494,Maranhão,6775805,0.2258,37384,1529769,0.0826,1986,559662,0.0000,0,0
2021-06-05,Brazil,203070494,Maranhão,6775805,0.2289,20969,1550738,0.0826,299,559961,0.0000,0,0
2021-06-06,Brazil,203070494,Maranhão,6775805,0.2316,18619,1569357,0.0827,113,560074,0.0000,0,0
2021-06-07,Brazil,203070494,Maranhão,6775805,0.2384,46250,1615607,0.0831,3150,563224,0.0000,0,0
2021-06-08,Brazil,203070494,Maranhão,6775805,0.2465,54859,1670466,0.0835,2813,566037,0.0000,0,0
2021-06-09,Brazil,203070494,Maranhão,6775805,0.2572,72027,1742493,0.0839,2591,568628,0.0000,0,0
2021-06-10,Brazil,203070494,Maranhão,6775805,0.2663,61633,1804126,0.0843,2420,571048,0.0000,0,0
2021-06-11,Brazil,203070494,Maranhão,6775805,0.2732,46942,1851068,0.0847,2646,573694,0.0000,0,0
2021-06-12,Brazil,203070494,Maranhão,6775805,0.2788,37799,1888867,0.0847,197,573891,0.0000,0,0
2021-06-13,Brazil,203070494,Maranhão,6775805,0.2809,14355,1903222,0.0847,71,573962,0.0000,0,0
2021-06-14,Brazil,203070494,Maranhão,6775805,0.2894,57450,1960672,0.0851,2834,576796,0.0000,0,0
2021-06-15,Brazil,203070494,Maranhão,6775805,0.2997,70115,2030787,0.0859,4954,581750,0.0000,0,0
2021-06-16,Brazil,203070494,Maranhão,6775805,0.3098,68299,2099086,0.0865,4215,585965,0.0000,0,0
2021-06-17,Brazil,203070494,Maranhão,6775805,0.3186,59607,2158693,0.0871,3993,589958,0.0000,0,0
2021-06-18,Brazil,203070494,Maranhão,6775805,0.3267,55000,2213693,0.0874,2308,592266,0.0000,0,0
2021-06-19,Brazil,203070494,Maranhão,6775805,0.3311,29455,2243148,0.0875,464,592730,0.0000,0,0
2021-06-20,Brazil,203070494,Maranhão,6775805,0.3338,18442,2261590,0.0875,109,592839,0.0000,0,0
2021-06-21,Brazil,203070494,Maranhão,6775805,0.3396,39491,2301081,0.0883,5673,598512,0.0000,0,0
2021-06-22,Brazil,203070494,Maranhão,6775805,0.3453,38648,2339729,0.0895,8037,606549,0.0000,0,0
2021-06-23,Brazil,203070494,Maranhão,6775805,0.3503,34139,2373868,0.0907,8158,614707,0.0000,0,0
2021-06-24,Brazil,203070494,Maranhão,6775805,0.3545,28413,2402281,0.0915,5254,619961,0.0000,0,0
2021-06-25,Brazil,203070494,Maranhão,6775805,0.3594,33267,2435548,0.0920,3085,623046,0.0000,0,0
2021-06-26,Brazil,203070494,Maranhão,6775805,0.3618,16013,2451561,0.0920,609,623655,0.0000,0,0
2021-06-27,Brazil,203070494,Maranhão,6775805,0.3624,3925,2455486,0.0921,164,623819,0.0000,0,0
2021-06-28,Brazil,203070494,Maranhão,6775805,0.3686,42103,2497589,0.0931,7185,631004,0.0000,0,0
2021-06-29,Brazil,203070494,Maranhão,6775805,0.3745,40178,2537767,0.0939,5244,636248,0.0000,0,0
2021-06-30,Brazil,203070494,Maranhão,6775805,0.3808,42132,2579899,0.0952,9028,645276,0.0000,0,0
2021-07-01,Brazil,203070494,Maranhão,6775805,0.3865,38641,2618540,0.0964,7807,653083,0.0000,0,0
2021-07-02,Brazil,203070494,Maranhão,6775805,0.3893,19496,2638036,0.0972,5401,658484,0.0000,0,0
2021-07-03,Brazil,203070494,Maranhão,6775805,0.3896,1733,2639769,0.0976,2538,661022,0.0000,0,0
2021-07-04,Brazil,203070494,Maranhão,6775805,0.3896,70,2639839,0.0978,1615,662637,0.0000,0,0
2021-07-05,Brazil,203070494,Maranhão,6775805,0.3914,12507,2652346,0.0992,9418,672055,0.0000,0,0
2021-07-06,Brazil,203070494,Maranhão,6775805,0.3962,31984,2684330,0.1007,9976,682031,0.0000,0,0
2021-07-07,Brazil,203070494,Maranhão,6775805,0.4017,37830,2722160,0.1027,13965,695996,0.0000,0,0
2021-07-08,Brazil,203070494,Maranhão,6775805,0.4058,27128,2749288,0.1044,11245,707241,0.0000,0,0
2021-07-09,Brazil,203070494,Maranhão,6775805,0.4079,14707,2763995,0.1054,7200,714441,0.0000,0,0
2021-07-10,Brazil,203070494,Maranhão,6775805,0.4084,2953,2766948,0.1057,1712,716153,0.0000,0,0
2021-07-11,Brazil,203070494,Maranhão,6775805,0.4084,118,2767066,0.1060,1916,718069,0.0000,0,0
2021-07-12,Brazil,203070494,Maranhão,6775805,0.4107,15731,2782797,0.1089,19939,738008,0.0000,0,0
2021-07-13,Brazil,203070494,Maranhão,6775805,0.4168,41177,2823974,0.1118,19818,757826,0.0000,0,0
2021-07-14,Brazil,203070494,Maranhão,6775805,0.4221,36134,2860108,0.1146,18954,776780,0.0000,0,0
2021-07-15,Brazil,203070494,Maranhão,6775805,0.4244,15414,2875522,0.1178,21536,798316,0.0000,0,0
2021-07-16,Brazil,203070494,Maranhão,6775805,0.4263,13067,2888589,0.1201,15295,813611,0.0000,0,0
2021-07-17,Brazil,203070494,Maranhão,6775805,0.4275,8150,2896739,0.1207,4517,818128,0.0000,0,0
2021-07-18,Brazil,203070494,Maranhão,6775805,0.4275,197,2896936,0.1208,432,818560,0.0000,0,0
2021-07-19,Brazil,203070494,Maranhão,6775805,0.4299,16011,2912947,0.1240,21644,840204,0.0000,0,0
2021-07-20,Brazil,203070494,Maranhão,6775805,0.4311,8082,2921029,0.1274,22890,863094,0.0000,0,0
2021-07-21,Brazil,203070494,Maranhão,6775805,0.4328,11711,2932740,0.1308,23023,886117,0.0000,0,0
2021-07-22,Brazil,203070494,Maranhão,6775805,0.4339,7117,2939857,0.1339,21087,907204,0.0000,0,0
2021-07-23,Brazil,203070494,Maranhão,6775805,0.4386,32283,2972140,0.1355,11201,918405,0.0000,0,0
2021-07-24,Brazil,203070494,Maranhão,6775805,0.4420,22974,2995114,0.1361,3933,922338,0.0000,0,0
2021-07-25,Brazil,203070494,Maranhão,6775805,0.4421,544,2995658,0.1362,614,922952,0.0000,0,0
2021-07-26,Brazil,203070494,Maranhão,6775805,0.4474,35646,3031304,0.1388,17542,940494,0.0000,0,0
2021-07-27,Brazil,203070494,Maranhão,6775805,0.4540,44799,3076103,0.1418,20260,960754,0.0000,0,0
2021-07-28,Brazil,203070494,Maranhão,6775805,0.4592,35557,3111660,0.1445,18183,978937,0.0000,0,0
2021-07-29,Brazil,203070494,Maranhão,6775805,0.4627,23625,3135285,0.1472,18760,997697,0.0000,0,0
2021-07-30,Brazil,203070494,Maranhão,6775805,0.4682,37229,3172514,0.1495,15383,1013080,0.0000,0,0
2021-07-31,Brazil,203070494,Maranhão,6775805,0.4694,8213,3180727,0.1504,5750,1018830,0.0000,0,0
2021-08-01,Brazil,203070494,Maranhão,6775805,0.4695,207,3180934,0.1504,80,1018910,0.0000,0,0
2021-08-02,Brazil,203070494,Maranhão,6775805,0.4720,17260,3198194,0.1540,24424,1043334,0.0000,0,0
2021-08-03,Brazil,203070494,Maranhão,6775805,0.4752,21834,3220028,0.1575,23808,1067142,0.0000,0,0
2021-08-04,Brazil,203070494,Maranhão,6775805,0.4776,16201,3236229,0.1612,25129,1092271,0.0000,0,0
2021-08-05,Brazil,203070494,Maranhão,6775805,0.4821,30258,3266487,0.1640,18627,1110898,0.0000,0,0
2021-08-06,Brazil,203070494,Maranhão,6775805,0.4860,26260,3292747,0.1659,13098,1123996,0.0000,0,0
2021-08-07,Brazil,203070494,Maranhão,6775805,0.4882,15481,3308228,0.1663,3068,1127064,0.0000,0,0
2021-08-08,Brazil,203070494,Maranhão,6775805,0.4885,2054,3310282,0.1664,94,1127158,0.0000,0,0
2021-08-09,Brazil,203070494,Maranhão,6775805,0.4927,27834,3338116,0.1690,17748,1144906,0.0000,0,0
2021-08-10,Brazil,203070494,Maranhão,6775805,0.4981,36850,3374966,0.1717,18382,1163288,0.0000,0,0
2021-08-11,Brazil,203070494,Maranhão,6775805,0.5026,30509,3405475,0.1745,19224,1182512,0.0000,0,0
2021-08-12,Brazil,203070494,Maranhão,6775805,0.5072,31201,3436676,0.1767,15106,1197618,0.0000,0,0
2021-08-13,Brazil,203070494,Maranhão,6775805,0.5125,35835,3472511,0.1786,12560,1210178,0.0000,0,0
2021-08-14,Brazil,203070494,Maranhão,6775805,0.5140,10399,3482910,0.1792,4000,1214178,0.0000,0,0
2021-08-15,Brazil,203070494,Maranhão,6775805,0.5141,284,3483194,0.1795,2047,1216225,0.0000,0,0
2021-08-16,Brazil,203070494,Maranhão,6775805,0.5194,35971,3519165,0.1821,17369,1233594,0.0000,0,0
2021-08-17,Brazil,203070494,Maranhão,6775805,0.5259,44349,3563514,0.1852,21568,1255162,0.0000,0,0
2021-08-18,Brazil,203070494,Maranhão,6775805,0.5324,43901,3607415,0.1886,22861,1278023,0.0000,0,0
2021-08-19,Brazil,203070494,Maranhão,6775805,0.5383,40196,3647611,0.1915,19422,1297445,0.0000,0,0
2021-08-20,Brazil,203070494,Maranhão,6775805,0.5435,35079,3682690,0.1941,17659,1315104,0.0000,0,0
2021-08-21,Brazil,203070494,Maranhão,6775805,0.5448,8440,3691130,0.1952,7357,1322461,0.0000,0,0
2021-08-22,Brazil,203070494,Maranhão,6775805,0.5448,630,3691760,0.1956,3082,1325543,0.0000,0,0
2021-08-23,Brazil,203070494,Maranhão,6775805,0.5497,32679,3724439,0.1997,27577,1353120,0.0000,0,0
2021-08-24,Brazil,203070494,Maranhão,6775805,0.5534,25331,3749770,0.2051,36751,1389871,0.0000,0,0
2021-08-25,Brazil,203070494,Maranhão,6775805,0.5573,26598,3776368,0.2102,34176,1424047,0.0000,0,0
2021-08-26,Brazil,203070494,Maranhão,6775805,0.5608,23769,3800137,0.2147,30886,1454933,0.0000,0,0
2021-08-27,Brazil,203070494,Maranhão,6775805,0.5647,26480,3826617,0.2190,29001,1483934,0.0000,0,0
2021-08-28,Brazil,203070494,Maranhão,6775805,0.5663,10233,3836850,0.2214,16238,1500172,0.0000,0,0
2021-08-29,Brazil,203070494,Maranhão,6775805,0.5663,287,3837137,0.2231,11231,1511403,0.0000,0,0
2021-08-30,Brazil,203070494,Maranhão,6775805,0.5697,23006,3860143,0.2297,45121,1556524,0.0000,0,0
2021-08-31,Brazil,203070494,Maranhão,6775805,0.5739,28425,3888568,0.2364,45518,1602042,0.0000,0,0
2021-09-01,Brazil,203070494,Maranhão,6775805,0.5778,26212,3914780,0.2444,53783,1655825,0.0000,0,0
2021-09-02,Brazil,203070494,Maranhão,6775805,0.5814,24932,3939712,0.2516,49084,1704909,0.0000,0,0
2021-09-03,Brazil,203070494,Maranhão,6775805,0.5853,25959,3965671,0.2572,38119,1743028,0.0000,0,0
2021-09-04,Brazil,203070494,Maranhão,6775805,0.5858,3328,3968999,0.2595,15036,1758064,0.0000,0,0
2021-09-05,Brazil,203070494,Maranhão,6775805,0.5859,726,3969725,0.2605,6838,1764902,0.0000,0,0
2021-09-06,Brazil,203070494,Maranhão,6775805,0.5869,7331,3977056,0.2643,26149,1791051,0.0000,0,0
2021-09-07,Brazil,203070494,Maranhão,6775805,0.5872,1398,3978454,0.2664,13712,1804763,0.0000,0,0
2021-09-08,Brazil,203070494,Maranhão,6775805,0.5897,17184,3995638,0.2759,64719,1869482,0.0000,0,0
2021-09-09,Brazil,203070494,Maranhão,6775805,0.5925,18749,4014387,0.2850,61754,1931236,0.0000,0,0
2021-09-10,Brazil,203070494,Maranhão,6775805,0.5945,14026,4028413,0.2923,49273,1980509,0.0000,0,0
2021-09-11,Brazil,203070494,Maranhão,6775805,0.5947,1391,4029804,0.2946,15627,1996136,0.0000,0,0
2021-09-12,Brazil,203070494,Maranhão,6775805,0.5949,963,4030767,0.2964,12070,2008206,0.0000,0,0
2021-09-13,Brazil,203070494,Maranhão,6775805,0.5969,14017,4044784,0.3043,53357,2061563,0.0000,0,0
2021-09-14,Brazil,203070494,Maranhão,6775805,0.5992,15384,4060168,0.3118,51192,2112755,0.0000,0,0
2021-09-15,Brazil,203070494,Maranhão,6775805,0.6015,15661,4075829,0.3184,44409,2157164,0.0000,0,0
2021-09-16,Brazil,203070494,Maranhão,6775805,0.6037,14820,4090649,0.3240,38466,2195630,0.0000,0,0
2021-09-17,Brazil,203070494,Maranhão,6775805,0.6054,11352,4102001,0.3279,26269,2221899,0.0000,0,0
2021-09-18,Brazil,203070494,Maranhão,6775805,0.6059,3192,4105193,0.3297,12224,2234123,0.0000,0,0
2021-09-19,Brazil,203070494,Maranhão,6775805,0.6060,1134,4106327,0.3299,1498,2235621,0.0000,0,0
2021-09-20,Brazil,203070494,Maranhão,6775805,0.6079,12699,4119026,0.3358,39709,2275330,0.0000,0,0
2021-09-21,Brazil,203070494,Maranhão,6775805,0.6102,15905,4134931,0.3418,40722,2316052,0.0000,0,0
2021-09-22,Brazil,203070494,Maranhão,6775805,0.6126,15765,4150696,0.3473,37368,2353420,0.0000,0,0
2021-09-23,Brazil,203070494,Maranhão,6775805,0.6148,15180,4165876,0.3512,26092,2379512,0.0000,0,0
2021-09-24,Brazil,203070494,Maranhão,6775805,0.6163,9821,4175697,0.3547,23978,2403490,0.0000,0,0
2021-09-25,Brazil,203070494,Maranhão,6775805,0.6165,1271,4176968,0.3561,9678,2413168,0.0000,0,0
2021-09-26,Brazil,203070494,Maranhão,6775805,0.6165,226,4177194,0.3562,379,2413547,0.0000,0,0
2021-09-27,Brazil,203070494,Maranhão,6775805,0.6184,12965,4190159,0.3603,27932,2441479,0.0000,0,0
2021-09-28,Brazil,203070494,Maranhão,6775805,0.6201,11423,4201582,0.3645,28577,2470056,0.0000,0,0
2021-09-29,Brazil,203070494,Maranhão,6775805,0.6219,12102,4213684,0.3680,23484,2493540,0.0000,0,0
2021-09-30,Brazil,203070494,Maranhão,6775805,0.6238,13029,4226713,0.3707,17927,2511467,0.0000,0,0
2021-10-01,Brazil,203070494,Maranhão,6775805,0.6251,8791,4235504,0.3727,13709,2525176,0.0000,0,0
2021-10-02,Brazil,203070494,Maranhão,6775805,0.6252,1000,4236504,0.3732,3563,2528739,0.0000,0,0
2021-10-03,Brazil,203070494,Maranhão,6775805,0.6252,57,4236561,0.3732,97,2528836,0.0000,0,0
2021-10-04,Brazil,203070494,Maranhão,6775805,0.6267,9605,4246166,0.3756,16317,2545153,0.0000,0,0
2021-10-05,Brazil,203070494,Maranhão,6775805,0.6280,8958,4255124,0.3791,23829,2568982,0.0000,0,0
2021-10-06,Brazil,203070494,Maranhão,6775805,0.6294,9476,4264600,0.3823,21172,2590154,0.0000,1,1
2021-10-07,Brazil,203070494,Maranhão,6775805,0.6307,8971,4273571,0.3849,17572,2607726,0.0000,0,1
2021-10-08,Brazil,203070494,Maranhão,6775805,0.6316,6209,4279780,0.3870,14589,2622315,0.0000,0,1
2021-10-09,Brazil,203070494,Maranhão,6775805,0.6318,1363,4281143,0.3877,4364,2626679,0.0000,0,1
2021-10-10,Brazil,203070494,Maranhão,6775805,0.6319,259,4281402,0.3878,712,2627391,0.0000,0,1
2021-10-11,Brazil,203070494,Maranhão,6775805,0.6329,6794,4288196,0.3895,12028,2639419,0.0000,0,1
2021-10-12,Brazil,203070494,Maranhão,6775805,0.6331,1542,4289738,0.3897,902,2640321,0.0000,0,1
2021-10-13,Brazil,203070494,Maranhão,6775805,0.6342,7651,4297389,0.3929,22116,2662437,0.0000,0,1
2021-10-14,Brazil,203070494,Maranhão,6775805,0.6368,17361,4314750,0.3964,23269,2685706,0.0000,1,2
2021-10-15,Brazil,203070494,Maranhão,6775805,0.6377,6283,4321033,0.3986,14838,2700544,0.0000,0,2
2021-10-16,Brazil,203070494,Maranhão,6775805,0.6381,2470,4323503,0.3993,5309,2705853,0.0000,0,2
2021-10-17,Brazil,203070494,Maranhão,6775805,0.6381,297,4323800,0.3994,164,2706017,0.0000,0,2
2021-10-18,Brazil,203070494,Maranhão,6775805,0.6396,9723,4333523,0.4031,25515,2731532,0.0000,0,2
2021-10-19,Brazil,203070494,Maranhão,6775805,0.6411,10173,4343696,0.4071,26878,2758410,0.0000,0,2
2021-10-20,Brazil,203070494,Maranhão,6775805,0.6423,8263,4351959,0.4109,25771,2784181,0.0000,0,2
2021-10-21,Brazil,203070494,Maranhão,6775805,0.6439,10679,4362638,0.4142,22314,2806495,0.0000,0,2
2021-10-22,Brazil,203070494,Maranhão,6775805,0.6448,6217,4368855,0.4167,17205,2823700,0.0000,0,2
2021-10-23,Brazil,203070494,Maranhão,6775805,0.6450,1459,4370314,0.4172,3188,2826888,0.0000,0,2
2021-10-24,Brazil,203070494,Maranhão,6775805,0.6450,181,4370495,0.4172,173,2827061,0.0000,0,2
2021-10-25,Brazil,203070494,Maranhão,6775805,0.6462,8364,4378859,0.4206,22915,2849976,0.0000,0,2
2021-10-26,Brazil,203070494,Maranhão,6775805,0.6476,9293,4388152,0.4243,25320,2875296,0.0000,0,2
2021-10-27,Brazil,203070494,Maranhão,6775805,0.6490,9151,4397303,0.4284,27667,2902963,0.0000,0,2
2021-10-28,Brazil,203070494,Maranhão,6775805,0.6500,6810,4404113,0.4321,24562,2927525,0.0000,0,2
2021-10-29,Brazil,203070494,Maranhão,6775805,0.6507,4614,4408727,0.4346,16976,2944501,0.0000,0,2
2021-10-30,Brazil,203070494,Maranhão,6775805,0.6507,505,4409232,0.4349,2459,2946960,0.0000,0,2
2021-10-31,Brazil,203070494,Maranhão,6775805,0.6507,120,4409352,0.4350,337,2947297,0.0000,0,2
2021-11-01,Brazil,203070494,Maranhão,6775805,0.6510,1593,4410945,0.4358,5294,2952591,0.0000,0,2
2021-11-02,Brazil,203070494,Maranhão,6775805,0.6510,250,4411195,0.4359,817,2953408,0.0000,0,2
2021-11-03,Brazil,203070494,Maranhão,6775805,0.6520,6392,4417587,0.4397,25598,2979006,0.0000,0,2
2021-11-04,Brazil,203070494,Maranhão,6775805,0.6530,6897,4424484,0.4435,25755,3004761,0.0000,0,2
2021-11-05,Brazil,203070494,Maranhão,6775805,0.6537,4884,4429368,0.4467,22095,3026856,0.0000,0,2
2021-11-06,Brazil,203070494,Maranhão,6775805,0.6538,981,4430349,0.4472,3508,3030364,0.0000,0,2
2021-11-07,Brazil,203070494,Maranhão,6775805,0.6539,25,4430374,0.4473,224,3030588,0.0000,0,2
2021-11-08,Brazil,203070494,Maranhão,6775805,0.6546,5273,4435647,0.4501,19158,3049746,0.0000,0,2
2021-11-09,Brazil,203070494,Maranhão,6775805,0.6555,5628,4441275,0.4532,20923,3070669,0.0000,0,2
2021-11-10,Brazil,203070494,Maranhão,6775805,0.6562,5235,4446510,0.4562,20147,3090816,0.0000,0,2
2021-11-11,Brazil,203070494,Maranhão,6775805,0.6570,4900,4451410,0.4597,24187,3115003,0.0000,0,2
2021-11-12,Brazil,203070494,Maranhão,6775805,0.6576,4440,4455850,0.4629,21194,3136197,0.0000,0,2
2021-11-13,Brazil,203070494,Maranhão,6775805,0.6577,572,4456422,0.4631,1894,3138091,0.0000,0,2
2021-11-14,Brazil,203070494,Maranhão,6775805,0.6577,73,4456495,0.4632,230,3138321,0.0000,0,2
2021-11-15,Brazil,203070494,Maranhão,6775805,0.6577,217,4456712,0.4633,831,3139152,0.0000,0,2
2021-11-16,Brazil,203070494,Maranhão,6775805,0.6586,5627,4462339,0.4672,26799,3165951,0.0000,0,2
2021-11-17,Brazil,203070494,Maranhão,6775805,0.6595,6327,4468666,0.4714,28403,3194354,0.0000,0,2
2021-11-18,Brazil,203070494,Maranhão,6775805,0.6604,6129,4474795,0.4753,26466,3220820,0.0000,0,2
2021-11-19,Brazil,203070494,Maranhão,6775805,0.6611,4764,4479559,0.4783,20321,3241141,0.0000,0,2
2021-11-20,Brazil,203070494,Maranhão,6775805,0.6612,480,4480039,0.4788,3147,3244288,0.0000,0,2
2021-11-21,Brazil,203070494,Maranhão,6775805,0.6612,106,4480145,0.4788,214,3244502,0.0000,0,2
2021-11-22,Brazil,203070494,Maranhão,6775805,0.6620,5241,4485386,0.4820,21645,3266147,0.0000,0,2
2021-11-23,Brazil,203070494,Maranhão,6775805,0.6629,6528,4491914,0.4857,25090,3291237,0.0000,0,2
2021-11-24,Brazil,203070494,Maranhão,6775805,0.6639,6250,4498164,0.4891,22499,3313736,0.0000,0,2
2021-11-25,Brazil,203070494,Maranhão,6775805,0.6647,5878,4504042,0.4924,22749,3336485,0.0000,0,2
2021-11-26,Brazil,203070494,Maranhão,6775805,0.6654,4779,4508821,0.4949,17188,3353673,0.0000,0,2
2021-11-27,Brazil,203070494,Maranhão,6775805,0.6655,580,4509401,0.4952,1619,3355292,0.0000,0,2
2021-11-28,Brazil,203070494,Maranhão,6775805,0.6655,129,4509530,0.4952,354,3355646,0.0000,0,2
2021-11-29,Brazil,203070494,Maranhão,6775805,0.6666,6893,4516423,0.4984,21628,3377274,0.0000,1,3
2021-11-30,Brazil,203070494,Maranhão,6775805,0.6677,7991,4524414,0.5018,23084,3400358,0.0000,0,3
2021-12-01,Brazil,203070494,Maranhão,6775805,0.6688,7319,4531733,0.5049,20892,3421250,0.0000,0,3
2021-12-02,Brazil,203070494,Maranhão,6775805,0.6700,8124,4539857,0.5079,20062,3441312,0.0000,0,3
2021-12-03,Brazil,203070494,Maranhão,6775805,0.6707,4953,4544810,0.5099,13378,3454690,0.0000,0,3
2021-12-04,Brazil,203070494,Maranhão,6775805,0.6708,484,4545294,0.5101,1673,3456363,0.0000,0,3
2021-12-05,Brazil,203070494,Maranhão,6775805,0.6708,81,4545375,0.5101,301,3456664,0.0000,0,3
2021-12-06,Brazil,203070494,Maranhão,6775805,0.6719,7270,4552645,0.5127,17064,3473728,0.0000,0,3
2021-12-07,Brazil,203070494,Maranhão,6775805,0.6730,7354,4559999,0.5152,17318,3491046,0.0000,0,3
2021-12-08,Brazil,203070494,Maranhão,6775805,0.6737,4677,4564676,0.5170,11989,3503035,0.0000,0,3
2021-12-09,Brazil,203070494,Maranhão,6775805,0.6745,5549,4570225,0.5193,15544,3518579,0.0000,0,3
2021-12-10,Brazil,203070494,Maranhão,6775805,0.6751,3880,4574105,0.5207,9621,3528200,0.0000,0,3
2021-12-11,Brazil,203070494,Maranhão,6775805,0.6751,497,4574602,0.5209,1078,3529278,0.0000,0,3
2021-12-12,Brazil,203070494,Maranhão,6775805,0.6752,143,4574745,0.5209,310,3529588,0.0000,0,3
2021-12-13,Brazil,203070494,Maranhão,6775805,0.6761,6590,4581335,0.5232,15535,3545123,0.0000,0,3
2021-12-14,Brazil,203070494,Maranhão,6775805,0.6771,6706,4588041,0.5256,16445,3561568,0.0000,0,3
2021-12-15,Brazil,203070494,Maranhão,6775805,0.6780,5656,4593697,0.5278,14885,3576453,0.0000,0,3
2021-12-16,Brazil,203070494,Maranhão,6775805,0.6786,4030,4597727,0.5294,10706,3587159,0.0000,0,3
2021-12-17,Brazil,203070494,Maranhão,6775805,0.6791,3674,4601401,0.5310,10775,3597934,0.0000,0,3
2021-12-18,Brazil,203070494,Maranhão,6775805,0.6792,451,4601852,0.5312,1140,3599074,0.0000,0,3
2021-12-19,Brazil,203070494,Maranhão,6775805,0.6792,106,4601958,0.5312,192,3599266,0.0000,0,3
2021-12-20,Brazil,203070494,Maranhão,6775805,0.6799,4703,4606661,0.5331,13013,3612279,0.0000,0,3
2021-12-21,Brazil,203070494,Maranhão,6775805,0.6804,3515,4610176,0.5347,10496,3622775,0.0000,0,3
2021-12-22,Brazil,203070494,Maranhão,6775805,0.6808,2569,4612745,0.5358,7566,3630341,0.0000,0,3
2021-12-23,Brazil,203070494,Maranhão,6775805,0.6810,1520,4614265,0.5364,4107,3634448,0.0000,0,3
2021-12-24,Brazil,203070494,Maranhão,6775805,0.6810,115,4614380,0.5364,342,3634790,0.0000,0,3
2021-12-25,Brazil,203070494,Maranhão,6775805,0.6810,5,4614385,0.5364,18,3634808,0.0000,0,3
2021-12-26,Brazil,203070494,Maranhão,6775805,0.6810,33,4614418,0.5364,41,3634849,0.0000,0,3
2021-12-27,Brazil,203070494,Maranhão,6775805,0.6812,1364,4615782,0.5371,4243,3639092,0.0000,0,3
2021-12-28,Brazil,203070494,Maranhão,6775805,0.6814,1532,4617314,0.5378,4632,3643724,0.0000,0,3
2021-12-29,Brazil,203070494,Maranhão,6775805,0.6816,1206,4618520,0.5383,3655,3647379,0.0000,0,3
2021-12-30,Brazil,203070494,Maranhão,6775805,0.6817,690,4619210,0.5386,2093,3649472,0.0000,0,3
2021-12-31,Brazil,203070494,Maranhão,6775805,0.6817,55,4619265,0.5386,186,3649658,0.0000,0,3
2021-01-05,Brazil,203070494,Mato Grosso,3658649,0.0000,1,1,0.0000,0,0,0.0000,0,0
2021-01-10,Brazil,203070494,Mato Grosso,3658649,0.0000,0,1,0.0000,1,1,0.0000,0,0
2021-01-17,Brazil,203070494,Mato Grosso,3658649,0.0000,7,8,0.0000,1,2,0.0000,0,0
2021-01-18,Brazil,203070494,Mato Grosso,3658649,0.0000,14,22,0.0000,0,2,0.0000,0,0
2021-01-19,Brazil,203070494,Mato Grosso,3658649,0.0001,268,290,0.0000,2,4,0.0000,0,0
2021-01-20,Brazil,203070494,Mato Grosso,3658649,0.0006,1955,2245,0.0000,2,6,0.0000,0,0
2021-01-21,Brazil,203070494,Mato Grosso,3658649,0.0026,7344,9589,0.0000,11,17,0.0000,0,0
2021-01-22,Brazil,203070494,Mato Grosso,3658649,0.0050,8877,18466,0.0000,21,38,0.0000,0,0
2021-01-23,Brazil,203070494,Mato Grosso,3658649,0.0061,3700,22166,0.0000,7,45,0.0000,0,0
2021-01-24,Brazil,203070494,Mato Grosso,3658649,0.0064,1298,23464,0.0000,2,47,0.0000,0,0
2021-01-25,Brazil,203070494,Mato Grosso,3658649,0.0074,3432,26896,0.0000,1,48,0.0000,0,0
2021-01-26,Brazil,203070494,Mato Grosso,3658649,0.0081,2658,29554,0.0000,4,52,0.0000,0,0
2021-01-27,Brazil,203070494,Mato Grosso,3658649,0.0092,4208,33762,0.0000,7,59,0.0000,0,0
2021-01-28,Brazil,203070494,Mato Grosso,3658649,0.0110,6553,40315,0.0000,6,65,0.0000,0,0
2021-01-29,Brazil,203070494,Mato Grosso,3658649,0.0126,5910,46225,0.0000,7,72,0.0000,0,0
2021-01-30,Brazil,203070494,Mato Grosso,3658649,0.0133,2359,48584,0.0000,4,76,0.0000,0,0
2021-01-31,Brazil,203070494,Mato Grosso,3658649,0.0137,1562,50146,0.0000,0,76,0.0000,0,0
2021-02-01,Brazil,203070494,Mato Grosso,3658649,0.0149,4253,54399,0.0000,9,85,0.0000,0,0
2021-02-02,Brazil,203070494,Mato Grosso,3658649,0.0163,5316,59715,0.0000,12,97,0.0000,0,0
2021-02-03,Brazil,203070494,Mato Grosso,3658649,0.0175,4246,63961,0.0001,154,251,0.0000,0,0
2021-02-04,Brazil,203070494,Mato Grosso,3658649,0.0187,4490,68451,0.0002,530,781,0.0000,0,0
2021-02-05,Brazil,203070494,Mato Grosso,3658649,0.0198,4095,72546,0.0005,947,1728,0.0000,0,0
2021-02-06,Brazil,203070494,Mato Grosso,3658649,0.0202,1258,73804,0.0006,438,2166,0.0000,0,0
2021-02-07,Brazil,203070494,Mato Grosso,3658649,0.0204,661,74465,0.0006,149,2315,0.0000,0,0
2021-02-08,Brazil,203070494,Mato Grosso,3658649,0.0208,1525,75990,0.0009,864,3179,0.0000,0,0
2021-02-09,Brazil,203070494,Mato Grosso,3658649,0.0212,1754,77744,0.0011,822,4001,0.0000,0,0
2021-02-10,Brazil,203070494,Mato Grosso,3658649,0.0217,1675,79419,0.0018,2498,6499,0.0000,0,0
2021-02-11,Brazil,203070494,Mato Grosso,3658649,0.0222,1941,81360,0.0028,3711,10210,0.0000,0,0
2021-02-12,Brazil,203070494,Mato Grosso,3658649,0.0231,3042,84402,0.0041,4666,14876,0.0000,0,0
2021-02-13,Brazil,203070494,Mato Grosso,3658649,0.0238,2833,87235,0.0049,2997,17873,0.0000,0,0
2021-02-14,Brazil,203070494,Mato Grosso,3658649,0.0241,907,88142,0.0053,1443,19316,0.0000,0,0
2021-02-15,Brazil,203070494,Mato Grosso,3658649,0.0246,1751,89893,0.0063,3685,23001,0.0000,0,0
2021-02-16,Brazil,203070494,Mato Grosso,3658649,0.0250,1592,91485,0.0071,2923,25924,0.0000,0,0
2021-02-17,Brazil,203070494,Mato Grosso,3658649,0.0254,1491,92976,0.0080,3255,29179,0.0000,0,0
2021-02-18,Brazil,203070494,Mato Grosso,3658649,0.0258,1409,94385,0.0090,3790,32969,0.0000,0,0
2021-02-19,Brazil,203070494,Mato Grosso,3658649,0.0262,1331,95716,0.0096,2115,35084,0.0000,0,0
2021-02-20,Brazil,203070494,Mato Grosso,3658649,0.0264,873,96589,0.0099,1292,36376,0.0000,0,0
2021-02-21,Brazil,203070494,Mato Grosso,3658649,0.0264,177,96766,0.0100,359,36735,0.0000,0,0
2021-02-22,Brazil,203070494,Mato Grosso,3658649,0.0267,737,97503,0.0104,1496,38231,0.0000,0,0
2021-02-23,Brazil,203070494,Mato Grosso,3658649,0.0269,995,98498,0.0108,1415,39646,0.0000,0,0
2021-02-24,Brazil,203070494,Mato Grosso,3658649,0.0271,788,99286,0.0112,1491,41137,0.0000,0,0
2021-02-25,Brazil,203070494,Mato Grosso,3658649,0.0273,635,99921,0.0117,1728,42865,0.0000,0,0
2021-02-26,Brazil,203070494,Mato Grosso,3658649,0.0275,697,100618,0.0121,1437,44302,0.0000,0,0
2021-02-27,Brazil,203070494,Mato Grosso,3658649,0.0275,68,100686,0.0122,251,44553,0.0000,0,0
2021-02-28,Brazil,203070494,Mato Grosso,3658649,0.0275,63,100749,0.0122,251,44804,0.0000,0,0
2021-03-01,Brazil,203070494,Mato Grosso,3658649,0.0277,424,101173,0.0126,1278,46082,0.0000,0,0
2021-03-02,Brazil,203070494,Mato Grosso,3658649,0.0280,1207,102380,0.0131,1794,47876,0.0000,0,0
2021-03-03,Brazil,203070494,Mato Grosso,3658649,0.0284,1562,103942,0.0137,2266,50142,0.0000,0,0
2021-03-04,Brazil,203070494,Mato Grosso,3658649,0.0294,3763,107705,0.0142,1775,51917,0.0000,0,0
2021-03-05,Brazil,203070494,Mato Grosso,3658649,0.0306,4292,111997,0.0146,1602,53519,0.0000,0,0
2021-03-06,Brazil,203070494,Mato Grosso,3658649,0.0312,2306,114303,0.0150,1358,54877,0.0000,0,0
2021-03-07,Brazil,203070494,Mato Grosso,3658649,0.0313,82,114385,0.0150,178,55055,0.0000,0,0
2021-03-08,Brazil,203070494,Mato Grosso,3658649,0.0322,3605,117990,0.0154,1201,56256,0.0000,0,0
2021-03-09,Brazil,203070494,Mato Grosso,3658649,0.0332,3614,121604,0.0159,2063,58319,0.0000,0,0
2021-03-10,Brazil,203070494,Mato Grosso,3658649,0.0341,3136,124740,0.0163,1299,59618,0.0000,0,0
2021-03-11,Brazil,203070494,Mato Grosso,3658649,0.0349,2802,127542,0.0167,1499,61117,0.0000,0,0
2021-03-12,Brazil,203070494,Mato Grosso,3658649,0.0359,3762,131304,0.0172,1742,62859,0.0000,0,0
2021-03-13,Brazil,203070494,Mato Grosso,3658649,0.0362,1056,132360,0.0174,906,63765,0.0000,0,0
2021-03-14,Brazil,203070494,Mato Grosso,3658649,0.0362,25,132385,0.0175,82,63847,0.0000,0,0
2021-03-15,Brazil,203070494,Mato Grosso,3658649,0.0371,3444,135829,0.0179,1471,65318,0.0000,0,0
2021-03-16,Brazil,203070494,Mato Grosso,3658649,0.0381,3661,139490,0.0181,920,66238,0.0000,0,0
2021-03-17,Brazil,203070494,Mato Grosso,3658649,0.0392,3921,143411,0.0183,842,67080,0.0000,0,0
2021-03-18,Brazil,203070494,Mato Grosso,3658649,0.0401,3430,146841,0.0186,810,67890,0.0000,0,0
2021-03-19,Brazil,203070494,Mato Grosso,3658649,0.0409,2868,149709,0.0188,759,68649,0.0000,0,0
2021-03-20,Brazil,203070494,Mato Grosso,3658649,0.0418,3298,153007,0.0188,238,68887,0.0000,0,0
2021-03-21,Brazil,203070494,Mato Grosso,3658649,0.0419,117,153124,0.0189,127,69014,0.0000,0,0
2021-03-22,Brazil,203070494,Mato Grosso,3658649,0.0429,3956,157080,0.0191,777,69791,0.0000,0,0
2021-03-23,Brazil,203070494,Mato Grosso,3658649,0.0446,6223,163303,0.0194,1242,71033,0.0000,0,0
2021-03-24,Brazil,203070494,Mato Grosso,3658649,0.0461,5402,168705,0.0197,899,71932,0.0000,0,0
2021-03-25,Brazil,203070494,Mato Grosso,3658649,0.0480,6875,175580,0.0199,786,72718,0.0000,0,0
2021-03-26,Brazil,203070494,Mato Grosso,3658649,0.0500,7321,182901,0.0202,1021,73739,0.0000,0,0
2021-03-27,Brazil,203070494,Mato Grosso,3658649,0.0528,10317,193218,0.0203,554,74293,0.0000,0,0
2021-03-28,Brazil,203070494,Mato Grosso,3658649,0.0528,107,193325,0.0203,83,74376,0.0000,0,0
2021-03-29,Brazil,203070494,Mato Grosso,3658649,0.0542,4802,198127,0.0205,596,74972,0.0000,0,0
2021-03-30,Brazil,203070494,Mato Grosso,3658649,0.0571,10808,208935,0.0209,1654,76626,0.0000,0,0
2021-03-31,Brazil,203070494,Mato Grosso,3658649,0.0606,12722,221657,0.0216,2529,79155,0.0000,0,0
2021-04-01,Brazil,203070494,Mato Grosso,3658649,0.0641,12728,234385,0.0222,2084,81239,0.0000,0,0
2021-04-02,Brazil,203070494,Mato Grosso,3658649,0.0641,77,234462,0.0223,200,81439,0.0000,0,0
2021-04-03,Brazil,203070494,Mato Grosso,3658649,0.0653,4346,238808,0.0224,529,81968,0.0000,0,0
2021-04-04,Brazil,203070494,Mato Grosso,3658649,0.0654,541,239349,0.0224,49,82017,0.0000,0,0
2021-04-05,Brazil,203070494,Mato Grosso,3658649,0.0676,8119,247468,0.0231,2577,84594,0.0000,0,0
2021-04-06,Brazil,203070494,Mato Grosso,3658649,0.0701,8939,256407,0.0238,2532,87126,0.0000,0,0
2021-04-07,Brazil,203070494,Mato Grosso,3658649,0.0732,11364,267771,0.0245,2494,89620,0.0000,0,0
2021-04-08,Brazil,203070494,Mato Grosso,3658649,0.0762,11163,278934,0.0255,3822,93442,0.0000,0,0
2021-04-09,Brazil,203070494,Mato Grosso,3658649,0.0793,11084,290018,0.0265,3541,96983,0.0000,0,0
2021-04-10,Brazil,203070494,Mato Grosso,3658649,0.0815,8006,298024,0.0272,2554,99537,0.0000,0,0
2021-04-11,Brazil,203070494,Mato Grosso,3658649,0.0816,363,298387,0.0273,303,99840,0.0000,0,0
2021-04-12,Brazil,203070494,Mato Grosso,3658649,0.0829,4736,303123,0.0285,4319,104159,0.0000,0,0
2021-04-13,Brazil,203070494,Mato Grosso,3658649,0.0856,9899,313022,0.0298,4753,108912,0.0000,0,0
2021-04-14,Brazil,203070494,Mato Grosso,3658649,0.0884,10362,323384,0.0311,4798,113710,0.0000,0,0
2021-04-15,Brazil,203070494,Mato Grosso,3658649,0.0907,8387,331771,0.0327,5754,119464,0.0000,0,0
2021-04-16,Brazil,203070494,Mato Grosso,3658649,0.0928,7873,339644,0.0344,6227,125691,0.0000,0,0
2021-04-17,Brazil,203070494,Mato Grosso,3658649,0.0945,6039,345683,0.0349,1906,127597,0.0000,0,0
2021-04-18,Brazil,203070494,Mato Grosso,3658649,0.0945,155,345838,0.0349,66,127663,0.0000,0,0
2021-04-19,Brazil,203070494,Mato Grosso,3658649,0.0960,5441,351279,0.0366,6291,133954,0.0000,0,0
2021-04-20,Brazil,203070494,Mato Grosso,3658649,0.0991,11342,362621,0.0389,8283,142237,0.0000,0,0
2021-04-21,Brazil,203070494,Mato Grosso,3658649,0.1023,11500,374121,0.0394,1743,143980,0.0000,0,0
2021-04-22,Brazil,203070494,Mato Grosso,3658649,0.1047,9104,383225,0.0421,10152,154132,0.0000,0,0
2021-04-23,Brazil,203070494,Mato Grosso,3658649,0.1078,11056,394281,0.0442,7427,161559,0.0000,0,0
2021-04-24,Brazil,203070494,Mato Grosso,3658649,0.1090,4626,398907,0.0464,8318,169877,0.0000,0,0
2021-04-25,Brazil,203070494,Mato Grosso,3658649,0.1091,84,398991,0.0465,69,169946,0.0000,0,0
2021-04-26,Brazil,203070494,Mato Grosso,3658649,0.1109,6669,405660,0.0485,7623,177569,0.0000,0,0
2021-04-27,Brazil,203070494,Mato Grosso,3658649,0.1132,8580,414240,0.0512,9795,187364,0.0000,0,0
2021-04-28,Brazil,203070494,Mato Grosso,3658649,0.1153,7773,422013,0.0534,8064,195428,0.0000,0,0
2021-04-29,Brazil,203070494,Mato Grosso,3658649,0.1177,8770,430783,0.0560,9536,204964,0.0000,0,0
2021-04-30,Brazil,203070494,Mato Grosso,3658649,0.1199,7853,438636,0.0578,6420,211384,0.0000,0,0
2021-05-01,Brazil,203070494,Mato Grosso,3658649,0.1215,5831,444467,0.0581,1174,212558,0.0000,0,0
2021-05-02,Brazil,203070494,Mato Grosso,3658649,0.1215,53,444520,0.0581,30,212588,0.0000,0,0
2021-05-03,Brazil,203070494,Mato Grosso,3658649,0.1235,7204,451724,0.0596,5390,217978,0.0000,0,0
2021-05-04,Brazil,203070494,Mato Grosso,3658649,0.1257,8196,459920,0.0609,4699,222677,0.0000,0,0
2021-05-05,Brazil,203070494,Mato Grosso,3658649,0.1283,9380,469300,0.0620,4283,226960,0.0000,0,0
2021-05-06,Brazil,203070494,Mato Grosso,3658649,0.1306,8529,477829,0.0631,3995,230955,0.0000,0,0
2021-05-07,Brazil,203070494,Mato Grosso,3658649,0.1339,11997,489826,0.0642,3953,234908,0.0000,0,0
2021-05-08,Brazil,203070494,Mato Grosso,3658649,0.1353,5101,494927,0.0645,1087,235995,0.0000,0,0
2021-05-09,Brazil,203070494,Mato Grosso,3658649,0.1353,29,494956,0.0645,17,236012,0.0000,0,0
2021-05-10,Brazil,203070494,Mato Grosso,3658649,0.1375,8211,503167,0.0655,3703,239715,0.0000,0,0
2021-05-11,Brazil,203070494,Mato Grosso,3658649,0.1400,8978,512145,0.0670,5250,244965,0.0000,0,0
2021-05-12,Brazil,203070494,Mato Grosso,3658649,0.1432,11724,523869,0.0685,5674,250639,0.0000,0,0
2021-05-13,Brazil,203070494,Mato Grosso,3658649,0.1458,9532,533401,0.0697,4272,254911,0.0000,0,0
2021-05-14,Brazil,203070494,Mato Grosso,3658649,0.1485,10046,543447,0.0706,3240,258151,0.0000,0,0
2021-05-15,Brazil,203070494,Mato Grosso,3658649,0.1495,3453,546900,0.0716,3965,262116,0.0000,0,0
2021-05-16,Brazil,203070494,Mato Grosso,3658649,0.1496,540,547440,0.0723,2529,264645,0.0000,0,0
2021-05-17,Brazil,203070494,Mato Grosso,3658649,0.1519,8241,555681,0.0728,1821,266466,0.0000,0,0
2021-05-18,Brazil,203070494,Mato Grosso,3658649,0.1540,7647,563328,0.0751,8120,274586,0.0000,0,0
2021-05-19,Brazil,203070494,Mato Grosso,3658649,0.1562,8120,571448,0.0764,5106,279692,0.0000,0,0
2021-05-20,Brazil,203070494,Mato Grosso,3658649,0.1589,10041,581489,0.0779,5231,284923,0.0000,0,0
2021-05-21,Brazil,203070494,Mato Grosso,3658649,0.1611,7957,589446,0.0794,5695,290618,0.0000,0,0
2021-05-22,Brazil,203070494,Mato Grosso,3658649,0.1620,3392,592838,0.0801,2493,293111,0.0000,0,0
2021-05-23,Brazil,203070494,Mato Grosso,3658649,0.1621,119,592957,0.0801,97,293208,0.0000,0,0
2021-05-24,Brazil,203070494,Mato Grosso,3658649,0.1646,9165,602122,0.0805,1439,294647,0.0000,0,0
2021-05-25,Brazil,203070494,Mato Grosso,3658649,0.1673,9888,612010,0.0810,1645,296292,0.0000,0,0
2021-05-26,Brazil,203070494,Mato Grosso,3658649,0.1700,9949,621959,0.0814,1408,297700,0.0000,0,0
2021-05-27,Brazil,203070494,Mato Grosso,3658649,0.1726,9384,631343,0.0820,2240,299940,0.0000,0,0
2021-05-28,Brazil,203070494,Mato Grosso,3658649,0.1748,8249,639592,0.0826,2154,302094,0.0000,0,0
2021-05-29,Brazil,203070494,Mato Grosso,3658649,0.1764,5726,645318,0.0827,407,302501,0.0000,0,0
2021-05-30,Brazil,203070494,Mato Grosso,3658649,0.1764,193,645511,0.0827,96,302597,0.0000,0,0
2021-05-31,Brazil,203070494,Mato Grosso,3658649,0.1783,6759,652270,0.0834,2455,305052,0.0000,0,0
2021-06-01,Brazil,203070494,Mato Grosso,3658649,0.1815,11868,664138,0.0839,1851,306903,0.0000,0,0
2021-06-02,Brazil,203070494,Mato Grosso,3658649,0.1854,14094,678232,0.0844,2032,308935,0.0000,0,0
2021-06-03,Brazil,203070494,Mato Grosso,3658649,0.1869,5631,683863,0.0845,380,309315,0.0000,0,0
2021-06-04,Brazil,203070494,Mato Grosso,3658649,0.1885,5869,689732,0.0848,904,310219,0.0000,0,0
2021-06-05,Brazil,203070494,Mato Grosso,3658649,0.1902,6051,695783,0.0849,507,310726,0.0000,0,0
2021-06-06,Brazil,203070494,Mato Grosso,3658649,0.1902,135,695918,0.0849,60,310786,0.0000,0,0
2021-06-07,Brazil,203070494,Mato Grosso,3658649,0.1930,10270,706188,0.0854,1514,312300,0.0000,0,0
2021-06-08,Brazil,203070494,Mato Grosso,3658649,0.1974,16046,722234,0.0858,1460,313760,0.0000,0,0
2021-06-09,Brazil,203070494,Mato Grosso,3658649,0.2025,18807,741041,0.0860,949,314709,0.0000,0,0
2021-06-10,Brazil,203070494,Mato Grosso,3658649,0.2075,17972,759013,0.0863,1069,315778,0.0000,0,0
2021-06-11,Brazil,203070494,Mato Grosso,3658649,0.2120,16722,775735,0.0865,841,316619,0.0000,0,0
2021-06-12,Brazil,203070494,Mato Grosso,3658649,0.2157,13403,789138,0.0866,131,316750,0.0000,0,0
2021-06-13,Brazil,203070494,Mato Grosso,3658649,0.2157,97,789235,0.0866,48,316798,0.0000,0,0
2021-06-14,Brazil,203070494,Mato Grosso,3658649,0.2196,14379,803614,0.0868,710,317508,0.0000,0,0
2021-06-15,Brazil,203070494,Mato Grosso,3658649,0.2242,16670,820284,0.0870,630,318138,0.0000,0,0
2021-06-16,Brazil,203070494,Mato Grosso,3658649,0.2291,17782,838066,0.0872,730,318868,0.0000,0,0
2021-06-17,Brazil,203070494,Mato Grosso,3658649,0.2348,20821,858887,0.0875,1104,319972,0.0000,0,0
2021-06-18,Brazil,203070494,Mato Grosso,3658649,0.2398,18513,877400,0.0877,930,320902,0.0000,0,0
2021-06-19,Brazil,203070494,Mato Grosso,3658649,0.2425,9860,887260,0.0878,163,321065,0.0000,0,0
2021-06-20,Brazil,203070494,Mato Grosso,3658649,0.2425,64,887324,0.0878,55,321120,0.0000,0,0
2021-06-21,Brazil,203070494,Mato Grosso,3658649,0.2459,12275,899599,0.0884,2337,323457,0.0000,0,0
2021-06-22,Brazil,203070494,Mato Grosso,3658649,0.2504,16355,915954,0.0893,3166,326623,0.0000,0,0
2021-06-23,Brazil,203070494,Mato Grosso,3658649,0.2544,14743,930697,0.0899,2321,328944,0.0000,0,0
2021-06-24,Brazil,203070494,Mato Grosso,3658649,0.2587,15698,946395,0.0903,1426,330370,0.0000,0,0
2021-06-25,Brazil,203070494,Mato Grosso,3658649,0.2631,16373,962768,0.0908,1665,332035,0.0000,0,0
2021-06-26,Brazil,203070494,Mato Grosso,3658649,0.2666,12663,975431,0.0911,1250,333285,0.0000,0,0
2021-06-27,Brazil,203070494,Mato Grosso,3658649,0.2666,80,975511,0.0912,219,333504,0.0000,0,0
2021-06-28,Brazil,203070494,Mato Grosso,3658649,0.2712,16623,992134,0.0915,1272,334776,0.0000,0,0
2021-06-29,Brazil,203070494,Mato Grosso,3658649,0.2767,20250,1012384,0.0918,1072,335848,0.0000,0,0
2021-06-30,Brazil,203070494,Mato Grosso,3658649,0.2828,22124,1034508,0.0921,1149,336997,0.0000,0,0
2021-07-01,Brazil,203070494,Mato Grosso,3658649,0.2888,21975,1056483,0.0927,2127,339124,0.0000,0,0
2021-07-02,Brazil,203070494,Mato Grosso,3658649,0.2945,21038,1077521,0.0931,1637,340761,0.0000,0,0
2021-07-03,Brazil,203070494,Mato Grosso,3658649,0.2967,8140,1085661,0.0932,297,341058,0.0000,0,0
2021-07-04,Brazil,203070494,Mato Grosso,3658649,0.2968,47,1085708,0.0932,42,341100,0.0000,0,0
2021-07-05,Brazil,203070494,Mato Grosso,3658649,0.3012,16401,1102109,0.0938,1933,343033,0.0000,0,0
2021-07-06,Brazil,203070494,Mato Grosso,3658649,0.3056,16004,1118113,0.0946,3057,346090,0.0000,0,0
2021-07-07,Brazil,203070494,Mato Grosso,3658649,0.3122,24109,1142222,0.0957,3983,350073,0.0000,0,0
2021-07-08,Brazil,203070494,Mato Grosso,3658649,0.3213,33299,1175521,0.0965,3015,353088,0.0000,0,0
2021-07-09,Brazil,203070494,Mato Grosso,3658649,0.3302,32699,1208220,0.0975,3655,356743,0.0000,0,0
2021-07-10,Brazil,203070494,Mato Grosso,3658649,0.3347,16391,1224611,0.0986,4075,360818,0.0000,0,0
2021-07-11,Brazil,203070494,Mato Grosso,3658649,0.3349,622,1225233,0.0986,7,360825,0.0000,0,0
2021-07-12,Brazil,203070494,Mato Grosso,3658649,0.3422,26607,1251840,0.0993,2660,363485,0.0000,0,0
2021-07-13,Brazil,203070494,Mato Grosso,3658649,0.3477,20385,1272225,0.1010,6017,369502,0.0000,0,0
2021-07-14,Brazil,203070494,Mato Grosso,3658649,0.3532,19986,1292211,0.1025,5607,375109,0.0000,0,0
2021-07-15,Brazil,203070494,Mato Grosso,3658649,0.3586,19921,1312132,0.1039,4996,380105,0.0000,0,0
2021-07-16,Brazil,203070494,Mato Grosso,3658649,0.3641,20037,1332169,0.1054,5340,385445,0.0000,0,0
2021-07-17,Brazil,203070494,Mato Grosso,3658649,0.3663,8145,1340314,0.1064,3859,389304,0.0000,0,0
2021-07-18,Brazil,203070494,Mato Grosso,3658649,0.3671,2836,1343150,0.1064,47,389351,0.0000,0,0
2021-07-19,Brazil,203070494,Mato Grosso,3658649,0.3727,20467,1363617,0.1074,3693,393044,0.0000,0,0
2021-07-20,Brazil,203070494,Mato Grosso,3658649,0.3808,29563,1393180,0.1093,6988,400032,0.0000,0,0
2021-07-21,Brazil,203070494,Mato Grosso,3658649,0.3887,29113,1422293,0.1122,10375,410407,0.0000,0,0
2021-07-22,Brazil,203070494,Mato Grosso,3658649,0.3980,34014,1456307,0.1150,10459,420866,0.0000,0,0
2021-07-23,Brazil,203070494,Mato Grosso,3658649,0.4072,33636,1489943,0.1176,9295,430161,0.0000,0,0
2021-07-24,Brazil,203070494,Mato Grosso,3658649,0.4140,24893,1514836,0.1188,4418,434579,0.0000,0,0
2021-07-25,Brazil,203070494,Mato Grosso,3658649,0.4164,8607,1523443,0.1188,33,434612,0.0000,0,0
2021-07-26,Brazil,203070494,Mato Grosso,3658649,0.4213,18097,1541540,0.1210,8037,442649,0.0000,0,0
2021-07-27,Brazil,203070494,Mato Grosso,3658649,0.4273,21713,1563253,0.1243,12221,454870,0.0000,0,0
2021-07-28,Brazil,203070494,Mato Grosso,3658649,0.4336,23268,1586521,0.1277,12358,467228,0.0000,0,0
2021-07-29,Brazil,203070494,Mato Grosso,3658649,0.4397,22134,1608655,0.1308,11277,478505,0.0000,0,0
2021-07-30,Brazil,203070494,Mato Grosso,3658649,0.4468,26018,1634673,0.1336,10197,488702,0.0000,0,0
2021-07-31,Brazil,203070494,Mato Grosso,3658649,0.4503,12869,1647542,0.1344,2946,491648,0.0000,0,0
2021-08-01,Brazil,203070494,Mato Grosso,3658649,0.4512,3229,1650771,0.1344,94,491742,0.0000,0,0
2021-08-02,Brazil,203070494,Mato Grosso,3658649,0.4550,13839,1664610,0.1376,11515,503257,0.0000,0,0
2021-08-03,Brazil,203070494,Mato Grosso,3658649,0.4596,17056,1681666,0.1406,11265,514522,0.0000,0,0
2021-08-04,Brazil,203070494,Mato Grosso,3658649,0.4642,16545,1698211,0.1437,11271,525793,0.0000,0,0
2021-08-05,Brazil,203070494,Mato Grosso,3658649,0.4700,21403,1719614,0.1463,9310,535103,0.0000,0,0
2021-08-06,Brazil,203070494,Mato Grosso,3658649,0.4758,21023,1740637,0.1490,10033,545136,0.0000,0,0
2021-08-07,Brazil,203070494,Mato Grosso,3658649,0.4784,9552,1750189,0.1500,3759,548895,0.0000,0,0
2021-08-08,Brazil,203070494,Mato Grosso,3658649,0.4784,123,1750312,0.1500,27,548922,0.0000,0,0
2021-08-09,Brazil,203070494,Mato Grosso,3658649,0.4834,18229,1768541,0.1524,8710,557632,0.0000,0,0
2021-08-10,Brazil,203070494,Mato Grosso,3658649,0.4884,18299,1786840,0.1551,9868,567500,0.0000,0,0
2021-08-11,Brazil,203070494,Mato Grosso,3658649,0.4952,25037,1811877,0.1577,9517,577017,0.0000,0,0
2021-08-12,Brazil,203070494,Mato Grosso,3658649,0.5013,22265,1834142,0.1606,10583,587600,0.0000,0,0
2021-08-13,Brazil,203070494,Mato Grosso,3658649,0.5068,19901,1854043,0.1639,11956,599556,0.0000,0,0
2021-08-14,Brazil,203070494,Mato Grosso,3658649,0.5099,11323,1865366,0.1648,3471,603027,0.0000,0,0
2021-08-15,Brazil,203070494,Mato Grosso,3658649,0.5105,2228,1867594,0.1648,20,603047,0.0000,0,0
2021-08-16,Brazil,203070494,Mato Grosso,3658649,0.5135,11286,1878880,0.1681,11839,614886,0.0000,0,0
2021-08-17,Brazil,203070494,Mato Grosso,3658649,0.5183,17466,1896346,0.1714,12311,627197,0.0000,0,0
2021-08-18,Brazil,203070494,Mato Grosso,3658649,0.5234,18649,1914995,0.1744,10709,637906,0.0000,0,0
2021-08-19,Brazil,203070494,Mato Grosso,3658649,0.5295,22356,1937351,0.1770,9766,647672,0.0000,0,0
2021-08-20,Brazil,203070494,Mato Grosso,3658649,0.5354,21420,1958771,0.1798,10097,657769,0.0000,0,0
2021-08-21,Brazil,203070494,Mato Grosso,3658649,0.5398,15986,1974757,0.1809,4000,661769,0.0000,0,0
2021-08-22,Brazil,203070494,Mato Grosso,3658649,0.5414,6076,1980833,0.1809,31,661800,0.0000,0,0
2021-08-23,Brazil,203070494,Mato Grosso,3658649,0.5468,19713,2000546,0.1831,8070,669870,0.0000,0,0
2021-08-24,Brazil,203070494,Mato Grosso,3658649,0.5523,20099,2020645,0.1871,14774,684644,0.0000,0,0
2021-08-25,Brazil,203070494,Mato Grosso,3658649,0.5583,22008,2042653,0.1909,13621,698265,0.0000,0,0
2021-08-26,Brazil,203070494,Mato Grosso,3658649,0.5645,22646,2065299,0.1948,14380,712645,0.0000,0,0
2021-08-27,Brazil,203070494,Mato Grosso,3658649,0.5702,20694,2085993,0.1986,14099,726744,0.0000,0,0
2021-08-28,Brazil,203070494,Mato Grosso,3658649,0.5734,11804,2097797,0.2007,7469,734213,0.0000,0,0
2021-08-29,Brazil,203070494,Mato Grosso,3658649,0.5735,298,2098095,0.2007,10,734223,0.0000,0,0
2021-08-30,Brazil,203070494,Mato Grosso,3658649,0.5767,11943,2110038,0.2054,17283,751506,0.0000,0,0
2021-08-31,Brazil,203070494,Mato Grosso,3658649,0.5807,14595,2124633,0.2106,18874,770380,0.0000,0,0
2021-09-01,Brazil,203070494,Mato Grosso,3658649,0.5860,19265,2143898,0.2147,15283,785663,0.0000,0,0
2021-09-02,Brazil,203070494,Mato Grosso,3658649,0.5898,13809,2157707,0.2199,18991,804654,0.0000,0,0
2021-09-03,Brazil,203070494,Mato Grosso,3658649,0.5934,13192,2170899,0.2248,17743,822397,0.0000,0,0
2021-09-04,Brazil,203070494,Mato Grosso,3658649,0.5950,6048,2176947,0.2271,8358,830755,0.0000,0,0
2021-09-05,Brazil,203070494,Mato Grosso,3658649,0.5950,20,2176967,0.2271,42,830797,0.0000,0,0
2021-09-06,Brazil,203070494,Mato Grosso,3658649,0.5958,2922,2179889,0.2289,6670,837467,0.0000,0,0
2021-09-07,Brazil,203070494,Mato Grosso,3658649,0.5960,577,2180466,0.2301,4562,842029,0.0000,0,0
2021-09-08,Brazil,203070494,Mato Grosso,3658649,0.5980,7382,2187848,0.2378,27959,869988,0.0000,0,0
2021-09-09,Brazil,203070494,Mato Grosso,3658649,0.6005,9036,2196884,0.2449,26143,896131,0.0000,0,0
2021-09-10,Brazil,203070494,Mato Grosso,3658649,0.6036,11546,2208430,0.2528,28731,924862,0.0000,0,0
2021-09-11,Brazil,203070494,Mato Grosso,3658649,0.6050,5007,2213437,0.2549,7838,932700,0.0000,0,0
2021-09-12,Brazil,203070494,Mato Grosso,3658649,0.6050,73,2213510,0.2554,1837,934537,0.0000,0,0
2021-09-13,Brazil,203070494,Mato Grosso,3658649,0.6080,11127,2224637,0.2606,18907,953444,0.0000,0,0
2021-09-14,Brazil,203070494,Mato Grosso,3658649,0.6114,12167,2236804,0.2654,17379,970823,0.0000,0,0
2021-09-15,Brazil,203070494,Mato Grosso,3658649,0.6153,14199,2251003,0.2700,16923,987746,0.0000,0,0
2021-09-16,Brazil,203070494,Mato Grosso,3658649,0.6176,8683,2259686,0.2750,18341,1006087,0.0000,0,0
2021-09-17,Brazil,203070494,Mato Grosso,3658649,0.6214,13679,2273365,0.2799,17896,1023983,0.0000,0,0
2021-09-18,Brazil,203070494,Mato Grosso,3658649,0.6221,2772,2276137,0.2816,6268,1030251,0.0000,0,0
2021-09-19,Brazil,203070494,Mato Grosso,3658649,0.6221,21,2276158,0.2816,31,1030282,0.0000,0,0
2021-09-20,Brazil,203070494,Mato Grosso,3658649,0.6242,7488,2283646,0.2858,15320,1045602,0.0000,0,0
2021-09-21,Brazil,203070494,Mato Grosso,3658649,0.6263,7802,2291448,0.2911,19583,1065185,0.0000,0,0
2021-09-22,Brazil,203070494,Mato Grosso,3658649,0.6296,12085,2303533,0.2958,17006,1082191,0.0000,0,0
2021-09-23,Brazil,203070494,Mato Grosso,3658649,0.6326,11012,2314545,0.3011,19481,1101672,0.0000,0,0
2021-09-24,Brazil,203070494,Mato Grosso,3658649,0.6359,11882,2326427,0.3072,22426,1124098,0.0000,0,0
2021-09-25,Brazil,203070494,Mato Grosso,3658649,0.6366,2513,2328940,0.3089,6232,1130330,0.0000,0,0
2021-09-26,Brazil,203070494,Mato Grosso,3658649,0.6366,21,2328961,0.3094,1496,1131826,0.0000,0,0
2021-09-27,Brazil,203070494,Mato Grosso,3658649,0.6400,12534,2341495,0.3135,15000,1146826,0.0000,0,0
2021-09-28,Brazil,203070494,Mato Grosso,3658649,0.6428,10119,2351614,0.3179,16434,1163260,0.0000,0,0
2021-09-29,Brazil,203070494,Mato Grosso,3658649,0.6452,8801,2360415,0.3236,20702,1183962,0.0000,11,11
2021-09-30,Brazil,203070494,Mato Grosso,3658649,0.6487,13070,2373485,0.3295,21516,1205478,0.0000,9,20
2021-10-01,Brazil,203070494,Mato Grosso,3658649,0.6509,7871,2381356,0.3355,22157,1227635,0.0000,5,25
2021-10-02,Brazil,203070494,Mato Grosso,3658649,0.6519,3758,2385114,0.3370,5448,1233083,0.0000,9,34
2021-10-03,Brazil,203070494,Mato Grosso,3658649,0.6520,173,2385287,0.3370,10,1233093,0.0000,0,34
2021-10-04,Brazil,203070494,Mato Grosso,3658649,0.6546,9496,2394783,0.3441,25773,1258866,0.0000,1,35
2021-10-05,Brazil,203070494,Mato Grosso,3658649,0.6576,11320,2406103,0.3500,21488,1280354,0.0000,53,88
2021-10-06,Brazil,203070494,Mato Grosso,3658649,0.6611,12811,2418914,0.3559,21721,1302075,0.0000,53,141
2021-10-07,Brazil,203070494,Mato Grosso,3658649,0.6644,11921,2430835,0.3614,20231,1322306,0.0000,38,179
2021-10-08,Brazil,203070494,Mato Grosso,3658649,0.6679,12796,2443631,0.3669,19944,1342250,0.0001,52,231
2021-10-09,Brazil,203070494,Mato Grosso,3658649,0.6699,7431,2451062,0.3684,5674,1347924,0.0001,0,231
2021-10-10,Brazil,203070494,Mato Grosso,3658649,0.6700,79,2451141,0.3686,521,1348445,0.0001,0,231
2021-10-11,Brazil,203070494,Mato Grosso,3658649,0.6711,4287,2455428,0.3702,5831,1354276,0.0001,0,231
2021-10-12,Brazil,203070494,Mato Grosso,3658649,0.6712,410,2455838,0.3705,1241,1355517,0.0001,0,231
2021-10-13,Brazil,203070494,Mato Grosso,3658649,0.6735,8419,2464257,0.3782,28220,1383737,0.0001,85,316
2021-10-14,Brazil,203070494,Mato Grosso,3658649,0.6767,11570,2475827,0.3849,24477,1408214,0.0001,88,404
2021-10-15,Brazil,203070494,Mato Grosso,3658649,0.6802,12899,2488726,0.3921,26476,1434690,0.0001,84,488
2021-10-16,Brazil,203070494,Mato Grosso,3658649,0.6818,5617,2494343,0.3960,14015,1448705,0.0001,16,504
2021-10-17,Brazil,203070494,Mato Grosso,3658649,0.6818,10,2494353,0.3960,18,1448723,0.0001,0,504
2021-10-18,Brazil,203070494,Mato Grosso,3658649,0.6838,7283,2501636,0.4027,24585,1473308,0.0002,54,558
2021-10-19,Brazil,203070494,Mato Grosso,3658649,0.6864,9821,2511457,0.4095,24784,1498092,0.0002,44,602
2021-10-20,Brazil,203070494,Mato Grosso,3658649,0.6885,7481,2518938,0.4161,24132,1522224,0.0002,32,634
2021-10-21,Brazil,203070494,Mato Grosso,3658649,0.6914,10623,2529561,0.4216,20171,1542395,0.0002,13,647
2021-10-22,Brazil,203070494,Mato Grosso,3658649,0.6933,6926,2536487,0.4267,18767,1561162,0.0002,10,657
2021-10-23,Brazil,203070494,Mato Grosso,3658649,0.6948,5676,2542163,0.4293,9535,1570697,0.0002,0,657
2021-10-24,Brazil,203070494,Mato Grosso,3658649,0.6948,49,2542212,0.4295,710,1571407,0.0002,0,657
2021-10-25,Brazil,203070494,Mato Grosso,3658649,0.6963,5152,2547364,0.4341,16869,1588276,0.0002,26,683
2021-10-26,Brazil,203070494,Mato Grosso,3658649,0.6982,7127,2554491,0.4398,20915,1609191,0.0002,1,684
2021-10-27,Brazil,203070494,Mato Grosso,3658649,0.7000,6476,2560967,0.4442,15915,1625106,0.0002,2,686
2021-10-28,Brazil,203070494,Mato Grosso,3658649,0.7014,5218,2566185,0.4480,13965,1639071,0.0002,0,686
2021-10-29,Brazil,203070494,Mato Grosso,3658649,0.7023,3459,2569644,0.4511,11193,1650264,0.0002,20,706
2021-10-30,Brazil,203070494,Mato Grosso,3658649,0.7027,1213,2570857,0.4518,2677,1652941,0.0002,19,725
2021-10-31,Brazil,203070494,Mato Grosso,3658649,0.7027,199,2571056,0.4520,671,1653612,0.0002,0,725
2021-11-01,Brazil,203070494,Mato Grosso,3658649,0.7029,493,2571549,0.4525,1820,1655432,0.0002,0,725
2021-11-02,Brazil,203070494,Mato Grosso,3658649,0.7029,148,2571697,0.4525,94,1655526,0.0002,0,725
2021-11-03,Brazil,203070494,Mato Grosso,3658649,0.7036,2626,2574323,0.4570,16456,1671982,0.0002,6,731
2021-11-04,Brazil,203070494,Mato Grosso,3658649,0.7052,5748,2580071,0.4615,16530,1688512,0.0002,13,744
2021-11-05,Brazil,203070494,Mato Grosso,3658649,0.7067,5473,2585544,0.4655,14443,1702955,0.0002,20,764
2021-11-06,Brazil,203070494,Mato Grosso,3658649,0.7077,3609,2589153,0.4673,6656,1709611,0.0002,21,785
2021-11-07,Brazil,203070494,Mato Grosso,3658649,0.7077,223,2589376,0.4677,1575,1711186,0.0002,0,785
2021-11-08,Brazil,203070494,Mato Grosso,3658649,0.7085,2614,2591990,0.4712,12590,1723776,0.0002,1,786
2021-11-09,Brazil,203070494,Mato Grosso,3658649,0.7092,2757,2594747,0.4748,13487,1737263,0.0002,16,802
2021-11-10,Brazil,203070494,Mato Grosso,3658649,0.7102,3477,2598224,0.4779,11045,1748308,0.0002,15,817
2021-11-11,Brazil,203070494,Mato Grosso,3658649,0.7112,3674,2601898,0.4820,15301,1763609,0.0002,6,823
2021-11-12,Brazil,203070494,Mato Grosso,3658649,0.7120,3193,2605091,0.4856,13122,1776731,0.0002,5,828
2021-11-13,Brazil,203070494,Mato Grosso,3658649,0.7122,631,2605722,0.4869,4577,1781308,0.0002,0,828
2021-11-14,Brazil,203070494,Mato Grosso,3658649,0.7122,131,2605853,0.4872,1056,1782364,0.0002,0,828
2021-11-15,Brazil,203070494,Mato Grosso,3658649,0.7123,261,2606114,0.4873,422,1782786,0.0002,0,828
2021-11-16,Brazil,203070494,Mato Grosso,3658649,0.7136,4559,2610673,0.4918,16432,1799218,0.0002,10,838
2021-11-17,Brazil,203070494,Mato Grosso,3658649,0.7145,3286,2613959,0.4959,15022,1814240,0.0002,11,849
2021-11-18,Brazil,203070494,Mato Grosso,3658649,0.7153,2978,2616937,0.5003,16259,1830499,0.0002,34,883
2021-11-19,Brazil,203070494,Mato Grosso,3658649,0.7160,2778,2619715,0.5045,15223,1845722,0.0002,9,892
2021-11-20,Brazil,203070494,Mato Grosso,3658649,0.7163,838,2620553,0.5057,4530,1850252,0.0002,0,892
2021-11-21,Brazil,203070494,Mato Grosso,3658649,0.7163,127,2620680,0.5057,20,1850272,0.0002,0,892
2021-11-22,Brazil,203070494,Mato Grosso,3658649,0.7171,2757,2623437,0.5095,13847,1864119,0.0002,22,914
2021-11-23,Brazil,203070494,Mato Grosso,3658649,0.7178,2853,2626290,0.5131,13253,1877372,0.0003,4,918
2021-11-24,Brazil,203070494,Mato Grosso,3658649,0.7186,2666,2628956,0.5164,11815,1889187,0.0003,23,941
2021-11-25,Brazil,203070494,Mato Grosso,3658649,0.7194,2998,2631954,0.5202,13910,1903097,0.0003,11,952
2021-11-26,Brazil,203070494,Mato Grosso,3658649,0.7201,2752,2634706,0.5236,12465,1915562,0.0003,4,956
2021-11-27,Brazil,203070494,Mato Grosso,3658649,0.7204,1099,2635805,0.5249,4741,1920303,0.0003,0,956
2021-11-28,Brazil,203070494,Mato Grosso,3658649,0.7205,164,2635969,0.5249,23,1920326,0.0003,0,956
2021-11-29,Brazil,203070494,Mato Grosso,3658649,0.7211,2324,2638293,0.5280,11414,1931740,0.0003,9,965
2021-11-30,Brazil,203070494,Mato Grosso,3658649,0.7219,2710,2641003,0.5318,13867,1945607,0.0003,0,965
2021-12-01,Brazil,203070494,Mato Grosso,3658649,0.7227,2992,2643995,0.5356,13949,1959556,0.0003,0,965
2021-12-02,Brazil,203070494,Mato Grosso,3658649,0.7236,3456,2647451,0.5396,14753,1974309,0.0003,0,965
2021-12-03,Brazil,203070494,Mato Grosso,3658649,0.7243,2650,2650101,0.5437,14834,1989143,0.0003,2,967
2021-12-04,Brazil,203070494,Mato Grosso,3658649,0.7246,1090,2651191,0.5452,5397,1994540,0.0003,0,967
2021-12-05,Brazil,203070494,Mato Grosso,3658649,0.7246,14,2651205,0.5452,16,1994556,0.0003,0,967
2021-12-06,Brazil,203070494,Mato Grosso,3658649,0.7254,2782,2653987,0.5489,13634,2008190,0.0003,0,967
2021-12-07,Brazil,203070494,Mato Grosso,3658649,0.7261,2729,2656716,0.5521,11769,2019959,0.0003,5,972
2021-12-08,Brazil,203070494,Mato Grosso,3658649,0.7268,2332,2659048,0.5548,9713,2029672,0.0003,19,991
2021-12-09,Brazil,203070494,Mato Grosso,3658649,0.7275,2692,2661740,0.5580,11923,2041595,0.0003,15,1006
2021-12-10,Brazil,203070494,Mato Grosso,3658649,0.7284,3280,2665020,0.5610,11027,2052622,0.0003,28,1034
2021-12-11,Brazil,203070494,Mato Grosso,3658649,0.7286,671,2665691,0.5615,1590,2054212,0.0003,0,1034
2021-12-12,Brazil,203070494,Mato Grosso,3658649,0.7286,12,2665703,0.5615,80,2054292,0.0003,0,1034
2021-12-13,Brazil,203070494,Mato Grosso,3658649,0.7291,1797,2667500,0.5636,7864,2062156,0.0003,20,1054
2021-12-14,Brazil,203070494,Mato Grosso,3658649,0.7296,1828,2669328,0.5664,10183,2072339,0.0003,27,1081
2021-12-15,Brazil,203070494,Mato Grosso,3658649,0.7301,1889,2671217,0.5691,9746,2082085,0.0003,38,1119
2021-12-16,Brazil,203070494,Mato Grosso,3658649,0.7306,1791,2673008,0.5715,8920,2091005,0.0003,33,1152
2021-12-17,Brazil,203070494,Mato Grosso,3658649,0.7310,1438,2674446,0.5738,8494,2099499,0.0003,1,1153
2021-12-18,Brazil,203070494,Mato Grosso,3658649,0.7311,421,2674867,0.5744,2084,2101583,0.0003,0,1153
2021-12-19,Brazil,203070494,Mato Grosso,3658649,0.7311,11,2674878,0.5744,93,2101676,0.0003,0,1153
2021-12-20,Brazil,203070494,Mato Grosso,3658649,0.7314,1151,2676029,0.5761,5949,2107625,0.0003,0,1153
2021-12-21,Brazil,203070494,Mato Grosso,3658649,0.7317,1035,2677064,0.5777,5947,2113572,0.0003,0,1153
2021-12-22,Brazil,203070494,Mato Grosso,3658649,0.7320,972,2678036,0.5790,4909,2118481,0.0003,0,1153
2021-12-23,Brazil,203070494,Mato Grosso,3658649,0.7322,684,2678720,0.5799,3268,2121749,0.0003,36,1189
2021-12-24,Brazil,203070494,Mato Grosso,3658649,0.7322,38,2678758,0.5800,244,2121993,0.0003,0,1189
2021-12-25,Brazil,203070494,Mato Grosso,3658649,0.7322,2,2678760,0.5800,8,2122001,0.0003,0,1189
2021-12-26,Brazil,203070494,Mato Grosso,3658649,0.7322,2,2678762,0.5800,10,2122011,0.0003,0,1189
2021-12-27,Brazil,203070494,Mato Grosso,3658649,0.7323,603,2679365,0.5808,2892,2124903,0.0003,0,1189
2021-12-28,Brazil,203070494,Mato Grosso,3658649,0.7326,831,2680196,0.5818,3694,2128597,0.0003,1,1190
2021-12-29,Brazil,203070494,Mato Grosso,3658649,0.7328,794,2680990,0.5827,3477,2132074,0.0003,0,1190
2021-12-30,Brazil,203070494,Mato Grosso,3658649,0.7329,484,2681474,0.5834,2456,2134530,0.0003,0,1190
2021-12-31,Brazil,203070494,Mato Grosso,3658649,0.7329,38,2681512,0.5835,113,2134643,0.0003,1,1191
2021-01-01,Brazil,203070494,Mato Grosso do Sul,2757013,0.0000,0,0,0.0000,0,0,0.0000,0,0
2021-01-04,Brazil,203070494,Mato Grosso do Sul,2757013,0.0000,0,0,0.0000,5,5,0.0000,0,0
2021-01-05,Brazil,203070494,Mato Grosso do Sul,2757013,0.0000,0,0,0.0000,1,6,0.0000,0,0
2021-01-06,Brazil,203070494,Mato Grosso do Sul,2757013,0.0000,1,1,0.0000,5,11,0.0000,0,0
2021-01-07,Brazil,203070494,Mato Grosso do Sul,2757013,0.0000,1,2,0.0000,3,14,0.0000,0,0
2021-01-08,Brazil,203070494,Mato Grosso do Sul,2757013,0.0000,0,2,0.0000,2,16,0.0000,0,0
2021-01-09,Brazil,203070494,Mato Grosso do Sul,2757013,0.0000,0,2,0.0000,2,18,0.0000,0,0
2021-01-11,Brazil,203070494,Mato Grosso do Sul,2757013,0.0000,2,4,0.0000,0,18,0.0000,0,0
2021-01-13,Brazil,203070494,Mato Grosso do Sul,2757013,0.0000,1,5,0.0000,0,18,0.0000,0,0
2021-01-15,Brazil,203070494,Mato Grosso do Sul,2757013,0.0000,1,6,0.0000,1,19,0.0000,0,0
2021-01-17,Brazil,203070494,Mato Grosso do Sul,2757013,0.0000,12,18,0.0000,2,21,0.0000,0,0
2021-01-18,Brazil,203070494,Mato Grosso do Sul,2757013,0.0000,19,37,0.0000,3,24,0.0000,0,0
2021-01-19,Brazil,203070494,Mato Grosso do Sul,2757013,0.0016,4290,4327,0.0000,32,56,0.0000,1,1
2021-01-20,Brazil,203070494,Mato Grosso do Sul,2757013,0.0041,6936,11263,0.0000,13,69,0.0000,0,1
2021-01-21,Brazil,203070494,Mato Grosso do Sul,2757013,0.0067,7112,18375,0.0000,20,89,0.0000,0,1
2021-01-22,Brazil,203070494,Mato Grosso do Sul,2757013,0.0091,6629,25004,0.0000,40,129,0.0000,0,1
2021-01-23,Brazil,203070494,Mato Grosso do Sul,2757013,0.0101,2959,27963,0.0001,13,142,0.0000,0,1
2021-01-24,Brazil,203070494,Mato Grosso do Sul,2757013,0.0112,2781,30744,0.0001,4,146,0.0000,0,1
2021-01-25,Brazil,203070494,Mato Grosso do Sul,2757013,0.0129,4726,35470,0.0001,8,154,0.0000,0,1
2021-01-26,Brazil,203070494,Mato Grosso do Sul,2757013,0.0159,8297,43767,0.0001,11,165,0.0000,0,1
2021-01-27,Brazil,203070494,Mato Grosso do Sul,2757013,0.0184,6826,50593,0.0001,14,179,0.0000,0,1
2021-01-28,Brazil,203070494,Mato Grosso do Sul,2757013,0.0207,6368,56961,0.0001,10,189,0.0000,0,1
2021-01-29,Brazil,203070494,Mato Grosso do Sul,2757013,0.0227,5547,62508,0.0001,12,201,0.0000,0,1
2021-01-30,Brazil,203070494,Mato Grosso do Sul,2757013,0.0236,2483,64991,0.0001,3,204,0.0000,0,1
2021-01-31,Brazil,203070494,Mato Grosso do Sul,2757013,0.0239,792,65783,0.0001,7,211,0.0000,0,1
2021-02-01,Brazil,203070494,Mato Grosso do Sul,2757013,0.0254,4291,70074,0.0001,29,240,0.0000,0,1
2021-02-02,Brazil,203070494,Mato Grosso do Sul,2757013,0.0267,3596,73670,0.0002,423,663,0.0000,0,1
2021-02-03,Brazil,203070494,Mato Grosso do Sul,2757013,0.0281,3861,77531,0.0005,616,1279,0.0000,0,1
2021-02-04,Brazil,203070494,Mato Grosso do Sul,2757013,0.0293,3141,80672,0.0007,780,2059,0.0000,1,2
2021-02-05,Brazil,203070494,Mato Grosso do Sul,2757013,0.0301,2415,83087,0.0014,1669,3728,0.0000,0,2
2021-02-06,Brazil,203070494,Mato Grosso do Sul,2757013,0.0304,830,83917,0.0017,1039,4767,0.0000,0,2
2021-02-07,Brazil,203070494,Mato Grosso do Sul,2757013,0.0305,44,83961,0.0018,148,4915,0.0000,0,2
2021-02-08,Brazil,203070494,Mato Grosso do Sul,2757013,0.0313,2236,86197,0.0026,2142,7057,0.0000,0,2
2021-02-09,Brazil,203070494,Mato Grosso do Sul,2757013,0.0329,4596,90793,0.0036,2913,9970,0.0000,0,2
2021-02-10,Brazil,203070494,Mato Grosso do Sul,2757013,0.0349,5388,96181,0.0055,5100,15070,0.0000,0,2
2021-02-11,Brazil,203070494,Mato Grosso do Sul,2757013,0.0371,6236,102417,0.0075,5616,20686,0.0000,1,3
2021-02-12,Brazil,203070494,Mato Grosso do Sul,2757013,0.0394,6206,108623,0.0095,5480,26166,0.0000,0,3
2021-02-13,Brazil,203070494,Mato Grosso do Sul,2757013,0.0403,2387,111010,0.0097,661,26827,0.0000,0,3
2021-02-14,Brazil,203070494,Mato Grosso do Sul,2757013,0.0403,17,111027,0.0098,86,26913,0.0000,0,3
2021-02-15,Brazil,203070494,Mato Grosso do Sul,2757013,0.0406,905,111932,0.0104,1695,28608,0.0000,1,4
2021-02-16,Brazil,203070494,Mato Grosso do Sul,2757013,0.0407,367,112299,0.0110,1725,30333,0.0000,0,4
2021-02-17,Brazil,203070494,Mato Grosso do Sul,2757013,0.0413,1446,113745,0.0119,2346,32679,0.0000,0,4
2021-02-18,Brazil,203070494,Mato Grosso do Sul,2757013,0.0418,1455,115200,0.0134,4358,37037,0.0000,0,4
2021-02-19,Brazil,203070494,Mato Grosso do Sul,2757013,0.0421,939,116139,0.0148,3739,40776,0.0000,0,4
2021-02-20,Brazil,203070494,Mato Grosso do Sul,2757013,0.0423,389,116528,0.0152,1123,41899,0.0000,0,4
2021-02-21,Brazil,203070494,Mato Grosso do Sul,2757013,0.0423,17,116545,0.0152,8,41907,0.0000,0,4
2021-02-22,Brazil,203070494,Mato Grosso do Sul,2757013,0.0425,608,117153,0.0161,2493,44400,0.0000,0,4
2021-02-23,Brazil,203070494,Mato Grosso do Sul,2757013,0.0427,637,117790,0.0173,3183,47583,0.0000,0,4
2021-02-24,Brazil,203070494,Mato Grosso do Sul,2757013,0.0430,629,118419,0.0182,2572,50155,0.0000,0,4
2021-02-25,Brazil,203070494,Mato Grosso do Sul,2757013,0.0432,715,119134,0.0188,1791,51946,0.0000,0,4
2021-02-26,Brazil,203070494,Mato Grosso do Sul,2757013,0.0435,808,119942,0.0195,1831,53777,0.0000,0,4
2021-02-27,Brazil,203070494,Mato Grosso do Sul,2757013,0.0447,3212,123154,0.0201,1533,55310,0.0000,0,4
2021-02-28,Brazil,203070494,Mato Grosso do Sul,2757013,0.0450,849,124003,0.0201,124,55434,0.0000,0,4
2021-03-01,Brazil,203070494,Mato Grosso do Sul,2757013,0.0460,2811,126814,0.0208,1929,57363,0.0000,0,4
2021-03-02,Brazil,203070494,Mato Grosso do Sul,2757013,0.0476,4405,131219,0.0216,2156,59519,0.0000,0,4
2021-03-03,Brazil,203070494,Mato Grosso do Sul,2757013,0.0488,3377,134596,0.0225,2643,62162,0.0000,0,4
2021-03-04,Brazil,203070494,Mato Grosso do Sul,2757013,0.0505,4614,139210,0.0235,2504,64666,0.0000,0,4
2021-03-05,Brazil,203070494,Mato Grosso do Sul,2757013,0.0521,4412,143622,0.0245,2919,67585,0.0000,0,4
2021-03-06,Brazil,203070494,Mato Grosso do Sul,2757013,0.0528,1998,145620,0.0248,747,68332,0.0000,0,4
2021-03-07,Brazil,203070494,Mato Grosso do Sul,2757013,0.0530,475,146095,0.0248,115,68447,0.0000,0,4
2021-03-08,Brazil,203070494,Mato Grosso do Sul,2757013,0.0539,2482,148577,0.0257,2384,70831,0.0000,0,4
2021-03-09,Brazil,203070494,Mato Grosso do Sul,2757013,0.0548,2454,151031,0.0269,3381,74212,0.0000,0,4
2021-03-10,Brazil,203070494,Mato Grosso do Sul,2757013,0.0558,2690,153721,0.0282,3408,77620,0.0000,0,4
2021-03-11,Brazil,203070494,Mato Grosso do Sul,2757013,0.0576,5092,158813,0.0296,3929,81549,0.0000,0,4
2021-03-12,Brazil,203070494,Mato Grosso do Sul,2757013,0.0598,6094,164907,0.0310,3885,85434,0.0000,1,5
2021-03-13,Brazil,203070494,Mato Grosso do Sul,2757013,0.0607,2517,167424,0.0315,1521,86955,0.0000,0,5
2021-03-14,Brazil,203070494,Mato Grosso do Sul,2757013,0.0609,549,167973,0.0315,24,86979,0.0000,1,6
2021-03-15,Brazil,203070494,Mato Grosso do Sul,2757013,0.0628,5197,173170,0.0319,1055,88034,0.0000,0,6
2021-03-16,Brazil,203070494,Mato Grosso do Sul,2757013,0.0644,4244,177414,0.0322,677,88711,0.0000,1,7
2021-03-17,Brazil,203070494,Mato Grosso do Sul,2757013,0.0660,4594,182008,0.0324,539,89250,0.0000,0,7
2021-03-18,Brazil,203070494,Mato Grosso do Sul,2757013,0.0679,5266,187274,0.0327,866,90116,0.0000,0,7
2021-03-19,Brazil,203070494,Mato Grosso do Sul,2757013,0.0721,11448,198722,0.0332,1297,91413,0.0000,4,11
2021-03-20,Brazil,203070494,Mato Grosso do Sul,2757013,0.0744,6477,205199,0.0333,273,91686,0.0000,0,11
2021-03-21,Brazil,203070494,Mato Grosso do Sul,2757013,0.0749,1385,206584,0.0333,46,91732,0.0000,0,11
2021-03-22,Brazil,203070494,Mato Grosso do Sul,2757013,0.0794,12426,219010,0.0337,1123,92855,0.0000,0,11
2021-03-23,Brazil,203070494,Mato Grosso do Sul,2757013,0.0865,19406,238416,0.0340,991,93846,0.0000,0,11
2021-03-24,Brazil,203070494,Mato Grosso do Sul,2757013,0.0928,17369,255785,0.0344,873,94719,0.0000,0,11
2021-03-25,Brazil,203070494,Mato Grosso do Sul,2757013,0.0986,16166,271951,0.0348,1242,95961,0.0000,0,11
2021-03-26,Brazil,203070494,Mato Grosso do Sul,2757013,0.1013,7215,279166,0.0354,1508,97469,0.0000,0,11
2021-03-27,Brazil,203070494,Mato Grosso do Sul,2757013,0.1063,13923,293089,0.0359,1558,99027,0.0000,0,11
2021-03-28,Brazil,203070494,Mato Grosso do Sul,2757013,0.1077,3846,296935,0.0361,415,99442,0.0000,0,11
2021-03-29,Brazil,203070494,Mato Grosso do Sul,2757013,0.1109,8738,305673,0.0366,1590,101032,0.0000,0,11
2021-03-30,Brazil,203070494,Mato Grosso do Sul,2757013,0.1154,12399,318072,0.0373,1854,102886,0.0000,0,11
2021-03-31,Brazil,203070494,Mato Grosso do Sul,2757013,0.1187,9082,327154,0.0378,1335,104221,0.0000,0,11
2021-04-01,Brazil,203070494,Mato Grosso do Sul,2757013,0.1205,5117,332271,0.0380,476,104697,0.0000,0,11
2021-04-02,Brazil,203070494,Mato Grosso do Sul,2757013,0.1234,7976,340247,0.0382,668,105365,0.0000,0,11
2021-04-03,Brazil,203070494,Mato Grosso do Sul,2757013,0.1306,19866,360113,0.0388,1727,107092,0.0000,0,11
2021-04-04,Brazil,203070494,Mato Grosso do Sul,2757013,0.1319,3534,363647,0.0391,577,107669,0.0000,0,11
2021-04-05,Brazil,203070494,Mato Grosso do Sul,2757013,0.1379,16505,380152,0.0407,4653,112322,0.0000,0,11
2021-04-06,Brazil,203070494,Mato Grosso do Sul,2757013,0.1426,13078,393230,0.0422,4136,116458,0.0000,0,11
2021-04-07,Brazil,203070494,Mato Grosso do Sul,2757013,0.1445,5295,398525,0.0454,8613,125071,0.0000,0,11
2021-04-08,Brazil,203070494,Mato Grosso do Sul,2757013,0.1463,4848,403373,0.0472,5098,130169,0.0000,0,11
2021-04-09,Brazil,203070494,Mato Grosso do Sul,2757013,0.1483,5371,408744,0.0528,15521,145690,0.0000,0,11
2021-04-10,Brazil,203070494,Mato Grosso do Sul,2757013,0.1500,4937,413681,0.0550,5983,151673,0.0000,0,11
2021-04-11,Brazil,203070494,Mato Grosso do Sul,2757013,0.1505,1193,414874,0.0551,249,151922,0.0000,0,11
2021-04-12,Brazil,203070494,Mato Grosso do Sul,2757013,0.1512,1904,416778,0.0570,5270,157192,0.0000,0,11
2021-04-13,Brazil,203070494,Mato Grosso do Sul,2757013,0.1522,2837,419615,0.0591,5750,162942,0.0000,0,11
2021-04-14,Brazil,203070494,Mato Grosso do Sul,2757013,0.1532,2652,422267,0.0605,3819,166761,0.0000,0,11
2021-04-15,Brazil,203070494,Mato Grosso do Sul,2757013,0.1539,1904,424171,0.0618,3752,170513,0.0000,0,11
2021-04-16,Brazil,203070494,Mato Grosso do Sul,2757013,0.1557,5185,429356,0.0649,8310,178823,0.0000,0,11
2021-04-17,Brazil,203070494,Mato Grosso do Sul,2757013,0.1594,10142,439498,0.0677,7790,186613,0.0000,0,11
2021-04-18,Brazil,203070494,Mato Grosso do Sul,2757013,0.1616,6146,445644,0.0680,916,187529,0.0000,0,11
2021-04-19,Brazil,203070494,Mato Grosso do Sul,2757013,0.1643,7360,453004,0.0711,8573,196102,0.0000,0,11
2021-04-20,Brazil,203070494,Mato Grosso do Sul,2757013,0.1662,5214,458218,0.0738,7312,203414,0.0000,0,11
2021-04-21,Brazil,203070494,Mato Grosso do Sul,2757013,0.1668,1550,459768,0.0742,1211,204625,0.0000,1,12
2021-04-22,Brazil,203070494,Mato Grosso do Sul,2757013,0.1682,3943,463711,0.0758,4283,208908,0.0000,0,12
2021-04-23,Brazil,203070494,Mato Grosso do Sul,2757013,0.1703,5770,469481,0.0786,7786,216694,0.0000,0,12
2021-04-24,Brazil,203070494,Mato Grosso do Sul,2757013,0.1739,9885,479366,0.0796,2714,219408,0.0000,0,12
2021-04-25,Brazil,203070494,Mato Grosso do Sul,2757013,0.1751,3423,482789,0.0798,644,220052,0.0000,0,12
2021-04-26,Brazil,203070494,Mato Grosso do Sul,2757013,0.1774,6397,489186,0.0812,3784,223836,0.0000,0,12
2021-04-27,Brazil,203070494,Mato Grosso do Sul,2757013,0.1799,6681,495867,0.0823,3041,226877,0.0000,0,12
2021-04-28,Brazil,203070494,Mato Grosso do Sul,2757013,0.1812,3687,499554,0.0829,1617,228494,0.0000,0,12
2021-04-29,Brazil,203070494,Mato Grosso do Sul,2757013,0.1830,4974,504528,0.0834,1322,229816,0.0000,0,12
2021-04-30,Brazil,203070494,Mato Grosso do Sul,2757013,0.1875,12407,516935,0.0837,812,230628,0.0000,0,12
2021-05-01,Brazil,203070494,Mato Grosso do Sul,2757013,0.1916,11171,528106,0.0837,139,230767,0.0000,0,12
2021-05-02,Brazil,203070494,Mato Grosso do Sul,2757013,0.1943,7681,535787,0.0837,28,230795,0.0000,0,12
2021-05-03,Brazil,203070494,Mato Grosso do Sul,2757013,0.2001,15798,551585,0.0842,1329,232124,0.0000,0,12
2021-05-04,Brazil,203070494,Mato Grosso do Sul,2757013,0.2083,22812,574397,0.0853,2933,235057,0.0000,0,12
2021-05-05,Brazil,203070494,Mato Grosso do Sul,2757013,0.2161,21268,595665,0.0859,1706,236763,0.0000,0,12
2021-05-06,Brazil,203070494,Mato Grosso do Sul,2757013,0.2230,19076,614741,0.0866,1991,238754,0.0000,0,12
2021-05-07,Brazil,203070494,Mato Grosso do Sul,2757013,0.2289,16372,631113,0.0873,2021,240775,0.0000,0,12
2021-05-08,Brazil,203070494,Mato Grosso do Sul,2757013,0.2311,5903,637016,0.0883,2681,243456,0.0000,0,12
2021-05-09,Brazil,203070494,Mato Grosso do Sul,2757013,0.2313,570,637586,0.0898,4144,247600,0.0000,0,12
2021-05-10,Brazil,203070494,Mato Grosso do Sul,2757013,0.2343,8477,646063,0.0915,4698,252298,0.0000,0,12
2021-05-11,Brazil,203070494,Mato Grosso do Sul,2757013,0.2378,9626,655689,0.0929,3747,256045,0.0000,0,12
2021-05-12,Brazil,203070494,Mato Grosso do Sul,2757013,0.2416,10475,666164,0.0934,1390,257435,0.0000,0,12
2021-05-13,Brazil,203070494,Mato Grosso do Sul,2757013,0.2448,8729,674893,0.0938,1258,258693,0.0000,0,12
2021-05-14,Brazil,203070494,Mato Grosso do Sul,2757013,0.2472,6749,681642,0.0961,6385,265078,0.0000,0,12
2021-05-15,Brazil,203070494,Mato Grosso do Sul,2757013,0.2487,3924,685566,0.1013,14074,279152,0.0000,1,13
2021-05-16,Brazil,203070494,Mato Grosso do Sul,2757013,0.2493,1730,687296,0.1035,6179,285331,0.0000,0,13
2021-05-17,Brazil,203070494,Mato Grosso do Sul,2757013,0.2516,6468,693764,0.1060,6840,292171,0.0000,1,14
2021-05-18,Brazil,203070494,Mato Grosso do Sul,2757013,0.2540,6617,700381,0.1138,21672,313843,0.0000,2,16
2021-05-19,Brazil,203070494,Mato Grosso do Sul,2757013,0.2578,10280,710661,0.1217,21786,335629,0.0000,0,16
2021-05-20,Brazil,203070494,Mato Grosso do Sul,2757013,0.2636,16037,726698,0.1249,8710,344339,0.0000,1,17
2021-05-21,Brazil,203070494,Mato Grosso do Sul,2757013,0.2681,12475,739173,0.1265,4299,348638,0.0000,0,17
2021-05-22,Brazil,203070494,Mato Grosso do Sul,2757013,0.2695,3744,742917,0.1275,2789,351427,0.0000,0,17
2021-05-23,Brazil,203070494,Mato Grosso do Sul,2757013,0.2698,894,743811,0.1277,745,352172,0.0000,1,18
2021-05-24,Brazil,203070494,Mato Grosso do Sul,2757013,0.2716,4984,748795,0.1285,2239,354411,0.0000,0,18
2021-05-25,Brazil,203070494,Mato Grosso do Sul,2757013,0.2741,6930,755725,0.1311,7003,361414,0.0000,0,18
2021-05-26,Brazil,203070494,Mato Grosso do Sul,2757013,0.2770,8089,763814,0.1318,1972,363386,0.0000,0,18
2021-05-27,Brazil,203070494,Mato Grosso do Sul,2757013,0.2837,18333,782147,0.1327,2357,365743,0.0000,0,18
2021-05-28,Brazil,203070494,Mato Grosso do Sul,2757013,0.2917,22039,804186,0.1335,2334,368077,0.0000,0,18
2021-05-29,Brazil,203070494,Mato Grosso do Sul,2757013,0.2980,17539,821725,0.1337,483,368560,0.0000,0,18
2021-05-30,Brazil,203070494,Mato Grosso do Sul,2757013,0.3004,6523,828248,0.1338,226,368786,0.0000,0,18
2021-05-31,Brazil,203070494,Mato Grosso do Sul,2757013,0.3057,14471,842719,0.1346,2222,371008,0.0000,0,18
2021-06-01,Brazil,203070494,Mato Grosso do Sul,2757013,0.3086,8228,850947,0.1357,3095,374103,0.0000,0,18
2021-06-02,Brazil,203070494,Mato Grosso do Sul,2757013,0.3151,17848,868795,0.1365,2266,376369,0.0000,0,18
2021-06-03,Brazil,203070494,Mato Grosso do Sul,2757013,0.3234,22709,891504,0.1384,5294,381663,0.0000,0,18
2021-06-04,Brazil,203070494,Mato Grosso do Sul,2757013,0.3325,25210,916714,0.1393,2362,384025,0.0000,0,18
2021-06-05,Brazil,203070494,Mato Grosso do Sul,2757013,0.3364,10847,927561,0.1400,1957,385982,0.0000,0,18
2021-06-06,Brazil,203070494,Mato Grosso do Sul,2757013,0.3375,2860,930421,0.1401,287,386269,0.0000,0,18
2021-06-07,Brazil,203070494,Mato Grosso do Sul,2757013,0.3425,13748,944169,0.1406,1370,387639,0.0000,0,18
2021-06-08,Brazil,203070494,Mato Grosso do Sul,2757013,0.3479,15095,959264,0.1413,1800,389439,0.0000,1,19
2021-06-09,Brazil,203070494,Mato Grosso do Sul,2757013,0.3516,10191,969455,0.1419,1726,391165,0.0000,0,19
2021-06-10,Brazil,203070494,Mato Grosso do Sul,2757013,0.3601,23443,992898,0.1429,2903,394068,0.0000,0,19
2021-06-11,Brazil,203070494,Mato Grosso do Sul,2757013,0.3686,23311,1016209,0.1443,3821,397889,0.0000,4,23
2021-06-12,Brazil,203070494,Mato Grosso do Sul,2757013,0.3716,8376,1024585,0.1445,604,398493,0.0000,0,23
2021-06-13,Brazil,203070494,Mato Grosso do Sul,2757013,0.3722,1441,1026026,0.1446,196,398689,0.0000,0,23
2021-06-14,Brazil,203070494,Mato Grosso do Sul,2757013,0.3748,7378,1033404,0.1451,1441,400130,0.0000,0,23
2021-06-15,Brazil,203070494,Mato Grosso do Sul,2757013,0.3766,4757,1038161,0.1456,1302,401432,0.0000,0,23
2021-06-16,Brazil,203070494,Mato Grosso do Sul,2757013,0.3783,4723,1042884,0.1459,875,402307,0.0000,0,23
2021-06-17,Brazil,203070494,Mato Grosso do Sul,2757013,0.3790,1900,1044784,0.1463,1024,403331,0.0000,0,23
2021-06-18,Brazil,203070494,Mato Grosso do Sul,2757013,0.3831,11421,1056205,0.1470,1833,405164,0.0000,0,23
2021-06-19,Brazil,203070494,Mato Grosso do Sul,2757013,0.3914,22876,1079081,0.1473,935,406099,0.0000,0,23
2021-06-20,Brazil,203070494,Mato Grosso do Sul,2757013,0.3942,7666,1086747,0.1474,155,406254,0.0000,0,23
2021-06-21,Brazil,203070494,Mato Grosso do Sul,2757013,0.3975,9150,1095897,0.1509,9722,415976,0.0000,1,24
2021-06-22,Brazil,203070494,Mato Grosso do Sul,2757013,0.3994,5185,1101082,0.1562,14660,430636,0.0000,0,24
2021-06-23,Brazil,203070494,Mato Grosso do Sul,2757013,0.4004,2813,1103895,0.1599,10089,440725,0.0000,2,26
2021-06-24,Brazil,203070494,Mato Grosso do Sul,2757013,0.4022,4860,1108755,0.1632,9120,449845,0.0000,0,26
2021-06-25,Brazil,203070494,Mato Grosso do Sul,2757013,0.4107,23633,1132388,0.1651,5299,455144,0.0000,0,26
2021-06-26,Brazil,203070494,Mato Grosso do Sul,2757013,0.4219,30902,1163290,0.1664,3528,458672,0.0000,0,26
2021-06-27,Brazil,203070494,Mato Grosso do Sul,2757013,0.4232,3379,1166669,0.1669,1554,460226,0.0000,0,26
2021-06-28,Brazil,203070494,Mato Grosso do Sul,2757013,0.4257,7017,1173686,0.1691,6051,466277,0.0000,0,26
2021-06-29,Brazil,203070494,Mato Grosso do Sul,2757013,0.4276,5178,1178864,0.1715,6430,472707,0.0000,0,26
2021-06-30,Brazil,203070494,Mato Grosso do Sul,2757013,0.4289,3498,1182362,0.1736,5950,478657,0.0000,0,26
2021-07-01,Brazil,203070494,Mato Grosso do Sul,2757013,0.4335,12846,1195208,0.1762,7119,485776,0.0000,2,28
2021-07-02,Brazil,203070494,Mato Grosso do Sul,2757013,0.4581,67776,1262984,0.1797,9736,495512,0.0000,0,28
2021-07-03,Brazil,203070494,Mato Grosso do Sul,2757013,0.4757,48491,1311475,0.1822,6808,502320,0.0000,0,28
2021-07-04,Brazil,203070494,Mato Grosso do Sul,2757013,0.4824,18459,1329934,0.1843,5771,508091,0.0000,0,28
2021-07-05,Brazil,203070494,Mato Grosso do Sul,2757013,0.4901,21190,1351124,0.1887,12214,520305,0.0000,0,28
2021-07-06,Brazil,203070494,Mato Grosso do Sul,2757013,0.5001,27667,1378791,0.1958,19434,539739,0.0000,0,28
2021-07-07,Brazil,203070494,Mato Grosso do Sul,2757013,0.5067,18207,1396998,0.2001,11865,551604,0.0000,0,28
2021-07-08,Brazil,203070494,Mato Grosso do Sul,2757013,0.5116,13387,1410385,0.2028,7615,559219,0.0000,0,28
2021-07-09,Brazil,203070494,Mato Grosso do Sul,2757013,0.5185,19056,1429441,0.2052,6413,565632,0.0000,0,28
2021-07-10,Brazil,203070494,Mato Grosso do Sul,2757013,0.5290,29091,1458532,0.2064,3507,569139,0.0000,0,28
2021-07-11,Brazil,203070494,Mato Grosso do Sul,2757013,0.5332,11627,1470159,0.2066,374,569513,0.0000,0,28
2021-07-12,Brazil,203070494,Mato Grosso do Sul,2757013,0.5389,15539,1485698,0.2096,8330,577843,0.0000,0,28
2021-07-13,Brazil,203070494,Mato Grosso do Sul,2757013,0.5414,6904,1492602,0.2118,5975,583818,0.0000,0,28
2021-07-14,Brazil,203070494,Mato Grosso do Sul,2757013,0.5437,6347,1498949,0.2134,4497,588315,0.0000,0,28
2021-07-15,Brazil,203070494,Mato Grosso do Sul,2757013,0.5447,2885,1501834,0.2148,4025,592340,0.0000,0,28
2021-07-16,Brazil,203070494,Mato Grosso do Sul,2757013,0.5510,17183,1519017,0.2172,6389,598729,0.0000,0,28
2021-07-17,Brazil,203070494,Mato Grosso do Sul,2757013,0.5588,21524,1540541,0.2196,6701,605430,0.0000,0,28
2021-07-18,Brazil,203070494,Mato Grosso do Sul,2757013,0.5593,1577,1542118,0.2200,1130,606560,0.0000,0,28
2021-07-19,Brazil,203070494,Mato Grosso do Sul,2757013,0.5608,3892,1546010,0.2223,6337,612897,0.0000,0,28
2021-07-20,Brazil,203070494,Mato Grosso do Sul,2757013,0.5631,6548,1552558,0.2259,10030,622927,0.0000,0,28
2021-07-21,Brazil,203070494,Mato Grosso do Sul,2757013,0.5682,14108,1566666,0.2307,13197,636124,0.0000,1,29
2021-07-22,Brazil,203070494,Mato Grosso do Sul,2757013,0.5720,10336,1577002,0.2357,13624,649748,0.0000,0,29
2021-07-23,Brazil,203070494,Mato Grosso do Sul,2757013,0.5741,5744,1582746,0.2396,10759,660507,0.0000,1,30
2021-07-24,Brazil,203070494,Mato Grosso do Sul,2757013,0.5755,3792,1586538,0.2411,4156,664663,0.0000,0,30
2021-07-25,Brazil,203070494,Mato Grosso do Sul,2757013,0.5755,37,1586575,0.2412,286,664949,0.0000,0,30
2021-07-26,Brazil,203070494,Mato Grosso do Sul,2757013,0.5764,2459,1589034,0.2435,6500,671449,0.0000,0,30
2021-07-27,Brazil,203070494,Mato Grosso do Sul,2757013,0.5770,1865,1590899,0.2461,6915,678364,0.0000,0,30
2021-07-28,Brazil,203070494,Mato Grosso do Sul,2757013,0.5795,6886,1597785,0.2491,8526,686890,0.0000,1,31
2021-07-29,Brazil,203070494,Mato Grosso do Sul,2757013,0.5880,23415,1621200,0.2525,9337,696227,0.0000,1,32
2021-07-30,Brazil,203070494,Mato Grosso do Sul,2757013,0.5953,20126,1641326,0.2569,12144,708371,0.0000,0,32
2021-07-31,Brazil,203070494,Mato Grosso do Sul,2757013,0.5980,7314,1648640,0.2597,7734,716105,0.0000,0,32
2021-08-01,Brazil,203070494,Mato Grosso do Sul,2757013,0.6008,7737,1656377,0.2604,1763,717868,0.0000,0,32
2021-08-02,Brazil,203070494,Mato Grosso do Sul,2757013,0.6084,20921,1677298,0.2630,7198,725066,0.0000,0,32
2021-08-03,Brazil,203070494,Mato Grosso do Sul,2757013,0.6167,23025,1700323,0.2655,6931,731997,0.0000,0,32
2021-08-04,Brazil,203070494,Mato Grosso do Sul,2757013,0.6199,8870,1709193,0.2677,6022,738019,0.0000,0,32
2021-08-05,Brazil,203070494,Mato Grosso do Sul,2757013,0.6248,13421,1722614,0.2707,8353,746372,0.0000,0,32
2021-08-06,Brazil,203070494,Mato Grosso do Sul,2757013,0.6350,27966,1750580,0.2724,4533,750905,0.0000,0,32
2021-08-07,Brazil,203070494,Mato Grosso do Sul,2757013,0.6432,22745,1773325,0.2732,2256,753161,0.0000,0,32
2021-08-08,Brazil,203070494,Mato Grosso do Sul,2757013,0.6456,6521,1779846,0.2747,4235,757396,0.0000,0,32
2021-08-09,Brazil,203070494,Mato Grosso do Sul,2757013,0.6529,20310,1800156,0.2821,20247,777643,0.0000,0,32
2021-08-10,Brazil,203070494,Mato Grosso do Sul,2757013,0.6586,15579,1815735,0.2900,21808,799451,0.0000,1,33
2021-08-11,Brazil,203070494,Mato Grosso do Sul,2757013,0.6640,14893,1830628,0.2951,14064,813515,0.0000,2,35
2021-08-12,Brazil,203070494,Mato Grosso do Sul,2757013,0.6672,8719,1839347,0.2993,11678,825193,0.0000,0,35
2021-08-13,Brazil,203070494,Mato Grosso do Sul,2757013,0.6719,12953,1852300,0.3055,16949,842142,0.0000,0,35
2021-08-14,Brazil,203070494,Mato Grosso do Sul,2757013,0.6787,18790,1871090,0.3075,5563,847705,0.0000,1,36
2021-08-15,Brazil,203070494,Mato Grosso do Sul,2757013,0.6832,12630,1883720,0.3083,2151,849856,0.0000,0,36
2021-08-16,Brazil,203070494,Mato Grosso do Sul,2757013,0.6927,25991,1909711,0.3105,6113,855969,0.0000,0,36
2021-08-17,Brazil,203070494,Mato Grosso do Sul,2757013,0.7013,23731,1933442,0.3173,18852,874821,0.0000,0,36
2021-08-18,Brazil,203070494,Mato Grosso do Sul,2757013,0.7092,21698,1955140,0.3255,22629,897450,0.0000,0,36
2021-08-19,Brazil,203070494,Mato Grosso do Sul,2757013,0.7150,16017,1971157,0.3304,13430,910880,0.0000,0,36
2021-08-20,Brazil,203070494,Mato Grosso do Sul,2757013,0.7181,8665,1979822,0.3334,8392,919272,0.0000,0,36
2021-08-21,Brazil,203070494,Mato Grosso do Sul,2757013,0.7268,23885,2003707,0.3360,6971,926243,0.0000,0,36
2021-08-22,Brazil,203070494,Mato Grosso do Sul,2757013,0.7281,3762,2007469,0.3369,2731,928974,0.0000,0,36
2021-08-23,Brazil,203070494,Mato Grosso do Sul,2757013,0.7311,8192,2015661,0.3399,8174,937148,0.0000,0,36
2021-08-24,Brazil,203070494,Mato Grosso do Sul,2757013,0.7364,14587,2030248,0.3447,13171,950319,0.0000,0,36
2021-08-25,Brazil,203070494,Mato Grosso do Sul,2757013,0.7400,10031,2040279,0.3529,22671,972990,0.0000,0,36
2021-08-26,Brazil,203070494,Mato Grosso do Sul,2757013,0.7425,6717,2046996,0.3587,15958,988948,0.0000,34,70
2021-08-27,Brazil,203070494,Mato Grosso do Sul,2757013,0.7439,3966,2050962,0.3634,12936,1001884,0.0001,80,150
2021-08-28,Brazil,203070494,Mato Grosso do Sul,2757013,0.7462,6348,2057310,0.3682,13365,1015249,0.0001,50,200
2021-08-29,Brazil,203070494,Mato Grosso do Sul,2757013,0.7469,1920,2059230,0.3698,4299,1019548,0.0001,89,289
2021-08-30,Brazil,203070494,Mato Grosso do Sul,2757013,0.7486,4748,2063978,0.3748,13811,1033359,0.0001,55,344
2021-08-31,Brazil,203070494,Mato Grosso do Sul,2757013,0.7499,3377,2067355,0.3798,13806,1047165,0.0002,92,436
2021-09-01,Brazil,203070494,Mato Grosso do Sul,2757013,0.7509,2917,2070272,0.3868,19317,1066482,0.0002,184,620
2021-09-02,Brazil,203070494,Mato Grosso do Sul,2757013,0.7521,3269,2073541,0.3913,12421,1078903,0.0003,267,887
2021-09-03,Brazil,203070494,Mato Grosso do Sul,2757013,0.7536,4021,2077562,0.3993,22018,1100921,0.0006,712,1599
2021-09-04,Brazil,203070494,Mato Grosso do Sul,2757013,0.7553,4846,2082408,0.4020,7408,1108329,0.0011,1470,3069
2021-09-05,Brazil,203070494,Mato Grosso do Sul,2757013,0.7558,1235,2083643,0.4031,3076,1111405,0.0014,919,3988
2021-09-06,Brazil,203070494,Mato Grosso do Sul,2757013,0.7562,1160,2084803,0.4053,5989,1117394,0.0021,1718,5706
2021-09-07,Brazil,203070494,Mato Grosso do Sul,2757013,0.7571,2652,2087455,0.4068,4153,1121547,0.0024,829,6535
2021-09-08,Brazil,203070494,Mato Grosso do Sul,2757013,0.7582,2777,2090232,0.4119,14086,1135633,0.0028,1067,7602
2021-09-09,Brazil,203070494,Mato Grosso do Sul,2757013,0.7592,2864,2093096,0.4164,12354,1147987,0.0030,670,8272
2021-09-10,Brazil,203070494,Mato Grosso do Sul,2757013,0.7611,5394,2098490,0.4222,15930,1163917,0.0033,921,9193
2021-09-11,Brazil,203070494,Mato Grosso do Sul,2757013,0.7628,4550,2103040,0.4267,12520,1176437,0.0038,1288,10481
2021-09-12,Brazil,203070494,Mato Grosso do Sul,2757013,0.7636,2268,2105308,0.4283,4323,1180760,0.0040,542,11023
2021-09-13,Brazil,203070494,Mato Grosso do Sul,2757013,0.7647,2994,2108302,0.4345,17069,1197829,0.0053,3649,14672
2021-09-14,Brazil,203070494,Mato Grosso do Sul,2757013,0.7659,3222,2111524,0.4401,15637,1213466,0.0073,5356,20028
2021-09-15,Brazil,203070494,Mato Grosso do Sul,2757013,0.7672,3646,2115170,0.4481,22084,1235550,0.0094,5924,25952
2021-09-16,Brazil,203070494,Mato Grosso do Sul,2757013,0.7681,2619,2117789,0.4532,13794,1249344,0.0105,3118,29070
2021-09-17,Brazil,203070494,Mato Grosso do Sul,2757013,0.7691,2654,2120443,0.4583,14083,1263427,0.0122,4624,33694
2021-09-18,Brazil,203070494,Mato Grosso do Sul,2757013,0.7700,2561,2123004,0.4639,15423,1278850,0.0139,4758,38452
2021-09-19,Brazil,203070494,Mato Grosso do Sul,2757013,0.7704,868,2123872,0.4662,6433,1285283,0.0144,1179,39631
2021-09-20,Brazil,203070494,Mato Grosso do Sul,2757013,0.7711,1994,2125866,0.4700,10587,1295870,0.0146,644,40275
2021-09-21,Brazil,203070494,Mato Grosso do Sul,2757013,0.7717,1816,2127682,0.4757,15691,1311561,0.0172,7156,47431
2021-09-22,Brazil,203070494,Mato Grosso do Sul,2757013,0.7731,3788,2131470,0.4823,18072,1329633,0.0194,5964,53395
2021-09-23,Brazil,203070494,Mato Grosso do Sul,2757013,0.7742,3140,2134610,0.4882,16217,1345850,0.0208,4024,57419
2021-09-24,Brazil,203070494,Mato Grosso do Sul,2757013,0.7755,3413,2138023,0.4921,10797,1356647,0.0219,2843,60262
2021-09-25,Brazil,203070494,Mato Grosso do Sul,2757013,0.7769,3763,2141786,0.4964,11995,1368642,0.0230,3255,63517
2021-09-26,Brazil,203070494,Mato Grosso do Sul,2757013,0.7771,692,2142478,0.4974,2813,1371455,0.0235,1144,64661
2021-09-27,Brazil,203070494,Mato Grosso do Sul,2757013,0.7780,2375,2144853,0.5018,12036,1383491,0.0245,2989,67650
2021-09-28,Brazil,203070494,Mato Grosso do Sul,2757013,0.7791,3064,2147917,0.5073,15081,1398572,0.0261,4230,71880
2021-09-29,Brazil,203070494,Mato Grosso do Sul,2757013,0.7801,2759,2150676,0.5116,11973,1410545,0.0272,3194,75074
2021-09-30,Brazil,203070494,Mato Grosso do Sul,2757013,0.7809,2307,2152983,0.5168,14158,1424703,0.0279,1782,76856
2021-10-01,Brazil,203070494,Mato Grosso do Sul,2757013,0.7815,1744,2154727,0.5196,7929,1432632,0.0283,1281,78137
2021-10-02,Brazil,203070494,Mato Grosso do Sul,2757013,0.7821,1655,2156382,0.5226,8284,1440916,0.0288,1316,79453
2021-10-03,Brazil,203070494,Mato Grosso do Sul,2757013,0.7822,283,2156665,0.5233,1695,1442611,0.0289,281,79734
2021-10-04,Brazil,203070494,Mato Grosso do Sul,2757013,0.7830,2002,2158667,0.5257,6754,1449365,0.0294,1369,81103
2021-10-05,Brazil,203070494,Mato Grosso do Sul,2757013,0.7839,2534,2161201,0.5301,12187,1461552,0.0299,1398,82501
2021-10-06,Brazil,203070494,Mato Grosso do Sul,2757013,0.7847,2105,2163306,0.5335,9237,1470789,0.0305,1522,84023
2021-10-07,Brazil,203070494,Mato Grosso do Sul,2757013,0.7853,1863,2165169,0.5367,8839,1479628,0.0309,1287,85310
2021-10-08,Brazil,203070494,Mato Grosso do Sul,2757013,0.7862,2443,2167612,0.5393,7278,1486906,0.0317,2089,87399
2021-10-09,Brazil,203070494,Mato Grosso do Sul,2757013,0.7867,1284,2168896,0.5416,6330,1493236,0.0322,1362,88761
2021-10-10,Brazil,203070494,Mato Grosso do Sul,2757013,0.7868,320,2169216,0.5425,2474,1495710,0.0323,210,88971
2021-10-11,Brazil,203070494,Mato Grosso do Sul,2757013,0.7870,644,2169860,0.5438,3421,1499131,0.0329,1621,90592
2021-10-12,Brazil,203070494,Mato Grosso do Sul,2757013,0.7872,522,2170382,0.5448,2783,1501914,0.0333,1081,91673
2021-10-13,Brazil,203070494,Mato Grosso do Sul,2757013,0.7877,1428,2171810,0.5477,7965,1509879,0.0339,1823,93496
2021-10-14,Brazil,203070494,Mato Grosso do Sul,2757013,0.7883,1473,2173283,0.5508,8755,1518634,0.0345,1643,95139
2021-10-15,Brazil,203070494,Mato Grosso do Sul,2757013,0.7887,1100,2174383,0.5528,5370,1524004,0.0348,916,96055
2021-10-16,Brazil,203070494,Mato Grosso do Sul,2757013,0.7892,1345,2175728,0.5548,5689,1529693,0.0352,959,97014
2021-10-17,Brazil,203070494,Mato Grosso do Sul,2757013,0.7892,189,2175917,0.5551,638,1530331,0.0352,35,97049
2021-10-18,Brazil,203070494,Mato Grosso do Sul,2757013,0.7898,1507,2177424,0.5578,7632,1537963,0.0357,1240,98289
2021-10-19,Brazil,203070494,Mato Grosso do Sul,2757013,0.7904,1669,2179093,0.5615,10209,1548172,0.0361,1146,99435
2021-10-20,Brazil,203070494,Mato Grosso do Sul,2757013,0.7909,1344,2180437,0.5644,7851,1556023,0.0364,922,100357
2021-10-21,Brazil,203070494,Mato Grosso do Sul,2757013,0.7914,1464,2181901,0.5674,8224,1564247,0.0372,2196,102553
2021-10-22,Brazil,203070494,Mato Grosso do Sul,2757013,0.7919,1358,2183259,0.5701,7422,1571669,0.0377,1441,103994
2021-10-23,Brazil,203070494,Mato Grosso do Sul,2757013,0.7922,917,2184176,0.5716,4224,1575893,0.0382,1241,105235
2021-10-24,Brazil,203070494,Mato Grosso do Sul,2757013,0.7923,179,2184355,0.5718,696,1576589,0.0383,319,105554
2021-10-25,Brazil,203070494,Mato Grosso do Sul,2757013,0.7927,1139,2185494,0.5741,6164,1582753,0.0389,1751,107305
2021-10-26,Brazil,203070494,Mato Grosso do Sul,2757013,0.7933,1531,2187025,0.5766,7022,1589775,0.0395,1655,108960
2021-10-27,Brazil,203070494,Mato Grosso do Sul,2757013,0.7937,1342,2188367,0.5790,6488,1596263,0.0399,1127,110087
2021-10-28,Brazil,203070494,Mato Grosso do Sul,2757013,0.7942,1307,2189674,0.5811,5879,1602142,0.0403,1070,111157
2021-10-29,Brazil,203070494,Mato Grosso do Sul,2757013,0.7945,897,2190571,0.5828,4715,1606857,0.0407,938,112095
2021-10-30,Brazil,203070494,Mato Grosso do Sul,2757013,0.7947,393,2190964,0.5837,2493,1609350,0.0407,25,112120
2021-10-31,Brazil,203070494,Mato Grosso do Sul,2757013,0.7947,130,2191094,0.5839,480,1609830,0.0407,9,112129
2021-11-01,Brazil,203070494,Mato Grosso do Sul,2757013,0.7949,466,2191560,0.5849,2623,1612453,0.0410,1014,113143
2021-11-02,Brazil,203070494,Mato Grosso do Sul,2757013,0.7950,271,2191831,0.5854,1505,1613958,0.0414,884,114027
2021-11-03,Brazil,203070494,Mato Grosso do Sul,2757013,0.7954,1043,2192874,0.5874,5420,1619378,0.0417,1070,115097
2021-11-04,Brazil,203070494,Mato Grosso do Sul,2757013,0.7958,1102,2193976,0.5894,5525,1624903,0.0422,1143,116240
2021-11-05,Brazil,203070494,Mato Grosso do Sul,2757013,0.7962,1027,2195003,0.5914,5706,1630609,0.0425,1058,117298
2021-11-06,Brazil,203070494,Mato Grosso do Sul,2757013,0.7963,388,2195391,0.5922,2203,1632812,0.0428,698,117996
2021-11-07,Brazil,203070494,Mato Grosso do Sul,2757013,0.7963,87,2195478,0.5925,593,1633405,0.0429,183,118179
2021-11-08,Brazil,203070494,Mato Grosso do Sul,2757013,0.7967,1014,2196492,0.5943,5133,1638538,0.0433,1099,119278
2021-11-09,Brazil,203070494,Mato Grosso do Sul,2757013,0.7971,1088,2197580,0.5966,6231,1644769,0.0436,883,120161
2021-11-10,Brazil,203070494,Mato Grosso do Sul,2757013,0.7975,1134,2198714,0.5986,5638,1650407,0.0439,777,120938
2021-11-11,Brazil,203070494,Mato Grosso do Sul,2757013,0.7979,1147,2199861,0.6004,4820,1655227,0.0441,760,121698
2021-11-12,Brazil,203070494,Mato Grosso do Sul,2757013,0.7982,917,2200778,0.6020,4540,1659767,0.0444,703,122401
2021-11-13,Brazil,203070494,Mato Grosso do Sul,2757013,0.7984,494,2201272,0.6028,2081,1661848,0.0445,386,122787
2021-11-14,Brazil,203070494,Mato Grosso do Sul,2757013,0.7985,110,2201382,0.6031,781,1662629,0.0446,137,122924
2021-11-15,Brazil,203070494,Mato Grosso do Sul,2757013,0.7986,291,2201673,0.6037,1655,1664284,0.0448,579,123503
2021-11-16,Brazil,203070494,Mato Grosso do Sul,2757013,0.7989,1010,2202683,0.6056,5343,1669627,0.0451,964,124467
2021-11-17,Brazil,203070494,Mato Grosso do Sul,2757013,0.7994,1193,2203876,0.6077,5798,1675425,0.0461,2590,127057
2021-11-18,Brazil,203070494,Mato Grosso do Sul,2757013,0.7997,1012,2204888,0.6096,5263,1680688,0.0475,3890,130947
2021-11-19,Brazil,203070494,Mato Grosso do Sul,2757013,0.8001,1054,2205942,0.6112,4460,1685148,0.0488,3609,134556
2021-11-20,Brazil,203070494,Mato Grosso do Sul,2757013,0.8003,512,2206454,0.6121,2424,1687572,0.0501,3546,138102
2021-11-21,Brazil,203070494,Mato Grosso do Sul,2757013,0.8003,121,2206575,0.6123,576,1688148,0.0505,1149,139251
2021-11-22,Brazil,203070494,Mato Grosso do Sul,2757013,0.8007,1093,2207668,0.6141,4956,1693104,0.0523,4881,144132
2021-11-23,Brazil,203070494,Mato Grosso do Sul,2757013,0.8012,1170,2208838,0.6157,4342,1697446,0.0540,4695,148827
2021-11-24,Brazil,203070494,Mato Grosso do Sul,2757013,0.8015,954,2209792,0.6172,4260,1701706,0.0556,4587,153414
2021-11-25,Brazil,203070494,Mato Grosso do Sul,2757013,0.8019,968,2210760,0.6185,3406,1705112,0.0567,2960,156374
2021-11-26,Brazil,203070494,Mato Grosso do Sul,2757013,0.8022,888,2211648,0.6197,3371,1708483,0.0578,3048,159422
2021-11-27,Brazil,203070494,Mato Grosso do Sul,2757013,0.8024,473,2212121,0.6205,2144,1710627,0.0587,2487,161909
2021-11-28,Brazil,203070494,Mato Grosso do Sul,2757013,0.8024,121,2212242,0.6206,447,1711074,0.0591,1009,162918
2021-11-29,Brazil,203070494,Mato Grosso do Sul,2757013,0.8028,1017,2213259,0.6219,3524,1714598,0.0602,3125,166043
2021-11-30,Brazil,203070494,Mato Grosso do Sul,2757013,0.8032,1156,2214415,0.6234,4116,1718714,0.0615,3622,169665
2021-12-01,Brazil,203070494,Mato Grosso do Sul,2757013,0.8036,1031,2215446,0.6249,4017,1722731,0.0629,3703,173368
2021-12-02,Brazil,203070494,Mato Grosso do Sul,2757013,0.8039,944,2216390,0.6261,3560,1726291,0.0640,3062,176430
2021-12-03,Brazil,203070494,Mato Grosso do Sul,2757013,0.8042,890,2217280,0.6272,2999,1729290,0.0648,2311,178741
2021-12-04,Brazil,203070494,Mato Grosso do Sul,2757013,0.8045,605,2217885,0.6278,1592,1730882,0.0657,2406,181147
2021-12-05,Brazil,203070494,Mato Grosso do Sul,2757013,0.8045,94,2217979,0.6279,305,1731187,0.0660,870,182017
2021-12-06,Brazil,203070494,Mato Grosso do Sul,2757013,0.8048,954,2218933,0.6290,3057,1734244,0.0670,2570,184587
2021-12-07,Brazil,203070494,Mato Grosso do Sul,2757013,0.8056,2039,2220972,0.6311,5708,1739952,0.0679,2583,187170
2021-12-08,Brazil,203070494,Mato Grosso do Sul,2757013,0.8059,1029,2222001,0.6321,2841,1742793,0.0688,2630,189800
2021-12-09,Brazil,203070494,Mato Grosso do Sul,2757013,0.8065,1662,2223663,0.6334,3540,1746333,0.0702,3812,193612
2021-12-10,Brazil,203070494,Mato Grosso do Sul,2757013,0.8071,1654,2225317,0.6345,3129,1749462,0.0713,3011,196623
2021-12-11,Brazil,203070494,Mato Grosso do Sul,2757013,0.8074,646,2225963,0.6355,2668,1752130,0.0725,3247,199870
2021-12-12,Brazil,203070494,Mato Grosso do Sul,2757013,0.8074,125,2226088,0.6358,706,1752836,0.0729,1233,201103
2021-12-13,Brazil,203070494,Mato Grosso do Sul,2757013,0.8077,814,2226902,0.6370,3390,1756226,0.0743,3802,204905
2021-12-14,Brazil,203070494,Mato Grosso do Sul,2757013,0.8081,935,2227837,0.6385,4051,1760277,0.0758,4109,209014
2021-12-15,Brazil,203070494,Mato Grosso do Sul,2757013,0.8083,784,2228621,0.6398,3599,1763876,0.0771,3448,212462
2021-12-16,Brazil,203070494,Mato Grosso do Sul,2757013,0.8086,750,2229371,0.6412,3973,1767849,0.0785,3843,216305
2021-12-17,Brazil,203070494,Mato Grosso do Sul,2757013,0.8089,694,2230065,0.6425,3404,1771253,0.0798,3588,219893
2021-12-18,Brazil,203070494,Mato Grosso do Sul,2757013,0.8090,345,2230410,0.6433,2348,1773601,0.0811,3564,223457
2021-12-19,Brazil,203070494,Mato Grosso do Sul,2757013,0.8090,123,2230533,0.6436,896,1774497,0.0816,1454,224911
2021-12-20,Brazil,203070494,Mato Grosso do Sul,2757013,0.8092,574,2231107,0.6446,2676,1777173,0.0829,3525,228436
2021-12-21,Brazil,203070494,Mato Grosso do Sul,2757013,0.8095,578,2231685,0.6455,2516,1779689,0.0841,3529,231965
2021-12-22,Brazil,203070494,Mato Grosso do Sul,2757013,0.8096,478,2232163,0.6463,2175,1781864,0.0850,2379,234344
2021-12-23,Brazil,203070494,Mato Grosso do Sul,2757013,0.8097,299,2232462,0.6468,1376,1783240,0.0857,2001,236345
2021-12-24,Brazil,203070494,Mato Grosso do Sul,2757013,0.8098,54,2232516,0.6469,316,1783556,0.0860,717,237062
2021-12-25,Brazil,203070494,Mato Grosso do Sul,2757013,0.8098,21,2232537,0.6470,175,1783731,0.0862,504,237566
2021-12-26,Brazil,203070494,Mato Grosso do Sul,2757013,0.8098,39,2232576,0.6471,273,1784004,0.0864,683,238249
2021-12-27,Brazil,203070494,Mato Grosso do Sul,2757013,0.8099,400,2232976,0.6477,1706,1785710,0.0876,3212,241461
2021-12-28,Brazil,203070494,Mato Grosso do Sul,2757013,0.8101,415,2233391,0.6484,1846,1787556,0.0888,3433,244894
2021-12-29,Brazil,203070494,Mato Grosso do Sul,2757013,0.8103,483,2233874,0.6490,1747,1789303,0.0897,2380,247274
2021-12-30,Brazil,203070494,Mato Grosso do Sul,2757013,0.8104,349,2234223,0.6495,1279,1790582,0.0905,2349,249623
2021-12-31,Brazil,203070494,Mato Grosso do Sul,2757013,0.8104,48,2234271,0.6496,251,1790833,0.0908,732,250355
2021-01-01,Brazil,203070494,Minas Gerais,20539989,0.0000,0,0,0.0000,0,0,0.0000,0,0
2021-01-02,Brazil,203070494,Minas Gerais,20539989,0.0000,6,6,0.0000,0,0,0.0000,0,0
2021-01-03,Brazil,203070494,Minas Gerais,20539989,0.0000,1,7,0.0000,0,0,0.0000,0,0
2021-01-04,Brazil,203070494,Minas Gerais,20539989,0.0000,11,18,0.0000,3,3,0.0000,0,0
2021-01-05,Brazil,203070494,Minas Gerais,20539989,0.0000,3,21,0.0000,3,6,0.0000,0,0
2021-01-06,Brazil,203070494,Minas Gerais,20539989,0.0000,0,21,0.0000,4,10,0.0000,0,0
2021-01-07,Brazil,203070494,Minas Gerais,20539989,0.0000,1,22,0.0000,1,11,0.0000,0,0
2021-01-08,Brazil,203070494,Minas Gerais,20539989,0.0000,3,25,0.0000,0,11,0.0000,0,0
2021-01-09,Brazil,203070494,Minas Gerais,20539989,0.0000,3,28,0.0000,0,11,0.0000,0,0
2021-01-10,Brazil,203070494,Minas Gerais,20539989,0.0000,6,34,0.0000,1,12,0.0000,0,0
2021-01-11,Brazil,203070494,Minas Gerais,20539989,0.0000,0,34,0.0000,2,14,0.0000,0,0
2021-01-12,Brazil,203070494,Minas Gerais,20539989,0.0000,0,34,0.0000,8,22,0.0000,0,0
2021-01-13,Brazil,203070494,Minas Gerais,20539989,0.0000,2,36,0.0000,2,24,0.0000,0,0
2021-01-14,Brazil,203070494,Minas Gerais,20539989,0.0000,4,40,0.0000,4,28,0.0000,0,0
2021-01-15,Brazil,203070494,Minas Gerais,20539989,0.0000,5,45,0.0000,0,28,0.0000,0,0
2021-01-16,Brazil,203070494,Minas Gerais,20539989,0.0000,0,45,0.0000,2,30,0.0000,0,0
2021-01-17,Brazil,203070494,Minas Gerais,20539989,0.0000,37,82,0.0000,9,39,0.0000,0,0
2021-01-18,Brazil,203070494,Minas Gerais,20539989,0.0000,114,196,0.0000,9,48,0.0000,0,0
2021-01-19,Brazil,203070494,Minas Gerais,20539989,0.0002,4687,4883,0.0000,23,71,0.0000,0,0
2021-01-20,Brazil,203070494,Minas Gerais,20539989,0.0023,43020,47903,0.0000,156,227,0.0000,0,0
2021-01-21,Brazil,203070494,Minas Gerais,20539989,0.0048,50816,98719,0.0000,102,329,0.0000,1,1
2021-01-22,Brazil,203070494,Minas Gerais,20539989,0.0062,29442,128161,0.0000,96,425,0.0000,0,1
2021-01-23,Brazil,203070494,Minas Gerais,20539989,0.0064,4052,132213,0.0000,9,434,0.0000,0,1
2021-01-24,Brazil,203070494,Minas Gerais,20539989,0.0065,1065,133278,0.0000,53,487,0.0000,0,1
2021-01-25,Brazil,203070494,Minas Gerais,20539989,0.0073,17567,150845,0.0000,60,547,0.0000,0,1
2021-01-26,Brazil,203070494,Minas Gerais,20539989,0.0080,13523,164368,0.0000,59,606,0.0000,0,1
2021-01-27,Brazil,203070494,Minas Gerais,20539989,0.0087,13437,177805,0.0000,34,640,0.0000,0,1
2021-01-28,Brazil,203070494,Minas Gerais,20539989,0.0092,10709,188514,0.0000,15,655,0.0000,0,1
2021-01-29,Brazil,203070494,Minas Gerais,20539989,0.0096,8875,197389,0.0000,36,691,0.0000,0,1
2021-01-30,Brazil,203070494,Minas Gerais,20539989,0.0097,1226,198615,0.0000,6,697,0.0000,0,1
2021-01-31,Brazil,203070494,Minas Gerais,20539989,0.0098,2487,201102,0.0000,4,701,0.0000,0,1
2021-02-01,Brazil,203070494,Minas Gerais,20539989,0.0110,24086,225188,0.0000,100,801,0.0000,0,1
2021-02-02,Brazil,203070494,Minas Gerais,20539989,0.0128,37524,262712,0.0001,1555,2356,0.0000,0,1
2021-02-03,Brazil,203070494,Minas Gerais,20539989,0.0144,33716,296428,0.0004,6810,9166,0.0000,0,1
2021-02-04,Brazil,203070494,Minas Gerais,20539989,0.0159,30085,326513,0.0013,18194,27360,0.0000,0,1
2021-02-05,Brazil,203070494,Minas Gerais,20539989,0.0171,23962,350475,0.0022,17963,45323,0.0000,0,1
2021-02-06,Brazil,203070494,Minas Gerais,20539989,0.0173,4298,354773,0.0023,1145,46468,0.0000,0,1
2021-02-07,Brazil,203070494,Minas Gerais,20539989,0.0174,1999,356772,0.0023,208,46676,0.0000,0,1
2021-02-08,Brazil,203070494,Minas Gerais,20539989,0.0182,17018,373790,0.0033,21247,67923,0.0000,0,1
2021-02-09,Brazil,203070494,Minas Gerais,20539989,0.0191,17563,391353,0.0043,20147,88070,0.0000,0,1
2021-02-10,Brazil,203070494,Minas Gerais,20539989,0.0197,13934,405287,0.0053,21373,109443,0.0000,0,1
2021-02-11,Brazil,203070494,Minas Gerais,20539989,0.0207,19940,425227,0.0063,20166,129609,0.0000,1,2
2021-02-12,Brazil,203070494,Minas Gerais,20539989,0.0223,33345,458572,0.0070,14417,144026,0.0000,0,2
2021-02-13,Brazil,203070494,Minas Gerais,20539989,0.0233,20055,478627,0.0071,1027,145053,0.0000,0,2
2021-02-14,Brazil,203070494,Minas Gerais,20539989,0.0234,2429,481056,0.0071,765,145818,0.0000,0,2
2021-02-15,Brazil,203070494,Minas Gerais,20539989,0.0245,22759,503815,0.0076,11194,157012,0.0000,0,2
2021-02-16,Brazil,203070494,Minas Gerais,20539989,0.0254,16893,520708,0.0082,11415,168427,0.0000,0,2
2021-02-17,Brazil,203070494,Minas Gerais,20539989,0.0261,14406,535114,0.0090,16498,184925,0.0000,0,2
2021-02-18,Brazil,203070494,Minas Gerais,20539989,0.0268,15728,550842,0.0100,20574,205499,0.0000,0,2
2021-02-19,Brazil,203070494,Minas Gerais,20539989,0.0275,14401,565243,0.0106,12921,218420,0.0000,0,2
2021-02-20,Brazil,203070494,Minas Gerais,20539989,0.0276,1668,566911,0.0107,1136,219556,0.0000,0,2
2021-02-21,Brazil,203070494,Minas Gerais,20539989,0.0276,426,567337,0.0107,577,220133,0.0000,0,2
2021-02-22,Brazil,203070494,Minas Gerais,20539989,0.0281,10414,577751,0.0113,11434,231567,0.0000,0,2
2021-02-23,Brazil,203070494,Minas Gerais,20539989,0.0285,8482,586233,0.0116,7550,239117,0.0000,0,2
2021-02-24,Brazil,203070494,Minas Gerais,20539989,0.0289,7461,593694,0.0120,6988,246105,0.0000,0,2
2021-02-25,Brazil,203070494,Minas Gerais,20539989,0.0292,5910,599604,0.0124,8819,254924,0.0000,0,2
2021-02-26,Brazil,203070494,Minas Gerais,20539989,0.0295,5644,605248,0.0131,14502,269426,0.0000,0,2
2021-02-27,Brazil,203070494,Minas Gerais,20539989,0.0295,973,606221,0.0134,5255,274681,0.0000,0,2
2021-02-28,Brazil,203070494,Minas Gerais,20539989,0.0295,272,606493,0.0135,2619,277300,0.0000,0,2
2021-03-01,Brazil,203070494,Minas Gerais,20539989,0.0297,4226,610719,0.0144,18414,295714,0.0000,0,2
2021-03-02,Brazil,203070494,Minas Gerais,20539989,0.0305,14979,625698,0.0151,14498,310212,0.0000,0,2
2021-03-03,Brazil,203070494,Minas Gerais,20539989,0.0325,42089,667787,0.0158,13415,323627,0.0000,0,2
2021-03-04,Brazil,203070494,Minas Gerais,20539989,0.0350,50985,718772,0.0164,13110,336737,0.0000,0,2
2021-03-05,Brazil,203070494,Minas Gerais,20539989,0.0369,39968,758740,0.0170,13194,349931,0.0000,0,2
2021-03-06,Brazil,203070494,Minas Gerais,20539989,0.0374,9390,768130,0.0176,10695,360626,0.0000,0,2
2021-03-07,Brazil,203070494,Minas Gerais,20539989,0.0375,2435,770565,0.0176,570,361196,0.0000,0,2
2021-03-08,Brazil,203070494,Minas Gerais,20539989,0.0389,28667,799232,0.0181,9852,371048,0.0000,0,2
2021-03-09,Brazil,203070494,Minas Gerais,20539989,0.0409,40935,840167,0.0185,8440,379488,0.0000,0,2
2021-03-10,Brazil,203070494,Minas Gerais,20539989,0.0433,48895,889062,0.0189,8035,387523,0.0000,0,2
2021-03-11,Brazil,203070494,Minas Gerais,20539989,0.0458,51288,940350,0.0192,7278,394801,0.0000,0,2
2021-03-12,Brazil,203070494,Minas Gerais,20539989,0.0474,32776,973126,0.0195,6260,401061,0.0000,0,2
2021-03-13,Brazil,203070494,Minas Gerais,20539989,0.0477,7609,980735,0.0196,663,401724,0.0000,0,2
2021-03-14,Brazil,203070494,Minas Gerais,20539989,0.0478,1777,982512,0.0196,222,401946,0.0000,0,2
2021-03-15,Brazil,203070494,Minas Gerais,20539989,0.0488,20106,1002618,0.0198,4965,406911,0.0000,0,2
2021-03-16,Brazil,203070494,Minas Gerais,20539989,0.0513,50756,1053374,0.0200,4589,411500,0.0000,0,2
2021-03-17,Brazil,203070494,Minas Gerais,20539989,0.0534,43987,1097361,0.0203,5896,417396,0.0000,0,2
2021-03-18,Brazil,203070494,Minas Gerais,20539989,0.0553,37590,1134951,0.0208,8820,426216,0.0000,0,2
2021-03-19,Brazil,203070494,Minas Gerais,20539989,0.0566,28162,1163113,0.0212,8465,434681,0.0000,0,2
2021-03-20,Brazil,203070494,Minas Gerais,20539989,0.0569,4895,1168008,0.0212,1099,435780,0.0000,0,2
2021-03-21,Brazil,203070494,Minas Gerais,20539989,0.0569,1621,1169629,0.0212,116,435896,0.0000,0,2
2021-03-22,Brazil,203070494,Minas Gerais,20539989,0.0585,31280,1200909,0.0216,7995,443891,0.0000,0,2
2021-03-23,Brazil,203070494,Minas Gerais,20539989,0.0622,75880,1276789,0.0222,11315,455206,0.0000,0,2
2021-03-24,Brazil,203070494,Minas Gerais,20539989,0.0669,97195,1373984,0.0231,18819,474025,0.0000,0,2
2021-03-25,Brazil,203070494,Minas Gerais,20539989,0.0708,79775,1453759,0.0245,29940,503965,0.0000,0,2
2021-03-26,Brazil,203070494,Minas Gerais,20539989,0.0754,95816,1549575,0.0259,28373,532338,0.0000,0,2
2021-03-27,Brazil,203070494,Minas Gerais,20539989,0.0806,106700,1656275,0.0261,3506,535844,0.0000,0,2
2021-03-28,Brazil,203070494,Minas Gerais,20539989,0.0812,12581,1668856,0.0261,1122,536966,0.0000,0,2
2021-03-29,Brazil,203070494,Minas Gerais,20539989,0.0868,113837,1782693,0.0271,19122,556088,0.0000,1,3
2021-03-30,Brazil,203070494,Minas Gerais,20539989,0.0952,172336,1955029,0.0282,24004,580092,0.0000,0,3
2021-03-31,Brazil,203070494,Minas Gerais,20539989,0.1022,144135,2099164,0.0301,37510,617602,0.0000,0,3
2021-04-01,Brazil,203070494,Minas Gerais,20539989,0.1074,107098,2206262,0.0310,19291,636893,0.0000,0,3
2021-04-02,Brazil,203070494,Minas Gerais,20539989,0.1086,24117,2230379,0.0311,1333,638226,0.0000,0,3
2021-04-03,Brazil,203070494,Minas Gerais,20539989,0.1097,23665,2254044,0.0311,1493,639719,0.0000,0,3
2021-04-04,Brazil,203070494,Minas Gerais,20539989,0.1101,6947,2260991,0.0312,426,640145,0.0000,0,3
2021-04-05,Brazil,203070494,Minas Gerais,20539989,0.1136,71548,2332539,0.0331,40506,680651,0.0000,0,3
2021-04-06,Brazil,203070494,Minas Gerais,20539989,0.1169,68382,2400921,0.0343,24655,705306,0.0000,0,3
2021-04-07,Brazil,203070494,Minas Gerais,20539989,0.1211,86302,2487223,0.0359,32394,737700,0.0000,5,8
2021-04-08,Brazil,203070494,Minas Gerais,20539989,0.1241,60847,2548070,0.0380,41924,779624,0.0000,6,14
2021-04-09,Brazil,203070494,Minas Gerais,20539989,0.1273,66048,2614118,0.0400,41694,821318,0.0000,0,14
2021-04-10,Brazil,203070494,Minas Gerais,20539989,0.1282,18300,2632418,0.0414,28815,850133,0.0000,0,14
2021-04-11,Brazil,203070494,Minas Gerais,20539989,0.1282,664,2633082,0.0416,3322,853455,0.0000,0,14
2021-04-12,Brazil,203070494,Minas Gerais,20539989,0.1293,22114,2655196,0.0436,43048,896503,0.0000,0,14
2021-04-13,Brazil,203070494,Minas Gerais,20539989,0.1306,27973,2683169,0.0461,49365,945868,0.0000,0,14
2021-04-14,Brazil,203070494,Minas Gerais,20539989,0.1344,78219,2761388,0.0486,52553,998421,0.0000,1,15
2021-04-15,Brazil,203070494,Minas Gerais,20539989,0.1374,61392,2822780,0.0515,58499,1056920,0.0000,0,15
2021-04-16,Brazil,203070494,Minas Gerais,20539989,0.1395,42072,2864852,0.0537,46262,1103182,0.0000,0,15
2021-04-17,Brazil,203070494,Minas Gerais,20539989,0.1399,8178,2873030,0.0554,34113,1137295,0.0000,0,15
2021-04-18,Brazil,203070494,Minas Gerais,20539989,0.1399,207,2873237,0.0554,1412,1138707,0.0000,0,15
2021-04-19,Brazil,203070494,Minas Gerais,20539989,0.1410,23515,2896752,0.0580,53415,1192122,0.0000,0,15
2021-04-20,Brazil,203070494,Minas Gerais,20539989,0.1458,98394,2995146,0.0613,67250,1259372,0.0000,0,15
2021-04-21,Brazil,203070494,Minas Gerais,20539989,0.1493,72157,3067303,0.0625,23425,1282797,0.0000,0,15
2021-04-22,Brazil,203070494,Minas Gerais,20539989,0.1543,101909,3169212,0.0664,80427,1363224,0.0000,0,15
2021-04-23,Brazil,203070494,Minas Gerais,20539989,0.1578,71870,3241082,0.0697,68570,1431794,0.0000,2,17
2021-04-24,Brazil,203070494,Minas Gerais,20539989,0.1589,21827,3262909,0.0713,32901,1464695,0.0000,0,17
2021-04-25,Brazil,203070494,Minas Gerais,20539989,0.1590,2624,3265533,0.0716,5620,1470315,0.0000,0,17
2021-04-26,Brazil,203070494,Minas Gerais,20539989,0.1604,29414,3294947,0.0750,70389,1540704,0.0000,0,17
2021-04-27,Brazil,203070494,Minas Gerais,20539989,0.1623,37933,3332880,0.0790,81752,1622456,0.0000,0,17
2021-04-28,Brazil,203070494,Minas Gerais,20539989,0.1669,94493,3427373,0.0830,81820,1704276,0.0000,0,17
2021-04-29,Brazil,203070494,Minas Gerais,20539989,0.1708,81034,3508407,0.0865,73021,1777297,0.0000,0,17
2021-04-30,Brazil,203070494,Minas Gerais,20539989,0.1733,50733,3559140,0.0890,51127,1828424,0.0000,0,17
2021-05-01,Brazil,203070494,Minas Gerais,20539989,0.1739,11961,3571101,0.0895,9897,1838321,0.0000,0,17
2021-05-02,Brazil,203070494,Minas Gerais,20539989,0.1739,1253,3572354,0.0896,2009,1840330,0.0000,0,17
2021-05-03,Brazil,203070494,Minas Gerais,20539989,0.1757,37191,3609545,0.0920,48580,1888910,0.0000,1,18
2021-05-04,Brazil,203070494,Minas Gerais,20539989,0.1784,53892,3663437,0.0937,36211,1925121,0.0000,0,18
2021-05-05,Brazil,203070494,Minas Gerais,20539989,0.1843,121695,3785132,0.0954,33438,1958559,0.0000,0,18
2021-05-06,Brazil,203070494,Minas Gerais,20539989,0.1899,115796,3900928,0.0965,23093,1981652,0.0000,0,18
2021-05-07,Brazil,203070494,Minas Gerais,20539989,0.1943,89986,3990914,0.0976,23269,2004921,0.0000,1,19
2021-05-08,Brazil,203070494,Minas Gerais,20539989,0.1961,35956,4026870,0.0977,2035,2006956,0.0000,0,19
2021-05-09,Brazil,203070494,Minas Gerais,20539989,0.1961,1441,4028311,0.0977,364,2007320,0.0000,0,19
2021-05-10,Brazil,203070494,Minas Gerais,20539989,0.1993,64870,4093181,0.0986,17472,2024792,0.0000,151,170
2021-05-11,Brazil,203070494,Minas Gerais,20539989,0.2027,71199,4164380,0.1004,37045,2061837,0.0000,0,170
2021-05-12,Brazil,203070494,Minas Gerais,20539989,0.2060,67097,4231477,0.1017,26756,2088593,0.0000,0,170
2021-05-13,Brazil,203070494,Minas Gerais,20539989,0.2092,66168,4297645,0.1031,28947,2117540,0.0000,0,170
2021-05-14,Brazil,203070494,Minas Gerais,20539989,0.2129,75757,4373402,0.1040,18436,2135976,0.0000,0,170
2021-05-15,Brazil,203070494,Minas Gerais,20539989,0.2146,33918,4407320,0.1042,4620,2140596,0.0000,0,170
2021-05-16,Brazil,203070494,Minas Gerais,20539989,0.2148,5271,4412591,0.1042,189,2140785,0.0000,0,170
2021-05-17,Brazil,203070494,Minas Gerais,20539989,0.2177,59497,4472088,0.1048,11123,2151908,0.0000,0,170
2021-05-18,Brazil,203070494,Minas Gerais,20539989,0.2210,67525,4539613,0.1066,37485,2189393,0.0000,0,170
2021-05-19,Brazil,203070494,Minas Gerais,20539989,0.2241,63029,4602642,0.1090,50199,2239592,0.0000,0,170
2021-05-20,Brazil,203070494,Minas Gerais,20539989,0.2275,69209,4671851,0.1111,41882,2281474,0.0000,0,170
2021-05-21,Brazil,203070494,Minas Gerais,20539989,0.2305,62902,4734753,0.1125,28726,2310200,0.0000,0,170
2021-05-22,Brazil,203070494,Minas Gerais,20539989,0.2313,15962,4750715,0.1130,11166,2321366,0.0000,0,170
2021-05-23,Brazil,203070494,Minas Gerais,20539989,0.2313,493,4751208,0.1133,5574,2326940,0.0000,0,170
2021-05-24,Brazil,203070494,Minas Gerais,20539989,0.2338,50950,4802158,0.1141,16497,2343437,0.0000,0,170
2021-05-25,Brazil,203070494,Minas Gerais,20539989,0.2371,67767,4869925,0.1151,20920,2364357,0.0000,0,170
2021-05-26,Brazil,203070494,Minas Gerais,20539989,0.2405,70805,4940730,0.1158,14127,2378484,0.0000,0,170
2021-05-27,Brazil,203070494,Minas Gerais,20539989,0.2442,75920,5016650,0.1164,12516,2391000,0.0000,0,170
2021-05-28,Brazil,203070494,Minas Gerais,20539989,0.2470,57483,5074133,0.1170,13083,2404083,0.0000,0,170
2021-05-29,Brazil,203070494,Minas Gerais,20539989,0.2473,6231,5080364,0.1175,10105,2414188,0.0000,0,170
2021-05-30,Brazil,203070494,Minas Gerais,20539989,0.2474,532,5080896,0.1175,226,2414414,0.0000,0,170
2021-05-31,Brazil,203070494,Minas Gerais,20539989,0.2495,43317,5124213,0.1183,15539,2429953,0.0000,0,170
2021-06-01,Brazil,203070494,Minas Gerais,20539989,0.2538,89833,5214046,0.1192,17567,2447520,0.0000,0,170
2021-06-02,Brazil,203070494,Minas Gerais,20539989,0.2604,135085,5349131,0.1204,25716,2473236,0.0000,0,170
2021-06-03,Brazil,203070494,Minas Gerais,20539989,0.2618,27598,5376729,0.1206,4213,2477449,0.0000,0,170
2021-06-04,Brazil,203070494,Minas Gerais,20539989,0.2644,54815,5431544,0.1212,11289,2488738,0.0000,0,170
2021-06-05,Brazil,203070494,Minas Gerais,20539989,0.2651,12923,5444467,0.1213,2426,2491164,0.0000,0,170
2021-06-06,Brazil,203070494,Minas Gerais,20539989,0.2651,1399,5445866,0.1213,425,2491589,0.0000,0,170
2021-06-07,Brazil,203070494,Minas Gerais,20539989,0.2686,71451,5517317,0.1227,28283,2519872,0.0000,0,170
2021-06-08,Brazil,203070494,Minas Gerais,20539989,0.2742,114201,5631518,0.1237,21591,2541463,0.0000,0,170
2021-06-09,Brazil,203070494,Minas Gerais,20539989,0.2803,126243,5757761,0.1246,18437,2559900,0.0000,0,170
2021-06-10,Brazil,203070494,Minas Gerais,20539989,0.2859,113962,5871723,0.1253,14425,2574325,0.0000,0,170
2021-06-11,Brazil,203070494,Minas Gerais,20539989,0.2918,122020,5993743,0.1260,13238,2587563,0.0000,0,170
2021-06-12,Brazil,203070494,Minas Gerais,20539989,0.2933,30898,6024641,0.1262,4928,2592491,0.0000,0,170
2021-06-13,Brazil,203070494,Minas Gerais,20539989,0.2934,2520,6027161,0.1262,405,2592896,0.0000,0,170
2021-06-14,Brazil,203070494,Minas Gerais,20539989,0.2977,87295,6114456,0.1270,15069,2607965,0.0000,0,170
2021-06-15,Brazil,203070494,Minas Gerais,20539989,0.3032,113044,6227500,0.1275,10077,2618042,0.0000,0,170
2021-06-16,Brazil,203070494,Minas Gerais,20539989,0.3096,131923,6359423,0.1280,10500,2628542,0.0000,0,170
2021-06-17,Brazil,203070494,Minas Gerais,20539989,0.3164,139040,6498463,0.1283,7323,2635865,0.0000,0,170
2021-06-18,Brazil,203070494,Minas Gerais,20539989,0.3227,130737,6629200,0.1287,6892,2642757,0.0000,0,170
2021-06-19,Brazil,203070494,Minas Gerais,20539989,0.3252,49950,6679150,0.1287,1560,2644317,0.0000,0,170
2021-06-20,Brazil,203070494,Minas Gerais,20539989,0.3255,7433,6686583,0.1287,134,2644451,0.0000,0,170
2021-06-21,Brazil,203070494,Minas Gerais,20539989,0.3300,91474,6778057,0.1291,7402,2651853,0.0000,0,170
2021-06-22,Brazil,203070494,Minas Gerais,20539989,0.3351,104238,6882295,0.1296,9473,2661326,0.0000,0,170
2021-06-23,Brazil,203070494,Minas Gerais,20539989,0.3410,121979,7004274,0.1299,7781,2669107,0.0000,0,170
2021-06-24,Brazil,203070494,Minas Gerais,20539989,0.3464,110276,7114550,0.1303,8203,2677310,0.0000,0,170
2021-06-25,Brazil,203070494,Minas Gerais,20539989,0.3516,106717,7221267,0.1308,8805,2686115,0.0000,0,170
2021-06-26,Brazil,203070494,Minas Gerais,20539989,0.3539,48083,7269350,0.1310,3898,2690013,0.0000,0,170
2021-06-27,Brazil,203070494,Minas Gerais,20539989,0.3540,1973,7271323,0.1310,459,2690472,0.0000,0,170
2021-06-28,Brazil,203070494,Minas Gerais,20539989,0.3585,92277,7363600,0.1315,11363,2701835,0.0000,0,170
2021-06-29,Brazil,203070494,Minas Gerais,20539989,0.3651,135807,7499407,0.1321,10630,2712465,0.0000,0,170
2021-06-30,Brazil,203070494,Minas Gerais,20539989,0.3729,159089,7658496,0.1327,13159,2725624,0.0000,0,170
2021-07-01,Brazil,203070494,Minas Gerais,20539989,0.3794,134773,7793269,0.1334,14304,2739928,0.0000,0,170
2021-07-02,Brazil,203070494,Minas Gerais,20539989,0.3857,129458,7922727,0.1339,11039,2750967,0.0000,0,170
2021-07-03,Brazil,203070494,Minas Gerais,20539989,0.3884,55064,7977791,0.1341,3807,2754774,0.0000,0,170
2021-07-04,Brazil,203070494,Minas Gerais,20539989,0.3889,9584,7987375,0.1341,151,2754925,0.0000,0,170
2021-07-05,Brazil,203070494,Minas Gerais,20539989,0.3939,102345,8089720,0.1347,11763,2766688,0.0000,0,170
2021-07-06,Brazil,203070494,Minas Gerais,20539989,0.4020,167732,8257452,0.1353,12459,2779147,0.0000,0,170
2021-07-07,Brazil,203070494,Minas Gerais,20539989,0.4103,170168,8427620,0.1368,31599,2810746,0.0000,0,170
2021-07-08,Brazil,203070494,Minas Gerais,20539989,0.4186,169510,8597130,0.1377,17486,2828232,0.0000,0,170
2021-07-09,Brazil,203070494,Minas Gerais,20539989,0.4286,206840,8803970,0.1387,19842,2848074,0.0000,0,170
2021-07-10,Brazil,203070494,Minas Gerais,20539989,0.4343,116249,8920219,0.1390,6472,2854546,0.0000,0,170
2021-07-11,Brazil,203070494,Minas Gerais,20539989,0.4353,20461,8940680,0.1390,108,2854654,0.0000,0,170
2021-07-12,Brazil,203070494,Minas Gerais,20539989,0.4430,158081,9098761,0.1399,18958,2873612,0.0000,0,170
2021-07-13,Brazil,203070494,Minas Gerais,20539989,0.4505,153613,9252374,0.1425,53131,2926743,0.0000,0,170
2021-07-14,Brazil,203070494,Minas Gerais,20539989,0.4599,193854,9446228,0.1451,54378,2981121,0.0000,0,170
2021-07-15,Brazil,203070494,Minas Gerais,20539989,0.4665,135267,9581495,0.1482,62884,3044005,0.0000,0,170
2021-07-16,Brazil,203070494,Minas Gerais,20539989,0.4728,130479,9711974,0.1498,33768,3077773,0.0000,0,170
2021-07-17,Brazil,203070494,Minas Gerais,20539989,0.4749,41995,9753969,0.1509,21090,3098863,0.0000,0,170
2021-07-18,Brazil,203070494,Minas Gerais,20539989,0.4751,3637,9757606,0.1509,1599,3100462,0.0000,0,170
2021-07-19,Brazil,203070494,Minas Gerais,20539989,0.4794,89534,9847140,0.1532,47041,3147503,0.0000,0,170
2021-07-20,Brazil,203070494,Minas Gerais,20539989,0.4857,128378,9975518,0.1565,66701,3214204,0.0000,0,170
2021-07-21,Brazil,203070494,Minas Gerais,20539989,0.4913,115655,10091173,0.1603,78670,3292874,0.0000,0,170
2021-07-22,Brazil,203070494,Minas Gerais,20539989,0.4972,121011,10212184,0.1643,82311,3375185,0.0000,0,170
2021-07-23,Brazil,203070494,Minas Gerais,20539989,0.5047,154275,10366459,0.1674,64113,3439298,0.0000,0,170
2021-07-24,Brazil,203070494,Minas Gerais,20539989,0.5082,72627,10439086,0.1682,16325,3455623,0.0000,0,170
2021-07-25,Brazil,203070494,Minas Gerais,20539989,0.5087,9968,10449054,0.1683,1358,3456981,0.0000,0,170
2021-07-26,Brazil,203070494,Minas Gerais,20539989,0.5151,130776,10579830,0.1707,49272,3506253,0.0000,0,170
2021-07-27,Brazil,203070494,Minas Gerais,20539989,0.5205,112096,10691926,0.1750,87349,3593602,0.0000,0,170
2021-07-28,Brazil,203070494,Minas Gerais,20539989,0.5248,86630,10778556,0.1801,105736,3699338,0.0000,0,170
2021-07-29,Brazil,203070494,Minas Gerais,20539989,0.5290,86888,10865444,0.1846,93182,3792520,0.0000,0,170
2021-07-30,Brazil,203070494,Minas Gerais,20539989,0.5324,69231,10934675,0.1882,72318,3864838,0.0000,14,184
2021-07-31,Brazil,203070494,Minas Gerais,20539989,0.5340,34133,10968808,0.1892,21569,3886407,0.0000,0,184
2021-08-01,Brazil,203070494,Minas Gerais,20539989,0.5341,2104,10970912,0.1899,13195,3899602,0.0000,0,184
2021-08-02,Brazil,203070494,Minas Gerais,20539989,0.5372,64021,11034933,0.1929,63394,3962996,0.0000,0,184
2021-08-03,Brazil,203070494,Minas Gerais,20539989,0.5401,58652,11093585,0.1963,68560,4031556,0.0000,0,184
2021-08-04,Brazil,203070494,Minas Gerais,20539989,0.5441,82812,11176397,0.1999,75118,4106674,0.0000,0,184
2021-08-05,Brazil,203070494,Minas Gerais,20539989,0.5512,145384,11321781,0.2042,88192,4194866,0.0000,0,184
2021-08-06,Brazil,203070494,Minas Gerais,20539989,0.5577,133684,11455465,0.2085,88276,4283142,0.0000,2,186
2021-08-07,Brazil,203070494,Minas Gerais,20539989,0.5595,37685,11493150,0.2098,25353,4308495,0.0000,0,186
2021-08-08,Brazil,203070494,Minas Gerais,20539989,0.5596,526,11493676,0.2098,153,4308648,0.0000,0,186
2021-08-09,Brazil,203070494,Minas Gerais,20539989,0.5630,69645,11563321,0.2137,80636,4389284,0.0000,0,186
2021-08-10,Brazil,203070494,Minas Gerais,20539989,0.5690,124170,11687491,0.2170,68387,4457671,0.0000,0,186
2021-08-11,Brazil,203070494,Minas Gerais,20539989,0.5758,139088,11826579,0.2206,72460,4530131,0.0000,0,186
2021-08-12,Brazil,203070494,Minas Gerais,20539989,0.5836,160535,11987114,0.2244,79139,4609270,0.0000,1,187
2021-08-13,Brazil,203070494,Minas Gerais,20539989,0.5934,202091,12189205,0.2274,62413,4671683,0.0000,0,187
2021-08-14,Brazil,203070494,Minas Gerais,20539989,0.5985,103152,12292357,0.2280,11298,4682981,0.0000,0,187
2021-08-15,Brazil,203070494,Minas Gerais,20539989,0.5989,9404,12301761,0.2281,2671,4685652,0.0000,0,187
2021-08-16,Brazil,203070494,Minas Gerais,20539989,0.6046,117635,12419396,0.2311,61978,4747630,0.0000,0,187
2021-08-17,Brazil,203070494,Minas Gerais,20539989,0.6112,134428,12553824,0.2348,74138,4821768,0.0000,0,187
2021-08-18,Brazil,203070494,Minas Gerais,20539989,0.6186,151517,12705341,0.2388,83309,4905077,0.0000,0,187
2021-08-19,Brazil,203070494,Minas Gerais,20539989,0.6274,180729,12886070,0.2419,63808,4968885,0.0000,0,187
2021-08-20,Brazil,203070494,Minas Gerais,20539989,0.6347,151188,13037258,0.2464,91428,5060313,0.0000,1,188
2021-08-21,Brazil,203070494,Minas Gerais,20539989,0.6387,82294,13119552,0.2471,15654,5075967,0.0000,0,188
2021-08-22,Brazil,203070494,Minas Gerais,20539989,0.6402,30963,13150515,0.2472,1702,5077669,0.0000,0,188
2021-08-23,Brazil,203070494,Minas Gerais,20539989,0.6470,138134,13288649,0.2504,65207,5142876,0.0000,0,188
2021-08-24,Brazil,203070494,Minas Gerais,20539989,0.6522,107598,13396247,0.2544,82311,5225187,0.0000,0,188
2021-08-25,Brazil,203070494,Minas Gerais,20539989,0.6589,137553,13533800,0.2586,86204,5311391,0.0000,0,188
2021-08-26,Brazil,203070494,Minas Gerais,20539989,0.6675,177590,13711390,0.2621,72504,5383895,0.0000,0,188
2021-08-27,Brazil,203070494,Minas Gerais,20539989,0.6757,167089,13878479,0.2663,86210,5470105,0.0000,0,188
2021-08-28,Brazil,203070494,Minas Gerais,20539989,0.6804,96004,13974483,0.2673,20999,5491104,0.0000,0,188
2021-08-29,Brazil,203070494,Minas Gerais,20539989,0.6813,20268,13994751,0.2678,8939,5500043,0.0000,0,188
2021-08-30,Brazil,203070494,Minas Gerais,20539989,0.6860,95048,14089799,0.2724,95583,5595626,0.0000,0,188
2021-08-31,Brazil,203070494,Minas Gerais,20539989,0.6923,130881,14220680,0.2769,91138,5686764,0.0000,0,188
2021-09-01,Brazil,203070494,Minas Gerais,20539989,0.6977,109378,14330058,0.2827,120741,5807505,0.0000,0,188
2021-09-02,Brazil,203070494,Minas Gerais,20539989,0.7025,99768,14429826,0.2891,131612,5939117,0.0000,0,188
2021-09-03,Brazil,203070494,Minas Gerais,20539989,0.7064,78984,14508810,0.2948,115510,6054627,0.0000,0,188
2021-09-04,Brazil,203070494,Minas Gerais,20539989,0.7078,29940,14538750,0.2959,24044,6078671,0.0000,0,188
2021-09-05,Brazil,203070494,Minas Gerais,20539989,0.7078,408,14539158,0.2962,5580,6084251,0.0000,0,188
2021-09-06,Brazil,203070494,Minas Gerais,20539989,0.7086,15658,14554816,0.2981,39369,6123620,0.0000,0,188
2021-09-07,Brazil,203070494,Minas Gerais,20539989,0.7086,797,14555613,0.2989,14857,6138477,0.0000,0,188
2021-09-08,Brazil,203070494,Minas Gerais,20539989,0.7106,40279,14595892,0.3069,164383,6302860,0.0000,0,188
2021-09-09,Brazil,203070494,Minas Gerais,20539989,0.7135,59724,14655616,0.3154,175413,6478273,0.0000,0,188
2021-09-10,Brazil,203070494,Minas Gerais,20539989,0.7180,92608,14748224,0.3227,149202,6627475,0.0000,0,188
2021-09-11,Brazil,203070494,Minas Gerais,20539989,0.7200,39966,14788190,0.3244,34865,6662340,0.0000,0,188
2021-09-12,Brazil,203070494,Minas Gerais,20539989,0.7200,563,14788753,0.3249,11889,6674229,0.0000,0,188
2021-09-13,Brazil,203070494,Minas Gerais,20539989,0.7220,41341,14830094,0.3312,128443,6802672,0.0000,0,188
2021-09-14,Brazil,203070494,Minas Gerais,20539989,0.7249,59744,14889838,0.3376,131152,6933824,0.0000,0,188
2021-09-15,Brazil,203070494,Minas Gerais,20539989,0.7282,66532,14956370,0.3437,126659,7060483,0.0000,0,188
2021-09-16,Brazil,203070494,Minas Gerais,20539989,0.7311,61440,15017810,0.3506,140708,7201191,0.0000,7,195
2021-09-17,Brazil,203070494,Minas Gerais,20539989,0.7335,47750,15065560,0.3565,122026,7323217,0.0000,3,198
2021-09-18,Brazil,203070494,Minas Gerais,20539989,0.7342,15171,15080731,0.3582,33564,7356781,0.0000,0,198
2021-09-19,Brazil,203070494,Minas Gerais,20539989,0.7342,350,15081081,0.3586,9046,7365827,0.0000,0,198
2021-09-20,Brazil,203070494,Minas Gerais,20539989,0.7354,23777,15104858,0.3643,116309,7482136,0.0000,0,198
2021-09-21,Brazil,203070494,Minas Gerais,20539989,0.7372,37422,15142280,0.3712,141802,7623938,0.0000,0,198
2021-09-22,Brazil,203070494,Minas Gerais,20539989,0.7397,50649,15192929,0.3775,129809,7753747,0.0000,0,198
2021-09-23,Brazil,203070494,Minas Gerais,20539989,0.7426,59352,15252281,0.3847,147260,7901007,0.0000,0,198
2021-09-24,Brazil,203070494,Minas Gerais,20539989,0.7458,66701,15318982,0.3913,136149,8037156,0.0000,0,198
2021-09-25,Brazil,203070494,Minas Gerais,20539989,0.7465,14648,15333630,0.3938,51371,8088527,0.0000,0,198
2021-09-26,Brazil,203070494,Minas Gerais,20539989,0.7465,268,15333898,0.3944,12147,8100674,0.0000,0,198
2021-09-27,Brazil,203070494,Minas Gerais,20539989,0.7485,39339,15373237,0.4012,139877,8240551,0.0000,0,198
2021-09-28,Brazil,203070494,Minas Gerais,20539989,0.7509,49585,15422822,0.4089,157370,8397921,0.0000,0,198
2021-09-29,Brazil,203070494,Minas Gerais,20539989,0.7544,73477,15496299,0.4161,149117,8547038,0.0000,1,199
2021-09-30,Brazil,203070494,Minas Gerais,20539989,0.7575,61907,15558206,0.4235,151511,8698549,0.0000,0,199
2021-10-01,Brazil,203070494,Minas Gerais,20539989,0.7607,66351,15624557,0.4301,134681,8833230,0.0000,0,199
2021-10-02,Brazil,203070494,Minas Gerais,20539989,0.7621,28063,15652620,0.4330,60504,8893734,0.0000,0,199
2021-10-03,Brazil,203070494,Minas Gerais,20539989,0.7622,3444,15656064,0.4333,7094,8900828,0.0000,0,199
2021-10-04,Brazil,203070494,Minas Gerais,20539989,0.7653,63450,15719514,0.4386,108327,9009155,0.0000,0,199
2021-10-05,Brazil,203070494,Minas Gerais,20539989,0.7689,74291,15793805,0.4444,118111,9127266,0.0000,1,200
2021-10-06,Brazil,203070494,Minas Gerais,20539989,0.7723,70004,15863809,0.4514,144666,9271932,0.0000,0,200
2021-10-07,Brazil,203070494,Minas Gerais,20539989,0.7760,75438,15939247,0.4586,147906,9419838,0.0000,2,202
2021-10-08,Brazil,203070494,Minas Gerais,20539989,0.7807,97082,16036329,0.4665,162091,9581929,0.0000,3,205
2021-10-09,Brazil,203070494,Minas Gerais,20539989,0.7820,26093,16062422,0.4679,28853,9610782,0.0000,0,205
2021-10-10,Brazil,203070494,Minas Gerais,20539989,0.7822,3628,16066050,0.4683,8369,9619151,0.0000,0,205
2021-10-11,Brazil,203070494,Minas Gerais,20539989,0.7828,13360,16079410,0.4708,51417,9670568,0.0000,0,205
2021-10-12,Brazil,203070494,Minas Gerais,20539989,0.7830,3441,16082851,0.4711,5769,9676337,0.0000,0,205
2021-10-13,Brazil,203070494,Minas Gerais,20539989,0.7848,37232,16120083,0.4794,171407,9847744,0.0000,1,206
2021-10-14,Brazil,203070494,Minas Gerais,20539989,0.7868,41607,16161690,0.4880,176297,10024041,0.0000,6,212
2021-10-15,Brazil,203070494,Minas Gerais,20539989,0.7887,39093,16200783,0.4955,154262,10178303,0.0000,0,212
2021-10-16,Brazil,203070494,Minas Gerais,20539989,0.7902,30594,16231377,0.4977,45108,10223411,0.0000,0,212
2021-10-17,Brazil,203070494,Minas Gerais,20539989,0.7903,1617,16232994,0.4983,11079,10234490,0.0000,0,212
2021-10-18,Brazil,203070494,Minas Gerais,20539989,0.7916,27395,16260389,0.5047,132503,10366993,0.0000,5,217
2021-10-19,Brazil,203070494,Minas Gerais,20539989,0.7932,31914,16292303,0.5105,118756,10485749,0.0000,1,218
2021-10-20,Brazil,203070494,Minas Gerais,20539989,0.7947,30500,16322803,0.5172,136698,10622447,0.0000,0,218
2021-10-21,Brazil,203070494,Minas Gerais,20539989,0.7961,28461,16351264,0.5239,139241,10761688,0.0000,1,219
2021-10-22,Brazil,203070494,Minas Gerais,20539989,0.7973,25509,16376773,0.5301,126648,10888336,0.0000,1,220
2021-10-23,Brazil,203070494,Minas Gerais,20539989,0.7975,4609,16381382,0.5315,29349,10917685,0.0000,0,220
2021-10-24,Brazil,203070494,Minas Gerais,20539989,0.7977,2730,16384112,0.5319,6946,10924631,0.0000,0,220
2021-10-25,Brazil,203070494,Minas Gerais,20539989,0.7985,17078,16401190,0.5370,106036,11030667,0.0000,0,220
2021-10-26,Brazil,203070494,Minas Gerais,20539989,0.7994,18263,16419453,0.5432,127346,11158013,0.0000,2,222
2021-10-27,Brazil,203070494,Minas Gerais,20539989,0.8009,30124,16449577,0.5502,142497,11300510,0.0000,0,222
2021-10-28,Brazil,203070494,Minas Gerais,20539989,0.8024,31885,16481462,0.5564,127025,11427535,0.0000,0,222
2021-10-29,Brazil,203070494,Minas Gerais,20539989,0.8034,20799,16502261,0.5611,97200,11524735,0.0000,0,222
2021-10-30,Brazil,203070494,Minas Gerais,20539989,0.8037,5969,16508230,0.5619,16000,11540735,0.0000,0,222
2021-10-31,Brazil,203070494,Minas Gerais,20539989,0.8040,6463,16514693,0.5621,4041,11544776,0.0000,0,222
2021-11-01,Brazil,203070494,Minas Gerais,20539989,0.8042,3065,16517758,0.5641,41215,11585991,0.0000,0,222
2021-11-02,Brazil,203070494,Minas Gerais,20539989,0.8042,446,16518204,0.5643,3850,11589841,0.0000,0,222
2021-11-03,Brazil,203070494,Minas Gerais,20539989,0.8050,17417,16535621,0.5701,119982,11709823,0.0000,1,223
2021-11-04,Brazil,203070494,Minas Gerais,20539989,0.8060,18632,16554253,0.5774,149956,11859779,0.0000,0,223
2021-11-05,Brazil,203070494,Minas Gerais,20539989,0.8072,24941,16579194,0.5851,158244,12018023,0.0000,2,225
2021-11-06,Brazil,203070494,Minas Gerais,20539989,0.8077,11040,16590234,0.5863,25505,12043528,0.0000,0,225
2021-11-07,Brazil,203070494,Minas Gerais,20539989,0.8079,4696,16594930,0.5866,5888,12049416,0.0000,0,225
2021-11-08,Brazil,203070494,Minas Gerais,20539989,0.8089,18919,16613849,0.5918,107084,12156500,0.0000,1,226
2021-11-09,Brazil,203070494,Minas Gerais,20539989,0.8100,22872,16636721,0.5976,118759,12275259,0.0000,1,227
2021-11-10,Brazil,203070494,Minas Gerais,20539989,0.8109,18868,16655589,0.6029,107866,12383125,0.0000,0,227
2021-11-11,Brazil,203070494,Minas Gerais,20539989,0.8117,17619,16673208,0.6080,104852,12487977,0.0000,0,227
2021-11-12,Brazil,203070494,Minas Gerais,20539989,0.8127,18958,16692166,0.6127,97068,12585045,0.0000,0,227
2021-11-13,Brazil,203070494,Minas Gerais,20539989,0.8129,3887,16696053,0.6134,14290,12599335,0.0000,1,228
2021-11-14,Brazil,203070494,Minas Gerais,20539989,0.8131,4557,16700610,0.6137,6031,12605366,0.0000,0,228
2021-11-15,Brazil,203070494,Minas Gerais,20539989,0.8133,4704,16705314,0.6139,4762,12610128,0.0000,0,228
2021-11-16,Brazil,203070494,Minas Gerais,20539989,0.8139,12403,16717717,0.6184,91708,12701836,0.0000,1,229
2021-11-17,Brazil,203070494,Minas Gerais,20539989,0.8145,13130,16730847,0.6238,110464,12812300,0.0000,0,229
2021-11-18,Brazil,203070494,Minas Gerais,20539989,0.8152,13583,16744430,0.6289,104598,12916898,0.0000,1,230
2021-11-19,Brazil,203070494,Minas Gerais,20539989,0.8160,17000,16761430,0.6340,105415,13022313,0.0000,0,230
2021-11-20,Brazil,203070494,Minas Gerais,20539989,0.8164,7622,16769052,0.6352,23813,13046126,0.0000,0,230
2021-11-21,Brazil,203070494,Minas Gerais,20539989,0.8164,799,16769851,0.6352,1605,13047731,0.0000,0,230
2021-11-22,Brazil,203070494,Minas Gerais,20539989,0.8170,11056,16780907,0.6397,92540,13140271,0.0000,1,231
2021-11-23,Brazil,203070494,Minas Gerais,20539989,0.8176,12091,16792998,0.6447,101277,13241548,0.0000,1,232
2021-11-24,Brazil,203070494,Minas Gerais,20539989,0.8182,13444,16806442,0.6497,103614,13345162,0.0000,0,232
2021-11-25,Brazil,203070494,Minas Gerais,20539989,0.8189,13163,16819605,0.6551,111572,13456734,0.0000,2,234
2021-11-26,Brazil,203070494,Minas Gerais,20539989,0.8194,11845,16831450,0.6602,102883,13559617,0.0000,0,234
2021-11-27,Brazil,203070494,Minas Gerais,20539989,0.8196,2511,16833961,0.6617,30925,13590542,0.0000,0,234
2021-11-28,Brazil,203070494,Minas Gerais,20539989,0.8196,161,16834122,0.6622,10401,13600943,0.0000,0,234
2021-11-29,Brazil,203070494,Minas Gerais,20539989,0.8200,9228,16843350,0.6667,93595,13694538,0.0000,0,234
2021-11-30,Brazil,203070494,Minas Gerais,20539989,0.8205,10015,16853365,0.6719,106256,13800794,0.0000,0,234
2021-12-01,Brazil,203070494,Minas Gerais,20539989,0.8210,10373,16863738,0.6764,93475,13894269,0.0000,0,234
2021-12-02,Brazil,203070494,Minas Gerais,20539989,0.8215,9196,16872934,0.6806,84745,13979014,0.0000,6,240
2021-12-03,Brazil,203070494,Minas Gerais,20539989,0.8218,7554,16880488,0.6841,73358,14052372,0.0000,39,279
2021-12-04,Brazil,203070494,Minas Gerais,20539989,0.8219,1507,16881995,0.6850,17176,14069548,0.0000,0,279
2021-12-05,Brazil,203070494,Minas Gerais,20539989,0.8219,575,16882570,0.6851,1516,14071064,0.0000,0,279
2021-12-06,Brazil,203070494,Minas Gerais,20539989,0.8223,6586,16889156,0.6878,56529,14127593,0.0000,0,279
2021-12-07,Brazil,203070494,Minas Gerais,20539989,0.8226,7733,16896889,0.6912,69018,14196611,0.0000,0,279
2021-12-08,Brazil,203070494,Minas Gerais,20539989,0.8229,6158,16903047,0.6934,45939,14242550,0.0000,1,280
2021-12-09,Brazil,203070494,Minas Gerais,20539989,0.8233,8057,16911104,0.6965,62660,14305210,0.0000,0,280
2021-12-10,Brazil,203070494,Minas Gerais,20539989,0.8236,6176,16917280,0.6990,51236,14356446,0.0000,34,314
2021-12-11,Brazil,203070494,Minas Gerais,20539989,0.8237,1294,16918574,0.6995,10333,14366779,0.0000,0,314
2021-12-12,Brazil,203070494,Minas Gerais,20539989,0.8237,176,16918750,0.6995,1482,14368261,0.0000,0,314
2021-12-13,Brazil,203070494,Minas Gerais,20539989,0.8240,5440,16924190,0.7019,48280,14416541,0.0000,49,363
2021-12-14,Brazil,203070494,Minas Gerais,20539989,0.8243,6421,16930611,0.7047,58126,14474667,0.0000,1,364
2021-12-15,Brazil,203070494,Minas Gerais,20539989,0.8246,6165,16936776,0.7073,53229,14527896,0.0000,0,364
2021-12-16,Brazil,203070494,Minas Gerais,20539989,0.8249,6394,16943170,0.7095,46075,14573971,0.0000,0,364
2021-12-17,Brazil,203070494,Minas Gerais,20539989,0.8251,4508,16947678,0.7113,36065,14610036,0.0000,1,365
2021-12-18,Brazil,203070494,Minas Gerais,20539989,0.8252,1300,16948978,0.7117,7519,14617555,0.0000,0,365
2021-12-19,Brazil,203070494,Minas Gerais,20539989,0.8252,194,16949172,0.7117,582,14618137,0.0000,1,366
2021-12-20,Brazil,203070494,Minas Gerais,20539989,0.8255,5951,16955123,0.7133,32074,14650211,0.0000,14,380
2021-12-21,Brazil,203070494,Minas Gerais,20539989,0.8257,4394,16959517,0.7148,31140,14681351,0.0000,1,381
2021-12-22,Brazil,203070494,Minas Gerais,20539989,0.8259,4282,16963799,0.7162,29866,14711217,0.0000,1,382
2021-12-23,Brazil,203070494,Minas Gerais,20539989,0.8260,3068,16966867,0.7175,25295,14736512,0.0000,0,382
2021-12-24,Brazil,203070494,Minas Gerais,20539989,0.8261,192,16967059,0.7175,1371,14737883,0.0000,0,382
2021-12-25,Brazil,203070494,Minas Gerais,20539989,0.8261,23,16967082,0.7175,81,14737964,0.0000,0,382
2021-12-26,Brazil,203070494,Minas Gerais,20539989,0.8261,66,16967148,0.7175,333,14738297,0.0000,0,382
2021-12-27,Brazil,203070494,Minas Gerais,20539989,0.8262,2586,16969734,0.7184,18435,14756732,0.0000,1,383
2021-12-28,Brazil,203070494,Minas Gerais,20539989,0.8263,3266,16973000,0.7195,22429,14779161,0.0000,2,385
2021-12-29,Brazil,203070494,Minas Gerais,20539989,0.8265,3498,16976498,0.7207,23828,14802989,0.0000,0,385
2021-12-30,Brazil,203070494,Minas Gerais,20539989,0.8266,2213,16978711,0.7214,13682,14816671,0.0000,0,385
2021-12-31,Brazil,203070494,Minas Gerais,20539989,0.8266,181,16978892,0.7214,875,14817546,0.0000,0,385
2021-01-02,Brazil,203070494,Paraná,11444380,0.0000,1,1,0.0000,0,0,0.0000,0,0
2021-01-03,Brazil,203070494,Paraná,11444380,0.0000,1,2,0.0000,0,0,0.0000,0,0
2021-01-04,Brazil,203070494,Paraná,11444380,0.0000,2,4,0.0000,0,0,0.0000,0,0
2021-01-05,Brazil,203070494,Paraná,11444380,0.0000,2,6,0.0000,0,0,0.0000,0,0
2021-01-07,Brazil,203070494,Paraná,11444380,0.0000,0,6,0.0000,0,0,0.0000,0,0
2021-01-08,Brazil,203070494,Paraná,11444380,0.0000,1,7,0.0000,0,0,0.0000,0,0
2021-01-11,Brazil,203070494,Paraná,11444380,0.0000,7,14,0.0000,1,1,0.0000,0,0
2021-01-12,Brazil,203070494,Paraná,11444380,0.0000,0,14,0.0000,1,2,0.0000,0,0
2021-01-13,Brazil,203070494,Paraná,11444380,0.0000,2,16,0.0000,0,2,0.0000,0,0
2021-01-14,Brazil,203070494,Paraná,11444380,0.0000,1,17,0.0000,0,2,0.0000,0,0
2021-01-15,Brazil,203070494,Paraná,11444380,0.0000,3,20,0.0000,0,2,0.0000,0,0
2021-01-16,Brazil,203070494,Paraná,11444380,0.0000,1,21,0.0000,0,2,0.0000,0,0
2021-01-17,Brazil,203070494,Paraná,11444380,0.0000,11,32,0.0000,3,5,0.0000,0,0
2021-01-18,Brazil,203070494,Paraná,11444380,0.0000,39,71,0.0000,13,18,0.0000,1,1
2021-01-19,Brazil,203070494,Paraná,11444380,0.0002,2030,2101,0.0000,8,26,0.0000,0,1
2021-01-20,Brazil,203070494,Paraná,11444380,0.0025,26000,28101,0.0000,27,53,0.0000,0,1
2021-01-21,Brazil,203070494,Paraná,11444380,0.0045,23885,51986,0.0000,27,80,0.0000,0,1
2021-01-22,Brazil,203070494,Paraná,11444380,0.0058,13929,65915,0.0000,31,111,0.0000,0,1
2021-01-23,Brazil,203070494,Paraná,11444380,0.0060,2676,68591,0.0000,7,118,0.0000,0,1
2021-01-24,Brazil,203070494,Paraná,11444380,0.0061,1009,69600,0.0000,28,146,0.0000,0,1
2021-01-25,Brazil,203070494,Paraná,11444380,0.0076,17379,86979,0.0000,15,161,0.0000,0,1
2021-01-26,Brazil,203070494,Paraná,11444380,0.0093,19126,106105,0.0000,25,186,0.0000,0,1
2021-01-27,Brazil,203070494,Paraná,11444380,0.0107,16705,122810,0.0000,14,200,0.0000,0,1
2021-01-28,Brazil,203070494,Paraná,11444380,0.0122,16317,139127,0.0000,12,212,0.0000,0,1
2021-01-29,Brazil,203070494,Paraná,11444380,0.0135,15265,154392,0.0000,13,225,0.0000,0,1
2021-01-30,Brazil,203070494,Paraná,11444380,0.0139,5251,159643,0.0000,3,228,0.0000,0,1
2021-01-31,Brazil,203070494,Paraná,11444380,0.0140,655,160298,0.0000,1,229,0.0000,0,1
2021-02-01,Brazil,203070494,Paraná,11444380,0.0147,8411,168709,0.0000,10,239,0.0000,0,1
2021-02-02,Brazil,203070494,Paraná,11444380,0.0155,8610,177319,0.0000,19,258,0.0000,0,1
2021-02-03,Brazil,203070494,Paraná,11444380,0.0163,9315,186634,0.0000,13,271,0.0000,0,1
2021-02-04,Brazil,203070494,Paraná,11444380,0.0170,8024,194658,0.0000,11,282,0.0000,0,1
2021-02-05,Brazil,203070494,Paraná,11444380,0.0177,8057,202715,0.0000,13,295,0.0000,0,1
2021-02-06,Brazil,203070494,Paraná,11444380,0.0180,2727,205442,0.0000,10,305,0.0000,0,1
2021-02-07,Brazil,203070494,Paraná,11444380,0.0180,16,205458,0.0000,1,306,0.0000,0,1
2021-02-08,Brazil,203070494,Paraná,11444380,0.0184,5549,211007,0.0000,62,368,0.0000,0,1
2021-02-09,Brazil,203070494,Paraná,11444380,0.0195,12081,223088,0.0000,58,426,0.0000,0,1
2021-02-10,Brazil,203070494,Paraná,11444380,0.0206,12273,235361,0.0001,1190,1616,0.0000,0,1
2021-02-11,Brazil,203070494,Paraná,11444380,0.0215,10715,246076,0.0003,1823,3439,0.0000,0,1
2021-02-12,Brazil,203070494,Paraná,11444380,0.0224,10559,256635,0.0010,8054,11493,0.0000,0,1
2021-02-13,Brazil,203070494,Paraná,11444380,0.0228,4458,261093,0.0012,2113,13606,0.0000,0,1
2021-02-14,Brazil,203070494,Paraná,11444380,0.0228,29,261122,0.0012,323,13929,0.0000,0,1
2021-02-15,Brazil,203070494,Paraná,11444380,0.0233,5944,267066,0.0022,11754,25683,0.0000,0,1
2021-02-16,Brazil,203070494,Paraná,11444380,0.0237,4731,271797,0.0030,8282,33965,0.0000,0,1
2021-02-17,Brazil,203070494,Paraná,11444380,0.0244,6896,278693,0.0044,16813,50778,0.0000,0,1
2021-02-18,Brazil,203070494,Paraná,11444380,0.0249,6571,285264,0.0059,16785,67563,0.0000,0,1
2021-02-19,Brazil,203070494,Paraná,11444380,0.0255,6084,291348,0.0072,14525,82088,0.0000,0,1
2021-02-20,Brazil,203070494,Paraná,11444380,0.0256,1207,292555,0.0073,1014,83102,0.0000,0,1
2021-02-21,Brazil,203070494,Paraná,11444380,0.0256,56,292611,0.0073,37,83139,0.0000,0,1
2021-02-22,Brazil,203070494,Paraná,11444380,0.0257,2050,294661,0.0082,10325,93464,0.0000,0,1
2021-02-23,Brazil,203070494,Paraná,11444380,0.0260,2379,297040,0.0089,8351,101815,0.0000,0,1
2021-02-24,Brazil,203070494,Paraná,11444380,0.0261,1670,298710,0.0095,6769,108584,0.0000,0,1
2021-02-25,Brazil,203070494,Paraná,11444380,0.0263,1731,300441,0.0099,5134,113718,0.0000,0,1
2021-02-26,Brazil,203070494,Paraná,11444380,0.0270,8183,308624,0.0104,4958,118676,0.0000,0,1
2021-02-27,Brazil,203070494,Paraná,11444380,0.0276,7641,316265,0.0104,506,119182,0.0000,0,1
2021-02-28,Brazil,203070494,Paraná,11444380,0.0278,1957,318222,0.0104,19,119201,0.0000,0,1
2021-03-01,Brazil,203070494,Paraná,11444380,0.0296,19996,338218,0.0107,2685,121886,0.0000,0,1
2021-03-02,Brazil,203070494,Paraná,11444380,0.0316,23266,361484,0.0109,2460,124346,0.0000,0,1
2021-03-03,Brazil,203070494,Paraná,11444380,0.0336,22524,384008,0.0111,2247,126593,0.0000,1,2
2021-03-04,Brazil,203070494,Paraná,11444380,0.0352,18270,402278,0.0113,2617,129210,0.0000,0,2
2021-03-05,Brazil,203070494,Paraná,11444380,0.0367,18229,420507,0.0118,6269,135479,0.0000,0,2
2021-03-06,Brazil,203070494,Paraná,11444380,0.0377,11034,431541,0.0120,2036,137515,0.0000,0,2
2021-03-07,Brazil,203070494,Paraná,11444380,0.0378,1355,432896,0.0120,71,137586,0.0000,0,2
2021-03-08,Brazil,203070494,Paraná,11444380,0.0392,16061,448957,0.0132,13431,151017,0.0000,0,2
2021-03-09,Brazil,203070494,Paraná,11444380,0.0404,13731,462688,0.0142,11444,162461,0.0000,0,2
2021-03-10,Brazil,203070494,Paraná,11444380,0.0415,12353,475041,0.0148,6806,169267,0.0000,0,2
2021-03-11,Brazil,203070494,Paraná,11444380,0.0425,11606,486647,0.0153,5810,175077,0.0000,0,2
2021-03-12,Brazil,203070494,Paraná,11444380,0.0444,21552,508199,0.0160,8247,183324,0.0000,0,2
2021-03-13,Brazil,203070494,Paraná,11444380,0.0451,8071,516270,0.0161,1279,184603,0.0000,0,2
2021-03-14,Brazil,203070494,Paraná,11444380,0.0452,1556,517826,0.0161,108,184711,0.0000,0,2
2021-03-15,Brazil,203070494,Paraná,11444380,0.0468,18112,535938,0.0169,8507,193218,0.0000,0,2
2021-03-16,Brazil,203070494,Paraná,11444380,0.0483,16680,552618,0.0174,5824,199042,0.0000,0,2
2021-03-17,Brazil,203070494,Paraná,11444380,0.0494,12404,565022,0.0176,2466,201508,0.0000,0,2
2021-03-18,Brazil,203070494,Paraná,11444380,0.0504,11481,576503,0.0178,1998,203506,0.0000,0,2
2021-03-19,Brazil,203070494,Paraná,11444380,0.0523,22577,599080,0.0180,2297,205803,0.0000,0,2
2021-03-20,Brazil,203070494,Paraná,11444380,0.0542,20968,620048,0.0180,498,206301,0.0000,0,2
2021-03-21,Brazil,203070494,Paraná,11444380,0.0543,1699,621747,0.0180,156,206457,0.0000,0,2
2021-03-22,Brazil,203070494,Paraná,11444380,0.0568,27742,649489,0.0183,2877,209334,0.0000,0,2
2021-03-23,Brazil,203070494,Paraná,11444380,0.0599,35511,685000,0.0186,3904,213238,0.0000,0,2
2021-03-24,Brazil,203070494,Paraná,11444380,0.0652,60686,745686,0.0188,2441,215679,0.0000,0,2
2021-03-25,Brazil,203070494,Paraná,11444380,0.0713,69928,815614,0.0191,2712,218391,0.0000,0,2
2021-03-26,Brazil,203070494,Paraná,11444380,0.0763,57554,873168,0.0195,4243,222634,0.0000,0,2
2021-03-27,Brazil,203070494,Paraná,11444380,0.0835,82433,955601,0.0195,958,223592,0.0000,0,2
2021-03-28,Brazil,203070494,Paraná,11444380,0.0874,44566,1000167,0.0196,401,223993,0.0000,0,2
2021-03-29,Brazil,203070494,Paraná,11444380,0.0931,65829,1065996,0.0204,9078,233071,0.0000,0,2
2021-03-30,Brazil,203070494,Paraná,11444380,0.0992,69289,1135285,0.0214,11368,244439,0.0000,0,2
2021-03-31,Brazil,203070494,Paraná,11444380,0.1030,43771,1179056,0.0223,10668,255107,0.0000,0,2
2021-04-01,Brazil,203070494,Paraná,11444380,0.1060,34577,1213633,0.0231,8692,263799,0.0000,1,3
2021-04-02,Brazil,203070494,Paraná,11444380,0.1068,8387,1222020,0.0231,621,264420,0.0000,0,3
2021-04-03,Brazil,203070494,Paraná,11444380,0.1083,17467,1239487,0.0233,2121,266541,0.0000,0,3
2021-04-04,Brazil,203070494,Paraná,11444380,0.1084,1140,1240627,0.0233,553,267094,0.0000,0,3
2021-04-05,Brazil,203070494,Paraná,11444380,0.1092,9666,1250293,0.0253,22299,289393,0.0000,0,3
2021-04-06,Brazil,203070494,Paraná,11444380,0.1102,11113,1261406,0.0272,21708,311101,0.0000,0,3
2021-04-07,Brazil,203070494,Paraná,11444380,0.1111,9680,1271086,0.0284,14369,325470,0.0000,0,3
2021-04-08,Brazil,203070494,Paraná,11444380,0.1118,7944,1279030,0.0294,11141,336611,0.0000,0,3
2021-04-09,Brazil,203070494,Paraná,11444380,0.1132,16870,1295900,0.0309,17166,353777,0.0000,0,3
2021-04-10,Brazil,203070494,Paraná,11444380,0.1162,34137,1330037,0.0313,4959,358736,0.0000,0,3
2021-04-11,Brazil,203070494,Paraná,11444380,0.1168,6657,1336694,0.0315,1683,360419,0.0000,0,3
2021-04-12,Brazil,203070494,Paraná,11444380,0.1190,25510,1362204,0.0332,19956,380375,0.0000,0,3
2021-04-13,Brazil,203070494,Paraná,11444380,0.1202,13698,1375902,0.0355,26127,406502,0.0000,0,3
2021-04-14,Brazil,203070494,Paraná,11444380,0.1209,8255,1384157,0.0379,27107,433609,0.0000,0,3
2021-04-15,Brazil,203070494,Paraná,11444380,0.1216,7546,1391703,0.0402,26937,460546,0.0000,0,3
2021-04-16,Brazil,203070494,Paraná,11444380,0.1228,13618,1405321,0.0436,38710,499256,0.0000,0,3
2021-04-17,Brazil,203070494,Paraná,11444380,0.1272,50240,1455561,0.0447,12735,511991,0.0000,0,3
2021-04-18,Brazil,203070494,Paraná,11444380,0.1292,23004,1478565,0.0451,3711,515702,0.0000,0,3
2021-04-19,Brazil,203070494,Paraná,11444380,0.1322,34092,1512657,0.0522,81224,596926,0.0000,0,3
2021-04-20,Brazil,203070494,Paraná,11444380,0.1351,33710,1546367,0.0591,78963,675889,0.0000,0,3
2021-04-21,Brazil,203070494,Paraná,11444380,0.1364,14937,1561304,0.0606,17702,693591,0.0000,0,3
2021-04-22,Brazil,203070494,Paraná,11444380,0.1412,54149,1615453,0.0692,98925,792516,0.0000,0,3
2021-04-23,Brazil,203070494,Paraná,11444380,0.1435,26503,1641956,0.0759,76574,869090,0.0000,1,4
2021-04-24,Brazil,203070494,Paraná,11444380,0.1461,30484,1672440,0.0786,30817,899907,0.0000,0,4
2021-04-25,Brazil,203070494,Paraná,11444380,0.1475,15772,1688212,0.0798,13109,913016,0.0000,1,5
2021-04-26,Brazil,203070494,Paraná,11444380,0.1514,44680,1732892,0.0851,60797,973813,0.0000,0,5
2021-04-27,Brazil,203070494,Paraná,11444380,0.1552,42984,1775876,0.0880,32803,1006616,0.0000,0,5
2021-04-28,Brazil,203070494,Paraná,11444380,0.1571,22478,1798354,0.0900,23324,1029940,0.0000,0,5
2021-04-29,Brazil,203070494,Paraná,11444380,0.1587,18071,1816425,0.0915,17525,1047465,0.0000,0,5
2021-04-30,Brazil,203070494,Paraná,11444380,0.1599,13011,1829436,0.0930,17019,1064484,0.0000,0,5
2021-05-01,Brazil,203070494,Paraná,11444380,0.1618,22656,1852092,0.0935,5349,1069833,0.0000,0,5
2021-05-02,Brazil,203070494,Paraná,11444380,0.1640,24885,1876977,0.0936,1686,1071519,0.0000,0,5
2021-05-03,Brazil,203070494,Paraná,11444380,0.1692,59095,1936072,0.0947,12584,1084103,0.0000,1,6
2021-05-04,Brazil,203070494,Paraná,11444380,0.1742,57300,1993372,0.0958,11711,1095814,0.0000,0,6
2021-05-05,Brazil,203070494,Paraná,11444380,0.1784,48675,2042047,0.0966,9142,1104956,0.0000,0,6
2021-05-06,Brazil,203070494,Paraná,11444380,0.1807,26137,2068184,0.0971,6613,1111569,0.0000,0,6
2021-05-07,Brazil,203070494,Paraná,11444380,0.1832,27948,2096132,0.0979,8491,1120060,0.0000,0,6
2021-05-08,Brazil,203070494,Paraná,11444380,0.1845,15866,2111998,0.0981,2450,1122510,0.0000,0,6
2021-05-09,Brazil,203070494,Paraná,11444380,0.1846,310,2112308,0.0981,11,1122521,0.0000,0,6
2021-05-10,Brazil,203070494,Paraná,11444380,0.1867,24788,2137096,0.0986,6392,1128913,0.0000,0,6
2021-05-11,Brazil,203070494,Paraná,11444380,0.1891,27370,2164466,0.0990,4045,1132958,0.0000,0,6
2021-05-12,Brazil,203070494,Paraná,11444380,0.1912,24250,2188716,0.0994,4963,1137921,0.0000,0,6
2021-05-13,Brazil,203070494,Paraná,11444380,0.1939,29813,2218529,0.1005,12178,1150099,0.0000,0,6
2021-05-14,Brazil,203070494,Paraná,11444380,0.1965,30108,2248637,0.1014,9963,1160062,0.0000,0,6
2021-05-15,Brazil,203070494,Paraná,11444380,0.1975,11221,2259858,0.1016,2737,1162799,0.0000,0,6
2021-05-16,Brazil,203070494,Paraná,11444380,0.1975,565,2260423,0.1016,90,1162889,0.0000,0,6
2021-05-17,Brazil,203070494,Paraná,11444380,0.2001,29662,2290085,0.1021,6020,1168909,0.0000,0,6
2021-05-18,Brazil,203070494,Paraná,11444380,0.2028,30707,2320792,0.1025,4217,1173126,0.0000,0,6
2021-05-19,Brazil,203070494,Paraná,11444380,0.2063,39927,2360719,0.1030,6007,1179133,0.0000,0,6
2021-05-20,Brazil,203070494,Paraná,11444380,0.2107,50839,2411558,0.1035,5475,1184608,0.0000,0,6
2021-05-21,Brazil,203070494,Paraná,11444380,0.2145,43729,2455287,0.1041,7202,1191810,0.0000,0,6
2021-05-22,Brazil,203070494,Paraná,11444380,0.2157,12708,2467995,0.1044,2885,1194695,0.0000,0,6
2021-05-23,Brazil,203070494,Paraná,11444380,0.2158,2023,2470018,0.1044,57,1194752,0.0000,0,6
2021-05-24,Brazil,203070494,Paraná,11444380,0.2190,36030,2506048,0.1051,7721,1202473,0.0000,0,6
2021-05-25,Brazil,203070494,Paraná,11444380,0.2229,45345,2551393,0.1058,8242,1210715,0.0000,0,6
2021-05-26,Brazil,203070494,Paraná,11444380,0.2262,37400,2588793,0.1065,7953,1218668,0.0000,0,6
2021-05-27,Brazil,203070494,Paraná,11444380,0.2295,37258,2626051,0.1076,13170,1231838,0.0000,0,6
2021-05-28,Brazil,203070494,Paraná,11444380,0.2326,35692,2661743,0.1084,9280,1241118,0.0000,0,6
2021-05-29,Brazil,203070494,Paraná,11444380,0.2338,13859,2675602,0.1087,2565,1243683,0.0000,0,6
2021-05-30,Brazil,203070494,Paraná,11444380,0.2342,4393,2679995,0.1087,34,1243717,0.0000,0,6
2021-05-31,Brazil,203070494,Paraná,11444380,0.2378,41830,2721825,0.1094,8595,1252312,0.0000,0,6
2021-06-01,Brazil,203070494,Paraná,11444380,0.2427,56231,2778056,0.1105,12529,1264841,0.0000,0,6
2021-06-02,Brazil,203070494,Paraná,11444380,0.2485,65434,2843490,0.1116,12721,1277562,0.0000,0,6
2021-06-03,Brazil,203070494,Paraná,11444380,0.2495,12068,2855558,0.1117,992,1278554,0.0000,0,6
2021-06-04,Brazil,203070494,Paraná,11444380,0.2529,39166,2894724,0.1120,3573,1282127,0.0000,0,6
2021-06-05,Brazil,203070494,Paraná,11444380,0.2573,49756,2944480,0.1122,1626,1283753,0.0000,0,6
2021-06-06,Brazil,203070494,Paraná,11444380,0.2579,6926,2951406,0.1122,112,1283865,0.0000,0,6
2021-06-07,Brazil,203070494,Paraná,11444380,0.2647,77876,3029282,0.1128,7515,1291380,0.0000,0,6
2021-06-08,Brazil,203070494,Paraná,11444380,0.2729,94183,3123465,0.1133,4967,1296347,0.0000,0,6
2021-06-09,Brazil,203070494,Paraná,11444380,0.2805,87254,3210719,0.1136,3417,1299764,0.0000,0,6
2021-06-10,Brazil,203070494,Paraná,11444380,0.2876,80682,3291401,0.1138,2310,1302074,0.0000,0,6
2021-06-11,Brazil,203070494,Paraná,11444380,0.2947,81047,3372448,0.1140,2661,1304735,0.0000,0,6
2021-06-12,Brazil,203070494,Paraná,11444380,0.3011,73508,3445956,0.1141,1107,1305842,0.0000,1,7
2021-06-13,Brazil,203070494,Paraná,11444380,0.3021,11090,3457046,0.1141,52,1305894,0.0000,0,7
2021-06-14,Brazil,203070494,Paraná,11444380,0.3095,84469,3541515,0.1143,2048,1307942,0.0000,0,7
2021-06-15,Brazil,203070494,Paraná,11444380,0.3188,107175,3648690,0.1145,2187,1310129,0.0000,0,7
2021-06-16,Brazil,203070494,Paraná,11444380,0.3293,120398,3769088,0.1147,2396,1312525,0.0000,0,7
2021-06-17,Brazil,203070494,Paraná,11444380,0.3374,92509,3861597,0.1149,2248,1314773,0.0000,0,7
2021-06-18,Brazil,203070494,Paraná,11444380,0.3447,83335,3944932,0.1151,2410,1317183,0.0000,0,7
2021-06-19,Brazil,203070494,Paraná,11444380,0.3486,44964,3989896,0.1152,695,1317878,0.0000,0,7
2021-06-20,Brazil,203070494,Paraná,11444380,0.3506,22701,4012597,0.1152,594,1318472,0.0000,1,8
2021-06-21,Brazil,203070494,Paraná,11444380,0.3575,79054,4091651,0.1156,4394,1322866,0.0000,0,8
2021-06-22,Brazil,203070494,Paraná,11444380,0.3641,75641,4167292,0.1160,4204,1327070,0.0000,0,8
2021-06-23,Brazil,203070494,Paraná,11444380,0.3685,49572,4216864,0.1164,5034,1332104,0.0000,0,8
2021-06-24,Brazil,203070494,Paraná,11444380,0.3714,34036,4250900,0.1167,3232,1335336,0.0000,0,8
2021-06-25,Brazil,203070494,Paraná,11444380,0.3752,42762,4293662,0.1170,3131,1338467,0.0000,0,8
2021-06-26,Brazil,203070494,Paraná,11444380,0.3803,58961,4352623,0.1170,592,1339059,0.0000,1,9
2021-06-27,Brazil,203070494,Paraná,11444380,0.3820,19040,4371663,0.1170,68,1339127,0.0000,0,9
2021-06-28,Brazil,203070494,Paraná,11444380,0.3883,71821,4443484,0.1173,3626,1342753,0.0000,0,9
2021-06-29,Brazil,203070494,Paraná,11444380,0.3935,59680,4503164,0.1177,4395,1347148,0.0000,0,9
2021-06-30,Brazil,203070494,Paraná,11444380,0.3965,34954,4538118,0.1181,4626,1351774,0.0000,0,9
2021-07-01,Brazil,203070494,Paraná,11444380,0.4006,46867,4584985,0.1185,4112,1355886,0.0000,0,9
2021-07-02,Brazil,203070494,Paraná,11444380,0.4048,47913,4632898,0.1192,7834,1363720,0.0000,0,9
2021-07-03,Brazil,203070494,Paraná,11444380,0.4126,89310,4722208,0.1196,4927,1368647,0.0000,0,9
2021-07-04,Brazil,203070494,Paraná,11444380,0.4139,14681,4736889,0.1197,1008,1369655,0.0000,0,9
2021-07-05,Brazil,203070494,Paraná,11444380,0.4208,78480,4815369,0.1209,13880,1383535,0.0000,1,10
2021-07-06,Brazil,203070494,Paraná,11444380,0.4303,109458,4924827,0.1220,12545,1396080,0.0000,0,10
2021-07-07,Brazil,203070494,Paraná,11444380,0.4413,125658,5050485,0.1225,5307,1401387,0.0000,0,10
2021-07-08,Brazil,203070494,Paraná,11444380,0.4489,86377,5136862,0.1231,7135,1408522,0.0000,0,10
2021-07-09,Brazil,203070494,Paraná,11444380,0.4544,63579,5200441,0.1250,21744,1430266,0.0000,0,10
2021-07-10,Brazil,203070494,Paraná,11444380,0.4619,85809,5286250,0.1260,11192,1441458,0.0000,3,13
2021-07-11,Brazil,203070494,Paraná,11444380,0.4633,15644,5301894,0.1263,4064,1445522,0.0000,0,13
2021-07-12,Brazil,203070494,Paraná,11444380,0.4696,72959,5374853,0.1304,47305,1492827,0.0000,2,15
2021-07-13,Brazil,203070494,Paraná,11444380,0.4754,66074,5440927,0.1326,24873,1517700,0.0000,0,15
2021-07-14,Brazil,203070494,Paraná,11444380,0.4792,43215,5484142,0.1341,17040,1534740,0.0000,0,15
2021-07-15,Brazil,203070494,Paraná,11444380,0.4813,24474,5508616,0.1366,28189,1562929,0.0000,1,16
2021-07-16,Brazil,203070494,Paraná,11444380,0.4844,35601,5544217,0.1394,32341,1595270,0.0000,0,16
2021-07-17,Brazil,203070494,Paraná,11444380,0.4885,46395,5590612,0.1400,6853,1602123,0.0000,0,16
2021-07-18,Brazil,203070494,Paraná,11444380,0.4907,25530,5616142,0.1402,2879,1605002,0.0000,0,16
2021-07-19,Brazil,203070494,Paraná,11444380,0.4971,72658,5688800,0.1448,51678,1656680,0.0000,1,17
2021-07-20,Brazil,203070494,Paraná,11444380,0.5020,55802,5744602,0.1487,45186,1701866,0.0000,0,17
2021-07-21,Brazil,203070494,Paraná,11444380,0.5054,39625,5784227,0.1525,43091,1744957,0.0000,0,17
2021-07-22,Brazil,203070494,Paraná,11444380,0.5112,66466,5850693,0.1552,31036,1775993,0.0000,0,17
2021-07-23,Brazil,203070494,Paraná,11444380,0.5205,105752,5956445,0.1575,26813,1802806,0.0000,1,18
2021-07-24,Brazil,203070494,Paraná,11444380,0.5242,42999,5999444,0.1585,11564,1814370,0.0000,0,18
2021-07-25,Brazil,203070494,Paraná,11444380,0.5247,5741,6005185,0.1588,3454,1817824,0.0000,0,18
2021-07-26,Brazil,203070494,Paraná,11444380,0.5285,43156,6048341,0.1649,68909,1886733,0.0000,0,18
2021-07-27,Brazil,203070494,Paraná,11444380,0.5311,29964,6078305,0.1706,65584,1952317,0.0000,0,18
2021-07-28,Brazil,203070494,Paraná,11444380,0.5329,20252,6098557,0.1749,49014,2001331,0.0000,0,18
2021-07-29,Brazil,203070494,Paraná,11444380,0.5349,22521,6121078,0.1778,32947,2034278,0.0000,0,18
2021-07-30,Brazil,203070494,Paraná,11444380,0.5397,55793,6176871,0.1806,32024,2066302,0.0000,0,18
2021-07-31,Brazil,203070494,Paraná,11444380,0.5418,23847,6200718,0.1811,6292,2072594,0.0000,0,18
2021-08-01,Brazil,203070494,Paraná,11444380,0.5420,1955,6202673,0.1811,452,2073046,0.0000,0,18
2021-08-02,Brazil,203070494,Paraná,11444380,0.5484,73873,6276546,0.1845,38342,2111388,0.0000,0,18
2021-08-03,Brazil,203070494,Paraná,11444380,0.5583,112595,6389141,0.1882,42457,2153845,0.0000,1,19
2021-08-04,Brazil,203070494,Paraná,11444380,0.5647,73055,6462196,0.1913,34976,2188821,0.0000,0,19
2021-08-05,Brazil,203070494,Paraná,11444380,0.5693,52701,6514897,0.1941,32931,2221752,0.0000,0,19
2021-08-06,Brazil,203070494,Paraná,11444380,0.5735,48136,6563033,0.1974,37626,2259378,0.0000,0,19
2021-08-07,Brazil,203070494,Paraná,11444380,0.5792,65654,6628687,0.1982,8772,2268150,0.0000,0,19
2021-08-08,Brazil,203070494,Paraná,11444380,0.5793,585,6629272,0.1982,322,2268472,0.0000,0,19
2021-08-09,Brazil,203070494,Paraná,11444380,0.5864,81263,6710535,0.2017,40260,2308732,0.0000,0,19
2021-08-10,Brazil,203070494,Paraná,11444380,0.5957,107309,6817844,0.2053,40712,2349444,0.0000,2,21
2021-08-11,Brazil,203070494,Paraná,11444380,0.6041,95610,6913454,0.2080,31405,2380849,0.0000,0,21
2021-08-12,Brazil,203070494,Paraná,11444380,0.6114,84050,6997504,0.2121,46921,2427770,0.0000,0,21
2021-08-13,Brazil,203070494,Paraná,11444380,0.6159,51461,7048965,0.2169,54830,2482600,0.0000,0,21
2021-08-14,Brazil,203070494,Paraná,11444380,0.6222,71665,7120630,0.2179,11685,2494285,0.0000,1,22
2021-08-15,Brazil,203070494,Paraná,11444380,0.6224,2596,7123226,0.2180,257,2494542,0.0000,0,22
2021-08-16,Brazil,203070494,Paraná,11444380,0.6270,52612,7175838,0.2223,50029,2544571,0.0000,1,23
2021-08-17,Brazil,203070494,Paraná,11444380,0.6336,75477,7251315,0.2268,51210,2595781,0.0000,1,24
2021-08-18,Brazil,203070494,Paraná,11444380,0.6437,115311,7366626,0.2294,29658,2625439,0.0000,0,24
2021-08-19,Brazil,203070494,Paraná,11444380,0.6486,55879,7422505,0.2336,47990,2673429,0.0000,0,24
2021-08-20,Brazil,203070494,Paraná,11444380,0.6519,37926,7460431,0.2382,53110,2726539,0.0000,0,24
2021-08-21,Brazil,203070494,Paraná,11444380,0.6580,70035,7530466,0.2395,13851,2740390,0.0000,1,25
2021-08-22,Brazil,203070494,Paraná,11444380,0.6589,10189,7540655,0.2399,4716,2745106,0.0000,0,25
2021-08-23,Brazil,203070494,Paraná,11444380,0.6649,69283,7609938,0.2444,52284,2797390,0.0000,0,25
2021-08-24,Brazil,203070494,Paraná,11444380,0.6720,80974,7690912,0.2507,71665,2869055,0.0000,0,25
2021-08-25,Brazil,203070494,Paraná,11444380,0.6775,63124,7754036,0.2564,65263,2934318,0.0000,0,25
2021-08-26,Brazil,203070494,Paraná,11444380,0.6808,37848,7791884,0.2614,57372,2991690,0.0000,0,25
2021-08-27,Brazil,203070494,Paraná,11444380,0.6854,52094,7843978,0.2665,58611,3050301,0.0000,0,25
2021-08-28,Brazil,203070494,Paraná,11444380,0.6876,25081,7869059,0.2688,26394,3076695,0.0000,0,25
2021-08-29,Brazil,203070494,Paraná,11444380,0.6882,7223,7876282,0.2692,3604,3080299,0.0000,1,26
2021-08-30,Brazil,203070494,Paraná,11444380,0.6931,55559,7931841,0.2773,93531,3173830,0.0000,0,26
2021-08-31,Brazil,203070494,Paraná,11444380,0.6954,26818,7958659,0.2852,90126,3263956,0.0000,0,26
2021-09-01,Brazil,203070494,Paraná,11444380,0.6967,15163,7973822,0.2923,81197,3345153,0.0000,0,26
2021-09-02,Brazil,203070494,Paraná,11444380,0.6984,19085,7992907,0.2990,76399,3421552,0.0000,0,26
2021-09-03,Brazil,203070494,Paraná,11444380,0.7009,28217,8021124,0.3060,79972,3501524,0.0000,0,26
2021-09-04,Brazil,203070494,Paraná,11444380,0.7036,31533,8052657,0.3080,23390,3524914,0.0000,0,26
2021-09-05,Brazil,203070494,Paraná,11444380,0.7036,28,8052685,0.3081,895,3525809,0.0000,0,26
2021-09-06,Brazil,203070494,Paraná,11444380,0.7040,4618,8057303,0.3109,31716,3557525,0.0000,0,26
2021-09-07,Brazil,203070494,Paraná,11444380,0.7041,329,8057632,0.3121,14688,3572213,0.0000,0,26
2021-09-08,Brazil,203070494,Paraná,11444380,0.7048,8585,8066217,0.3211,102833,3675046,0.0000,0,26
2021-09-09,Brazil,203070494,Paraná,11444380,0.7054,6181,8072398,0.3317,120701,3795747,0.0000,2,28
2021-09-10,Brazil,203070494,Paraná,11444380,0.7061,8305,8080703,0.3413,110187,3905934,0.0000,0,28
2021-09-11,Brazil,203070494,Paraná,11444380,0.7075,16491,8097194,0.3438,28540,3934474,0.0000,0,28
2021-09-12,Brazil,203070494,Paraná,11444380,0.7077,2335,8099529,0.3440,2918,3937392,0.0000,0,28
2021-09-13,Brazil,203070494,Paraná,11444380,0.7106,32429,8131958,0.3532,104259,4041651,0.0000,0,28
2021-09-14,Brazil,203070494,Paraná,11444380,0.7127,24797,8156755,0.3620,100643,4142294,0.0000,0,28
2021-09-15,Brazil,203070494,Paraná,11444380,0.7153,29760,8186515,0.3690,80335,4222629,0.0000,0,28
2021-09-16,Brazil,203070494,Paraná,11444380,0.7213,68648,8255163,0.3753,72242,4294871,0.0000,0,28
2021-09-17,Brazil,203070494,Paraná,11444380,0.7258,51173,8306336,0.3805,60144,4355015,0.0000,0,28
2021-09-18,Brazil,203070494,Paraná,11444380,0.7284,29985,8336321,0.3822,19278,4374293,0.0000,0,28
2021-09-19,Brazil,203070494,Paraná,11444380,0.7289,5152,8341473,0.3826,3832,4378125,0.0000,0,28
2021-09-20,Brazil,203070494,Paraná,11444380,0.7307,20583,8362056,0.3909,95807,4473932,0.0000,4,32
2021-09-21,Brazil,203070494,Paraná,11444380,0.7325,21424,8383480,0.3985,87147,4561079,0.0000,8,40
2021-09-22,Brazil,203070494,Paraná,11444380,0.7343,20404,8403884,0.4058,83532,4644611,0.0000,296,336
2021-09-23,Brazil,203070494,Paraná,11444380,0.7362,21274,8425158,0.4118,68453,4713064,0.0001,887,1223
2021-09-24,Brazil,203070494,Paraná,11444380,0.7374,14140,8439298,0.4189,80875,4793939,0.0001,90,1313
2021-09-25,Brazil,203070494,Paraná,11444380,0.7387,14939,8454237,0.4256,76784,4870723,0.0001,37,1350
2021-09-26,Brazil,203070494,Paraná,11444380,0.7388,892,8455129,0.4264,9027,4879750,0.0001,9,1359
2021-09-27,Brazil,203070494,Paraná,11444380,0.7400,14219,8469348,0.4331,77111,4956861,0.0001,184,1543
2021-09-28,Brazil,203070494,Paraná,11444380,0.7428,31754,8501102,0.4401,79810,5036671,0.0002,317,1860
2021-09-29,Brazil,203070494,Paraná,11444380,0.7449,23929,8525031,0.4481,91834,5128505,0.0002,250,2110
2021-09-30,Brazil,203070494,Paraná,11444380,0.7475,29297,8554328,0.4539,66498,5195003,0.0002,405,2515
2021-10-01,Brazil,203070494,Paraná,11444380,0.7496,24072,8578400,0.4592,60349,5255352,0.0002,156,2671
2021-10-02,Brazil,203070494,Paraná,11444380,0.7532,41771,8620171,0.4605,14567,5269919,0.0003,482,3153
2021-10-03,Brazil,203070494,Paraná,11444380,0.7533,1387,8621558,0.4609,5312,5275231,0.0003,1,3154
2021-10-04,Brazil,203070494,Paraná,11444380,0.7550,19517,8641075,0.4673,73101,5348332,0.0003,328,3482
2021-10-05,Brazil,203070494,Paraná,11444380,0.7570,21845,8662920,0.4738,74140,5422472,0.0003,474,3956
2021-10-06,Brazil,203070494,Paraná,11444380,0.7591,24253,8687173,0.4804,75340,5497812,0.0004,1192,5148
2021-10-07,Brazil,203070494,Paraná,11444380,0.7609,21202,8708375,0.4865,70380,5568192,0.0005,846,5994
2021-10-08,Brazil,203070494,Paraná,11444380,0.7628,21357,8729732,0.4926,69281,5637473,0.0006,485,6479
2021-10-09,Brazil,203070494,Paraná,11444380,0.7631,3080,8732812,0.4946,22517,5659990,0.0006,212,6691
2021-10-10,Brazil,203070494,Paraná,11444380,0.7631,428,8733240,0.4951,5780,5665770,0.0006,38,6729
2021-10-11,Brazil,203070494,Paraná,11444380,0.7634,3565,8736805,0.4973,25911,5691681,0.0006,149,6878
2021-10-12,Brazil,203070494,Paraná,11444380,0.7635,414,8737219,0.4978,5695,5697376,0.0006,47,6925
2021-10-13,Brazil,203070494,Paraná,11444380,0.7645,12145,8749364,0.5060,93531,5790907,0.0007,637,7562
2021-10-14,Brazil,203070494,Paraná,11444380,0.7656,12953,8762317,0.5131,81420,5872327,0.0008,1461,9023
2021-10-15,Brazil,203070494,Paraná,11444380,0.7665,10120,8772437,0.5211,91758,5964085,0.0009,1369,10392
2021-10-16,Brazil,203070494,Paraná,11444380,0.7677,13115,8785552,0.5269,66426,6030511,0.0009,148,10540
2021-10-17,Brazil,203070494,Paraná,11444380,0.7677,410,8785962,0.5272,2931,6033442,0.0009,0,10540
2021-10-18,Brazil,203070494,Paraná,11444380,0.7685,8828,8794790,0.5349,87650,6121092,0.0010,364,10904
2021-10-19,Brazil,203070494,Paraná,11444380,0.7697,13378,8808168,0.5423,85625,6206717,0.0010,635,11539
2021-10-20,Brazil,203070494,Paraná,11444380,0.7708,13559,8821727,0.5488,73821,6280538,0.0010,366,11905
2021-10-21,Brazil,203070494,Paraná,11444380,0.7734,29229,8850956,0.5541,60770,6341308,0.0011,464,12369
2021-10-22,Brazil,203070494,Paraná,11444380,0.7782,54801,8905757,0.5593,59354,6400662,0.0011,399,12768
2021-10-23,Brazil,203070494,Paraná,11444380,0.7800,21230,8926987,0.5618,28824,6429486,0.0011,245,13013
2021-10-24,Brazil,203070494,Paraná,11444380,0.7809,9559,8936546,0.5621,3340,6432826,0.0011,0,13013
2021-10-25,Brazil,203070494,Paraná,11444380,0.7838,34058,8970604,0.5674,60717,6493543,0.0012,673,13686
2021-10-26,Brazil,203070494,Paraná,11444380,0.7870,36159,9006763,0.5729,62671,6556214,0.0013,902,14588
2021-10-27,Brazil,203070494,Paraná,11444380,0.7895,28212,9034975,0.5779,57624,6613838,0.0013,689,15277
2021-10-28,Brazil,203070494,Paraná,11444380,0.7909,15993,9050968,0.5823,49718,6663556,0.0014,686,15963
2021-10-29,Brazil,203070494,Paraná,11444380,0.7916,8254,9059222,0.5863,46166,6709722,0.0014,203,16166
2021-10-30,Brazil,203070494,Paraná,11444380,0.7921,5917,9065139,0.5869,6420,6716142,0.0014,3,16169
2021-10-31,Brazil,203070494,Paraná,11444380,0.7921,434,9065573,0.5870,1808,6717950,0.0014,0,16169
2021-11-01,Brazil,203070494,Paraná,11444380,0.7923,1250,9066823,0.5875,5234,6723184,0.0014,0,16169
2021-11-02,Brazil,203070494,Paraná,11444380,0.7923,495,9067318,0.5877,2145,6725329,0.0014,0,16169
2021-11-03,Brazil,203070494,Paraná,11444380,0.7931,9406,9076724,0.5926,56518,6781847,0.0015,440,16609
2021-11-04,Brazil,203070494,Paraná,11444380,0.7945,15432,9092156,0.5972,52694,6834541,0.0015,317,16926
2021-11-05,Brazil,203070494,Paraná,11444380,0.7972,31405,9123561,0.6006,39010,6873551,0.0015,114,17040
2021-11-06,Brazil,203070494,Paraná,11444380,0.7983,12597,9136158,0.6017,12035,6885586,0.0016,1545,18585
2021-11-07,Brazil,203070494,Paraná,11444380,0.7986,3854,9140012,0.6019,2359,6887945,0.0016,0,18585
2021-11-08,Brazil,203070494,Paraná,11444380,0.8015,33035,9173047,0.6050,35588,6923533,0.0018,1733,20318
2021-11-09,Brazil,203070494,Paraná,11444380,0.8038,26318,9199365,0.6084,39040,6962573,0.0018,457,20775
2021-11-10,Brazil,203070494,Paraná,11444380,0.8052,15408,9214773,0.6124,45555,7008128,0.0019,1061,21836
2021-11-11,Brazil,203070494,Paraná,11444380,0.8064,14051,9228824,0.6167,49206,7057334,0.0020,517,22353
2021-11-12,Brazil,203070494,Paraná,11444380,0.8074,10861,9239685,0.6213,53365,7110699,0.0020,402,22755
2021-11-13,Brazil,203070494,Paraná,11444380,0.8079,6304,9245989,0.6220,7509,7118208,0.0020,12,22767
2021-11-14,Brazil,203070494,Paraná,11444380,0.8079,252,9246241,0.6220,332,7118540,0.0020,1,22768
2021-11-15,Brazil,203070494,Paraná,11444380,0.8080,352,9246593,0.6222,1631,7120171,0.0020,0,22768
2021-11-16,Brazil,203070494,Paraná,11444380,0.8088,9359,9255952,0.6266,50363,7170534,0.0020,259,23027
2021-11-17,Brazil,203070494,Paraná,11444380,0.8095,8245,9264197,0.6304,43710,7214244,0.0021,791,23818
2021-11-18,Brazil,203070494,Paraná,11444380,0.8103,9222,9273419,0.6339,40497,7254741,0.0021,358,24176
2021-11-19,Brazil,203070494,Paraná,11444380,0.8112,10307,9283726,0.6376,42591,7297332,0.0022,1365,25541
2021-11-20,Brazil,203070494,Paraná,11444380,0.8115,3891,9287617,0.6393,19500,7316832,0.0022,145,25686
2021-11-21,Brazil,203070494,Paraná,11444380,0.8116,285,9287902,0.6397,3915,7320747,0.0022,46,25732
2021-11-22,Brazil,203070494,Paraná,11444380,0.8123,7840,9295742,0.6432,40112,7360859,0.0023,494,26226
2021-11-23,Brazil,203070494,Paraná,11444380,0.8131,9997,9305739,0.6469,42620,7403479,0.0023,198,26424
2021-11-24,Brazil,203070494,Paraná,11444380,0.8144,14199,9319938,0.6498,33007,7436486,0.0023,211,26635
2021-11-25,Brazil,203070494,Paraná,11444380,0.8159,17463,9337401,0.6530,36735,7473221,0.0023,203,26838
2021-11-26,Brazil,203070494,Paraná,11444380,0.8172,14895,9352296,0.6559,32596,7505817,0.0025,1258,28096
2021-11-27,Brazil,203070494,Paraná,11444380,0.8179,8507,9360803,0.6583,28418,7534235,0.0025,5,28101
2021-11-28,Brazil,203070494,Paraná,11444380,0.8180,345,9361148,0.6584,664,7534899,0.0025,1,28102
2021-11-29,Brazil,203070494,Paraná,11444380,0.8191,13029,9374177,0.6615,35878,7570777,0.0025,653,28755
2021-11-30,Brazil,203070494,Paraná,11444380,0.8204,14451,9388628,0.6648,37617,7608394,0.0026,934,29689
2021-12-01,Brazil,203070494,Paraná,11444380,0.8213,11059,9399687,0.6677,32453,7640847,0.0027,1141,30830
2021-12-02,Brazil,203070494,Paraná,11444380,0.8221,8514,9408201,0.6702,29742,7670589,0.0028,908,31738
2021-12-03,Brazil,203070494,Paraná,11444380,0.8228,8101,9416302,0.6733,35094,7705683,0.0028,190,31928
2021-12-04,Brazil,203070494,Paraná,11444380,0.8229,1847,9418149,0.6739,6318,7712001,0.0028,1,31929
2021-12-05,Brazil,203070494,Paraná,11444380,0.8230,118,9418267,0.6739,701,7712702,0.0028,0,31929
2021-12-06,Brazil,203070494,Paraná,11444380,0.8237,8298,9426565,0.6761,25115,7737817,0.0028,253,32182
2021-12-07,Brazil,203070494,Paraná,11444380,0.8243,6940,9433505,0.6784,26517,7764334,0.0029,609,32791
2021-12-08,Brazil,203070494,Paraná,11444380,0.8248,5832,9439337,0.6803,21355,7785689,0.0029,648,33439
2021-12-09,Brazil,203070494,Paraná,11444380,0.8253,5163,9444500,0.6826,26492,7812181,0.0030,769,34208
2021-12-10,Brazil,203070494,Paraná,11444380,0.8256,4104,9448604,0.6848,25154,7837335,0.0031,1121,35329
2021-12-11,Brazil,203070494,Paraná,11444380,0.8257,877,9449481,0.6852,4141,7841476,0.0031,0,35329
2021-12-12,Brazil,203070494,Paraná,11444380,0.8257,137,9449618,0.6853,1048,7842524,0.0031,0,35329
2021-12-13,Brazil,203070494,Paraná,11444380,0.8261,4694,9454312,0.6872,22286,7864810,0.0032,1225,36554
2021-12-14,Brazil,203070494,Paraná,11444380,0.8265,3922,9458234,0.6894,24745,7889555,0.0032,215,36769
2021-12-15,Brazil,203070494,Paraná,11444380,0.8269,4853,9463087,0.6920,29959,7919514,0.0033,1537,38306
2021-12-16,Brazil,203070494,Paraná,11444380,0.8272,4155,9467242,0.6943,26125,7945639,0.0035,1710,40016
2021-12-17,Brazil,203070494,Paraná,11444380,0.8276,3815,9471057,0.6971,32741,7978380,0.0037,1812,41828
2021-12-18,Brazil,203070494,Paraná,11444380,0.8276,810,9471867,0.6979,8256,7986636,0.0037,234,42062
2021-12-19,Brazil,203070494,Paraná,11444380,0.8277,83,9471950,0.6980,1561,7988197,0.0037,0,42062
2021-12-20,Brazil,203070494,Paraná,11444380,0.8279,3120,9475070,0.7011,35098,8023295,0.0037,752,42814
2021-12-21,Brazil,203070494,Paraná,11444380,0.8282,2703,9477773,0.7038,31309,8054604,0.0039,2324,45138
2021-12-22,Brazil,203070494,Paraná,11444380,0.8284,2358,9480131,0.7060,24743,8079347,0.0041,1398,46536
2021-12-23,Brazil,203070494,Paraná,11444380,0.8285,1427,9481558,0.7074,16411,8095758,0.0041,694,47230
2021-12-24,Brazil,203070494,Paraná,11444380,0.8285,70,9481628,0.7074,532,8096290,0.0041,0,47230
2021-12-25,Brazil,203070494,Paraná,11444380,0.8285,5,9481633,0.7074,29,8096319,0.0041,0,47230
2021-12-26,Brazil,203070494,Paraná,11444380,0.8285,20,9481653,0.7075,127,8096446,0.0041,0,47230
2021-12-27,Brazil,203070494,Paraná,11444380,0.8286,1255,9482908,0.7084,10873,8107319,0.0043,1957,49187
2021-12-28,Brazil,203070494,Paraná,11444380,0.8287,1415,9484323,0.7094,11353,8118672,0.0045,2474,51661
2021-12-29,Brazil,203070494,Paraná,11444380,0.8288,1052,9485375,0.7101,7433,8126105,0.0046,839,52500
2021-12-30,Brazil,203070494,Paraná,11444380,0.8289,916,9486291,0.7106,5818,8131923,0.0048,2158,54658
2021-12-31,Brazil,203070494,Paraná,11444380,0.8289,11,9486302,0.7106,145,8132068,0.0048,0,54658
2021-01-01,Brazil,203070494,Paraíba,3974687,0.0000,0,0,0.0000,1,1,0.0000,0,0
2021-01-03,Brazil,203070494,Paraíba,3974687,0.0000,0,0,0.0000,4,5,0.0000,0,0
2021-01-04,Brazil,203070494,Paraíba,3974687,0.0000,0,0,0.0000,2,7,0.0000,0,0
2021-01-05,Brazil,203070494,Paraíba,3974687,0.0000,4,4,0.0000,3,10,0.0000,0,0
2021-01-06,Brazil,203070494,Paraíba,3974687,0.0000,1,5,0.0000,0,10,0.0000,0,0
2021-01-07,Brazil,203070494,Paraíba,3974687,0.0000,0,5,0.0000,1,11,0.0000,0,0
2021-01-08,Brazil,203070494,Paraíba,3974687,0.0000,0,5,0.0000,1,12,0.0000,0,0
2021-01-09,Brazil,203070494,Paraíba,3974687,0.0000,0,5,0.0000,1,13,0.0000,0,0
2021-01-10,Brazil,203070494,Paraíba,3974687,0.0000,0,5,0.0000,0,13,0.0000,0,0
2021-01-11,Brazil,203070494,Paraíba,3974687,0.0000,1,6,0.0000,1,14,0.0000,0,0
2021-01-12,Brazil,203070494,Paraíba,3974687,0.0000,0,6,0.0000,0,14,0.0000,0,0
2021-01-13,Brazil,203070494,Paraíba,3974687,0.0000,0,6,0.0000,1,15,0.0000,0,0
2021-01-14,Brazil,203070494,Paraíba,3974687,0.0000,0,6,0.0000,1,16,0.0000,0,0
2021-01-15,Brazil,203070494,Paraíba,3974687,0.0000,0,6,0.0000,1,17,0.0000,0,0
2021-01-16,Brazil,203070494,Paraíba,3974687,0.0000,1,7,0.0000,1,18,0.0000,0,0
2021-01-17,Brazil,203070494,Paraíba,3974687,0.0000,12,19,0.0000,2,20,0.0000,0,0
2021-01-18,Brazil,203070494,Paraíba,3974687,0.0000,32,51,0.0000,11,31,0.0000,0,0
2021-01-19,Brazil,203070494,Paraíba,3974687,0.0006,2474,2525,0.0000,19,50,0.0000,0,0
2021-01-20,Brazil,203070494,Paraíba,3974687,0.0036,11833,14358,0.0000,17,67,0.0000,0,0
2021-01-21,Brazil,203070494,Paraíba,3974687,0.0060,9557,23915,0.0000,20,87,0.0000,0,0
2021-01-22,Brazil,203070494,Paraíba,3974687,0.0069,3492,27407,0.0000,21,108,0.0000,0,0
2021-01-23,Brazil,203070494,Paraíba,3974687,0.0070,450,27857,0.0000,2,110,0.0000,0,0
2021-01-24,Brazil,203070494,Paraíba,3974687,0.0070,72,27929,0.0000,2,112,0.0000,0,0
2021-01-25,Brazil,203070494,Paraíba,3974687,0.0080,3839,31768,0.0000,7,119,0.0000,0,0
2021-01-26,Brazil,203070494,Paraíba,3974687,0.0097,6976,38744,0.0000,6,125,0.0000,0,0
2021-01-27,Brazil,203070494,Paraíba,3974687,0.0113,6109,44853,0.0000,11,136,0.0000,0,0
2021-01-28,Brazil,203070494,Paraíba,3974687,0.0138,10174,55027,0.0000,49,185,0.0000,0,0
2021-01-29,Brazil,203070494,Paraíba,3974687,0.0154,6078,61105,0.0000,5,190,0.0000,0,0
2021-01-30,Brazil,203070494,Paraíba,3974687,0.0155,436,61541,0.0000,6,196,0.0000,0,0
2021-01-31,Brazil,203070494,Paraíba,3974687,0.0155,21,61562,0.0001,5,201,0.0000,0,0
2021-02-01,Brazil,203070494,Paraíba,3974687,0.0169,5699,67261,0.0001,27,228,0.0000,0,0
2021-02-02,Brazil,203070494,Paraíba,3974687,0.0180,4441,71702,0.0001,50,278,0.0000,0,0
2021-02-03,Brazil,203070494,Paraíba,3974687,0.0188,3161,74863,0.0001,41,319,0.0000,0,0
2021-02-04,Brazil,203070494,Paraíba,3974687,0.0196,3125,77988,0.0001,14,333,0.0000,0,0
2021-02-05,Brazil,203070494,Paraíba,3974687,0.0202,2117,80105,0.0001,11,344,0.0000,0,0
2021-02-06,Brazil,203070494,Paraíba,3974687,0.0204,903,81008,0.0001,8,352,0.0000,0,0
2021-02-07,Brazil,203070494,Paraíba,3974687,0.0207,1100,82108,0.0001,11,363,0.0000,0,0
2021-02-08,Brazil,203070494,Paraíba,3974687,0.0211,1678,83786,0.0001,104,467,0.0000,0,0
2021-02-09,Brazil,203070494,Paraíba,3974687,0.0220,3687,87473,0.0004,1030,1497,0.0000,0,0
2021-02-10,Brazil,203070494,Paraíba,3974687,0.0236,6308,93781,0.0008,1517,3014,0.0000,0,0
2021-02-11,Brazil,203070494,Paraíba,3974687,0.0251,6175,99956,0.0012,1689,4703,0.0000,0,0
2021-02-12,Brazil,203070494,Paraíba,3974687,0.0265,5263,105219,0.0016,1795,6498,0.0000,0,0
2021-02-13,Brazil,203070494,Paraíba,3974687,0.0265,129,105348,0.0017,318,6816,0.0000,0,0
2021-02-14,Brazil,203070494,Paraíba,3974687,0.0265,107,105455,0.0018,147,6963,0.0000,0,0
2021-02-15,Brazil,203070494,Paraíba,3974687,0.0268,882,106337,0.0022,1963,8926,0.0000,0,0
2021-02-16,Brazil,203070494,Paraíba,3974687,0.0270,917,107254,0.0037,5657,14583,0.0000,0,0
2021-02-17,Brazil,203070494,Paraíba,3974687,0.0275,1991,109245,0.0057,8164,22747,0.0000,0,0
2021-02-18,Brazil,203070494,Paraíba,3974687,0.0280,2073,111318,0.0068,4196,26943,0.0000,0,0
2021-02-19,Brazil,203070494,Paraíba,3974687,0.0287,2557,113875,0.0074,2504,29447,0.0000,0,0
2021-02-20,Brazil,203070494,Paraíba,3974687,0.0288,567,114442,0.0074,71,29518,0.0000,0,0
2021-02-21,Brazil,203070494,Paraíba,3974687,0.0288,69,114511,0.0074,46,29564,0.0000,0,0
2021-02-22,Brazil,203070494,Paraíba,3974687,0.0292,1490,116001,0.0083,3581,33145,0.0000,0,0
2021-02-23,Brazil,203070494,Paraíba,3974687,0.0295,1262,117263,0.0092,3457,36602,0.0000,0,0
2021-02-24,Brazil,203070494,Paraíba,3974687,0.0299,1548,118811,0.0100,2989,39591,0.0000,0,0
2021-02-25,Brazil,203070494,Paraíba,3974687,0.0302,1176,119987,0.0106,2621,42212,0.0000,0,0
2021-02-26,Brazil,203070494,Paraíba,3974687,0.0305,1069,121056,0.0110,1591,43803,0.0000,0,0
2021-02-27,Brazil,203070494,Paraíba,3974687,0.0308,1428,122484,0.0113,938,44741,0.0000,0,0
2021-02-28,Brazil,203070494,Paraíba,3974687,0.0309,190,122674,0.0115,887,45628,0.0000,0,0
2021-03-01,Brazil,203070494,Paraíba,3974687,0.0322,5202,127876,0.0119,1687,47315,0.0000,0,0
2021-03-02,Brazil,203070494,Paraíba,3974687,0.0345,9189,137065,0.0124,2051,49366,0.0000,0,0
2021-03-03,Brazil,203070494,Paraíba,3974687,0.0372,10604,147669,0.0130,2393,51759,0.0000,0,0
2021-03-04,Brazil,203070494,Paraíba,3974687,0.0396,9669,157338,0.0137,2882,54641,0.0000,0,0
2021-03-05,Brazil,203070494,Paraíba,3974687,0.0424,11313,168651,0.0144,2462,57103,0.0000,0,0
2021-03-06,Brazil,203070494,Paraíba,3974687,0.0430,2107,170758,0.0144,111,57214,0.0000,0,0
2021-03-07,Brazil,203070494,Paraíba,3974687,0.0430,160,170918,0.0144,13,57227,0.0000,0,0
2021-03-08,Brazil,203070494,Paraíba,3974687,0.0457,10847,181765,0.0149,2158,59385,0.0000,0,0
2021-03-09,Brazil,203070494,Paraíba,3974687,0.0484,10743,192508,0.0156,2702,62087,0.0000,0,0
2021-03-10,Brazil,203070494,Paraíba,3974687,0.0518,13401,205909,0.0164,3039,65126,0.0000,0,0
2021-03-11,Brazil,203070494,Paraíba,3974687,0.0549,12421,218330,0.0171,2900,68026,0.0000,0,0
2021-03-12,Brazil,203070494,Paraíba,3974687,0.0579,11808,230138,0.0177,2213,70239,0.0000,0,0
2021-03-13,Brazil,203070494,Paraíba,3974687,0.0589,3784,233922,0.0178,353,70592,0.0000,0,0
2021-03-14,Brazil,203070494,Paraíba,3974687,0.0596,3129,237051,0.0178,77,70669,0.0000,0,0
2021-03-15,Brazil,203070494,Paraíba,3974687,0.0623,10588,247639,0.0181,1258,71927,0.0000,0,0
2021-03-16,Brazil,203070494,Paraíba,3974687,0.0646,8996,256635,0.0184,1160,73087,0.0000,0,0
2021-03-17,Brazil,203070494,Paraíba,3974687,0.0670,9852,266487,0.0189,1939,75026,0.0000,0,0
2021-03-18,Brazil,203070494,Paraíba,3974687,0.0686,6300,272787,0.0194,2019,77045,0.0000,0,0
2021-03-19,Brazil,203070494,Paraíba,3974687,0.0706,7971,280758,0.0200,2251,79296,0.0000,0,0
2021-03-20,Brazil,203070494,Paraíba,3974687,0.0721,5649,286407,0.0201,634,79930,0.0000,0,0
2021-03-21,Brazil,203070494,Paraíba,3974687,0.0733,4895,291302,0.0202,367,80297,0.0000,0,0
2021-03-22,Brazil,203070494,Paraíba,3974687,0.0788,21965,313267,0.0209,2725,83022,0.0000,0,0
2021-03-23,Brazil,203070494,Paraíba,3974687,0.0883,37800,351067,0.0216,2729,85751,0.0000,0,0
2021-03-24,Brazil,203070494,Paraíba,3974687,0.0949,25949,377016,0.0223,2841,88592,0.0000,0,0
2021-03-25,Brazil,203070494,Paraíba,3974687,0.1003,21447,398463,0.0230,2960,91552,0.0000,0,0
2021-03-26,Brazil,203070494,Paraíba,3974687,0.1043,16294,414757,0.0239,3612,95164,0.0000,0,0
2021-03-27,Brazil,203070494,Paraíba,3974687,0.1092,19449,434206,0.0241,645,95809,0.0000,0,0
2021-03-28,Brazil,203070494,Paraíba,3974687,0.1113,8237,442443,0.0242,204,96013,0.0000,0,0
2021-03-29,Brazil,203070494,Paraíba,3974687,0.1160,18811,461254,0.0253,4730,100743,0.0000,0,0
2021-03-30,Brazil,203070494,Paraíba,3974687,0.1203,16916,478170,0.0268,5962,106705,0.0000,0,0
2021-03-31,Brazil,203070494,Paraíba,3974687,0.1234,12108,490278,0.0279,4360,111065,0.0000,0,0
2021-04-01,Brazil,203070494,Paraíba,3974687,0.1241,2938,493216,0.0284,1896,112961,0.0000,0,0
2021-04-02,Brazil,203070494,Paraíba,3974687,0.1242,573,493789,0.0286,794,113755,0.0000,0,0
2021-04-03,Brazil,203070494,Paraíba,3974687,0.1287,17856,511645,0.0290,1492,115247,0.0000,0,0
2021-04-04,Brazil,203070494,Paraíba,3974687,0.1297,3851,515496,0.0291,545,115792,0.0000,0,0
2021-04-05,Brazil,203070494,Paraíba,3974687,0.1319,8577,524073,0.0311,7808,123600,0.0000,0,0
2021-04-06,Brazil,203070494,Paraíba,3974687,0.1356,15019,539092,0.0339,11130,134730,0.0000,0,0
2021-04-07,Brazil,203070494,Paraíba,3974687,0.1386,11635,550727,0.0372,13165,147895,0.0000,0,0
2021-04-08,Brazil,203070494,Paraíba,3974687,0.1412,10503,561230,0.0403,12122,160017,0.0000,0,0
2021-04-09,Brazil,203070494,Paraíba,3974687,0.1430,7233,568463,0.0427,9596,169613,0.0000,0,0
2021-04-10,Brazil,203070494,Paraíba,3974687,0.1447,6734,575197,0.0435,3259,172872,0.0000,0,0
2021-04-11,Brazil,203070494,Paraíba,3974687,0.1448,163,575360,0.0436,238,173110,0.0000,0,0
2021-04-12,Brazil,203070494,Paraíba,3974687,0.1469,8578,583938,0.0457,8338,181448,0.0000,0,0
2021-04-13,Brazil,203070494,Paraíba,3974687,0.1482,5232,589170,0.0485,11406,192854,0.0000,0,0
2021-04-14,Brazil,203070494,Paraíba,3974687,0.1492,4033,593203,0.0510,9856,202710,0.0000,0,0
2021-04-15,Brazil,203070494,Paraíba,3974687,0.1498,2127,595330,0.0526,6552,209262,0.0000,0,0
2021-04-16,Brazil,203070494,Paraíba,3974687,0.1503,1986,597316,0.0551,9563,218825,0.0000,0,0
2021-04-17,Brazil,203070494,Paraíba,3974687,0.1519,6276,603592,0.0560,3742,222567,0.0000,0,0
2021-04-18,Brazil,203070494,Paraíba,3974687,0.1520,491,604083,0.0562,879,223446,0.0000,0,0
2021-04-19,Brazil,203070494,Paraíba,3974687,0.1552,12697,616780,0.0593,12096,235542,0.0000,0,0
2021-04-20,Brazil,203070494,Paraíba,3974687,0.1579,10875,627655,0.0644,20354,255896,0.0000,0,0
2021-04-21,Brazil,203070494,Paraíba,3974687,0.1592,5021,632676,0.0661,6861,262757,0.0000,0,0
2021-04-22,Brazil,203070494,Paraíba,3974687,0.1608,6619,639295,0.0701,15958,278715,0.0000,0,0
2021-04-23,Brazil,203070494,Paraíba,3974687,0.1621,4949,644244,0.0729,11017,289732,0.0000,0,0
2021-04-24,Brazil,203070494,Paraíba,3974687,0.1630,3714,647958,0.0745,6184,295916,0.0000,0,0
2021-04-25,Brazil,203070494,Paraíba,3974687,0.1632,804,648762,0.0798,21192,317108,0.0000,0,0
2021-04-26,Brazil,203070494,Paraíba,3974687,0.1647,6046,654808,0.0836,15242,332350,0.0000,0,0
2021-04-27,Brazil,203070494,Paraíba,3974687,0.1663,6339,661147,0.0881,18003,350353,0.0000,0,0
2021-04-28,Brazil,203070494,Paraíba,3974687,0.1679,6243,667390,0.0902,8225,358578,0.0000,0,0
2021-04-29,Brazil,203070494,Paraíba,3974687,0.1688,3481,670871,0.0929,10591,369169,0.0000,0,0
2021-04-30,Brazil,203070494,Paraíba,3974687,0.1720,12687,683558,0.0943,5520,374689,0.0000,0,0
2021-05-01,Brazil,203070494,Paraíba,3974687,0.1736,6397,689955,0.0951,3111,377800,0.0000,0,0
2021-05-02,Brazil,203070494,Paraíba,3974687,0.1738,934,690889,0.0953,849,378649,0.0000,0,0
2021-05-03,Brazil,203070494,Paraíba,3974687,0.1768,11933,702822,0.0969,6413,385062,0.0000,0,0
2021-05-04,Brazil,203070494,Paraíba,3974687,0.1799,12246,715068,0.0985,6565,391627,0.0000,0,0
2021-05-05,Brazil,203070494,Paraíba,3974687,0.1840,16267,731335,0.1000,5812,397439,0.0000,0,0
2021-05-06,Brazil,203070494,Paraíba,3974687,0.1875,14102,745437,0.1008,3203,400642,0.0000,0,0
2021-05-07,Brazil,203070494,Paraíba,3974687,0.1910,13604,759041,0.1011,1023,401665,0.0000,0,0
2021-05-08,Brazil,203070494,Paraíba,3974687,0.1921,4677,763718,0.1011,88,401753,0.0000,0,0
2021-05-09,Brazil,203070494,Paraíba,3974687,0.1922,258,763976,0.1011,20,401773,0.0000,0,0
2021-05-10,Brazil,203070494,Paraíba,3974687,0.1946,9564,773540,0.1025,5478,407251,0.0000,0,0
2021-05-11,Brazil,203070494,Paraíba,3974687,0.1971,9841,783381,0.1037,4728,411979,0.0000,0,0
2021-05-12,Brazil,203070494,Paraíba,3974687,0.2003,12917,796298,0.1048,4560,416539,0.0000,0,0
2021-05-13,Brazil,203070494,Paraíba,3974687,0.2035,12460,808758,0.1054,2332,418871,0.0000,0,0
2021-05-14,Brazil,203070494,Paraíba,3974687,0.2059,9567,818325,0.1057,1093,419964,0.0000,0,0
2021-05-15,Brazil,203070494,Paraíba,3974687,0.2067,3066,821391,0.1058,368,420332,0.0000,0,0
2021-05-16,Brazil,203070494,Paraíba,3974687,0.2078,4414,825805,0.1058,25,420357,0.0000,0,0
2021-05-17,Brazil,203070494,Paraíba,3974687,0.2099,8300,834105,0.1060,771,421128,0.0000,0,0
2021-05-18,Brazil,203070494,Paraíba,3974687,0.2134,14145,848250,0.1062,855,421983,0.0000,0,0
2021-05-19,Brazil,203070494,Paraíba,3974687,0.2159,10028,858278,0.1091,11719,433702,0.0000,0,0
2021-05-20,Brazil,203070494,Paraíba,3974687,0.2182,8964,867242,0.1131,15994,449696,0.0000,0,0
2021-05-21,Brazil,203070494,Paraíba,3974687,0.2197,6014,873256,0.1152,8096,457792,0.0000,0,0
2021-05-22,Brazil,203070494,Paraíba,3974687,0.2203,2358,875614,0.1157,2236,460028,0.0000,0,0
2021-05-23,Brazil,203070494,Paraíba,3974687,0.2204,425,876039,0.1157,41,460069,0.0000,0,0
2021-05-24,Brazil,203070494,Paraíba,3974687,0.2218,5398,881437,0.1164,2699,462768,0.0000,0,0
2021-05-25,Brazil,203070494,Paraíba,3974687,0.2233,5961,887398,0.1174,3666,466434,0.0000,0,0
2021-05-26,Brazil,203070494,Paraíba,3974687,0.2249,6414,893812,0.1182,3354,469788,0.0000,0,0
2021-05-27,Brazil,203070494,Paraíba,3974687,0.2268,7579,901391,0.1188,2283,472071,0.0000,0,0
2021-05-28,Brazil,203070494,Paraíba,3974687,0.2302,13424,914815,0.1191,1221,473292,0.0000,0,0
2021-05-29,Brazil,203070494,Paraíba,3974687,0.2313,4407,919222,0.1191,94,473386,0.0000,0,0
2021-05-30,Brazil,203070494,Paraíba,3974687,0.2319,2360,921582,0.1193,664,474050,0.0000,0,0
2021-05-31,Brazil,203070494,Paraíba,3974687,0.2348,11505,933087,0.1199,2464,476514,0.0000,0,0
2021-06-01,Brazil,203070494,Paraíba,3974687,0.2385,14893,947980,0.1208,3572,480086,0.0000,0,0
2021-06-02,Brazil,203070494,Paraíba,3974687,0.2424,15610,963590,0.1221,5104,485190,0.0000,0,0
2021-06-03,Brazil,203070494,Paraíba,3974687,0.2465,16243,979833,0.1227,2354,487544,0.0000,0,0
2021-06-04,Brazil,203070494,Paraíba,3974687,0.2521,22006,1001839,0.1239,5051,492595,0.0000,0,0
2021-06-05,Brazil,203070494,Paraíba,3974687,0.2543,8822,1010661,0.1240,253,492848,0.0000,0,0
2021-06-06,Brazil,203070494,Paraíba,3974687,0.2544,611,1011272,0.1240,30,492878,0.0000,0,0
2021-06-07,Brazil,203070494,Paraíba,3974687,0.2600,22172,1033444,0.1250,4025,496903,0.0000,0,0
2021-06-08,Brazil,203070494,Paraíba,3974687,0.2649,19297,1052741,0.1260,3766,500669,0.0000,0,0
2021-06-09,Brazil,203070494,Paraíba,3974687,0.2713,25616,1078357,0.1266,2528,503197,0.0000,0,0
2021-06-10,Brazil,203070494,Paraíba,3974687,0.2788,29815,1108172,0.1271,2089,505286,0.0000,0,0
2021-06-11,Brazil,203070494,Paraíba,3974687,0.2857,27443,1135615,0.1275,1365,506651,0.0000,0,0
2021-06-12,Brazil,203070494,Paraíba,3974687,0.2870,5239,1140854,0.1275,148,506799,0.0000,0,0
2021-06-13,Brazil,203070494,Paraíba,3974687,0.2874,1517,1142371,0.1275,48,506847,0.0000,0,0
2021-06-14,Brazil,203070494,Paraíba,3974687,0.2918,17524,1159895,0.1278,1275,508122,0.0000,0,0
2021-06-15,Brazil,203070494,Paraíba,3974687,0.2961,17150,1177045,0.1281,1204,509326,0.0000,0,0
2021-06-16,Brazil,203070494,Paraíba,3974687,0.3003,16620,1193665,0.1284,1088,510414,0.0000,0,0
2021-06-17,Brazil,203070494,Paraíba,3974687,0.3036,13145,1206810,0.1286,905,511319,0.0000,0,0
2021-06-18,Brazil,203070494,Paraíba,3974687,0.3063,10629,1217439,0.1288,650,511969,0.0000,0,0
2021-06-19,Brazil,203070494,Paraíba,3974687,0.3088,9832,1227271,0.1289,411,512380,0.0000,0,0
2021-06-20,Brazil,203070494,Paraíba,3974687,0.3098,3994,1231265,0.1293,1468,513848,0.0000,0,0
2021-06-21,Brazil,203070494,Paraíba,3974687,0.3138,15838,1247103,0.1304,4284,518132,0.0000,0,0
2021-06-22,Brazil,203070494,Paraíba,3974687,0.3181,17417,1264520,0.1313,3696,521828,0.0000,0,0
2021-06-23,Brazil,203070494,Paraíba,3974687,0.3206,9603,1274123,0.1318,1853,523681,0.0000,0,0
2021-06-24,Brazil,203070494,Paraíba,3974687,0.3213,2892,1277015,0.1321,1441,525122,0.0000,0,0
2021-06-25,Brazil,203070494,Paraíba,3974687,0.3275,24532,1301547,0.1324,1161,526283,0.0000,0,0
2021-06-26,Brazil,203070494,Paraíba,3974687,0.3316,16316,1317863,0.1328,1529,527812,0.0000,0,0
2021-06-27,Brazil,203070494,Paraíba,3974687,0.3319,1382,1319245,0.1331,1035,528847,0.0000,0,0
2021-06-28,Brazil,203070494,Paraíba,3974687,0.3369,19831,1339076,0.1337,2544,531391,0.0000,0,0
2021-06-29,Brazil,203070494,Paraíba,3974687,0.3409,15749,1354825,0.1342,2201,533592,0.0000,0,0
2021-06-30,Brazil,203070494,Paraíba,3974687,0.3457,19257,1374082,0.1345,977,534569,0.0000,0,0
2021-07-01,Brazil,203070494,Paraíba,3974687,0.3503,18220,1392302,0.1347,664,535233,0.0000,0,0
2021-07-02,Brazil,203070494,Paraíba,3974687,0.3564,24079,1416381,0.1350,1169,536402,0.0000,0,0
2021-07-03,Brazil,203070494,Paraíba,3974687,0.3590,10589,1426970,0.1351,635,537037,0.0000,0,0
2021-07-04,Brazil,203070494,Paraíba,3974687,0.3601,4388,1431358,0.1351,116,537153,0.0000,0,0
2021-07-05,Brazil,203070494,Paraíba,3974687,0.3681,31886,1463244,0.1355,1377,538530,0.0000,0,0
2021-07-06,Brazil,203070494,Paraíba,3974687,0.3747,26269,1489513,0.1358,1376,539906,0.0000,0,0
2021-07-07,Brazil,203070494,Paraíba,3974687,0.3791,17172,1506685,0.1363,1930,541836,0.0000,0,0
2021-07-08,Brazil,203070494,Paraíba,3974687,0.3826,14074,1520759,0.1368,2013,543849,0.0000,0,0
2021-07-09,Brazil,203070494,Paraíba,3974687,0.3860,13344,1534103,0.1372,1425,545274,0.0000,0,0
2021-07-10,Brazil,203070494,Paraíba,3974687,0.3873,5406,1539509,0.1375,1280,546554,0.0000,0,0
2021-07-11,Brazil,203070494,Paraíba,3974687,0.3874,269,1539778,0.1376,287,546841,0.0000,0,0
2021-07-12,Brazil,203070494,Paraíba,3974687,0.3902,11039,1550817,0.1390,5788,552629,0.0000,0,0
2021-07-13,Brazil,203070494,Paraíba,3974687,0.3930,11080,1561897,0.1405,5634,558263,0.0000,0,0
2021-07-14,Brazil,203070494,Paraíba,3974687,0.3945,6257,1568154,0.1417,4757,563020,0.0000,0,0
2021-07-15,Brazil,203070494,Paraíba,3974687,0.3958,5060,1573214,0.1431,5581,568601,0.0000,0,0
2021-07-16,Brazil,203070494,Paraíba,3974687,0.4013,22001,1595215,0.1443,5066,573667,0.0000,0,0
2021-07-17,Brazil,203070494,Paraíba,3974687,0.4115,40439,1635654,0.1449,2213,575880,0.0000,0,0
2021-07-18,Brazil,203070494,Paraíba,3974687,0.4140,9807,1645461,0.1450,588,576468,0.0000,0,0
2021-07-19,Brazil,203070494,Paraíba,3974687,0.4246,41999,1687460,0.1474,9483,585951,0.0000,0,0
2021-07-20,Brazil,203070494,Paraíba,3974687,0.4328,32782,1720242,0.1497,9126,595077,0.0000,0,0
2021-07-21,Brazil,203070494,Paraíba,3974687,0.4403,30001,1750243,0.1514,6573,601650,0.0000,0,0
2021-07-22,Brazil,203070494,Paraíba,3974687,0.4468,25631,1775874,0.1531,6716,608366,0.0000,0,0
2021-07-23,Brazil,203070494,Paraíba,3974687,0.4505,14903,1790777,0.1549,7265,615631,0.0000,0,0
2021-07-24,Brazil,203070494,Paraíba,3974687,0.4515,3696,1794473,0.1559,3824,619455,0.0000,0,0
2021-07-25,Brazil,203070494,Paraíba,3974687,0.4516,461,1794934,0.1559,62,619517,0.0000,0,0
2021-07-26,Brazil,203070494,Paraíba,3974687,0.4540,9436,1804370,0.1581,8865,628382,0.0000,0,0
2021-07-27,Brazil,203070494,Paraíba,3974687,0.4563,9171,1813541,0.1605,9670,638052,0.0000,0,0
2021-07-28,Brazil,203070494,Paraíba,3974687,0.4610,18904,1832445,0.1629,9456,647508,0.0000,0,0
2021-07-29,Brazil,203070494,Paraíba,3974687,0.4654,17488,1849933,0.1659,12000,659508,0.0000,0,0
2021-07-30,Brazil,203070494,Paraíba,3974687,0.4690,14239,1864172,0.1687,10885,670393,0.0000,0,0
2021-07-31,Brazil,203070494,Paraíba,3974687,0.4696,2346,1866518,0.1696,3780,674173,0.0000,0,0
2021-08-01,Brazil,203070494,Paraíba,3974687,0.4756,23818,1890336,0.1697,486,674659,0.0000,0,0
2021-08-02,Brazil,203070494,Paraíba,3974687,0.4813,22734,1913070,0.1729,12463,687122,0.0000,0,0
2021-08-03,Brazil,203070494,Paraíba,3974687,0.4889,30061,1943131,0.1767,15034,702156,0.0000,0,0
2021-08-04,Brazil,203070494,Paraíba,3974687,0.4932,17236,1960367,0.1811,17665,719821,0.0000,0,0
2021-08-05,Brazil,203070494,Paraíba,3974687,0.4951,7346,1967713,0.1828,6693,726514,0.0000,0,0
2021-08-06,Brazil,203070494,Paraíba,3974687,0.5033,32927,2000640,0.1854,10256,736770,0.0000,0,0
2021-08-07,Brazil,203070494,Paraíba,3974687,0.5056,8984,2009624,0.1866,4959,741729,0.0000,0,0
2021-08-08,Brazil,203070494,Paraíba,3974687,0.5090,13495,2023119,0.1868,884,742613,0.0000,0,0
2021-08-09,Brazil,203070494,Paraíba,3974687,0.5148,23175,2046294,0.1898,11866,754479,0.0000,0,0
2021-08-10,Brazil,203070494,Paraíba,3974687,0.5258,43626,2089920,0.1933,13916,768395,0.0000,0,0
2021-08-11,Brazil,203070494,Paraíba,3974687,0.5312,21514,2111434,0.1970,14439,782834,0.0000,0,0
2021-08-12,Brazil,203070494,Paraíba,3974687,0.5390,30959,2142393,0.1998,11205,794039,0.0000,0,0
2021-08-13,Brazil,203070494,Paraíba,3974687,0.5454,25490,2167883,0.2019,8295,802334,0.0000,0,0
2021-08-14,Brazil,203070494,Paraíba,3974687,0.5494,15966,2183849,0.2034,5939,808273,0.0000,0,0
2021-08-15,Brazil,203070494,Paraíba,3974687,0.5507,5183,2189032,0.2035,439,808712,0.0000,0,0
2021-08-16,Brazil,203070494,Paraíba,3974687,0.5665,62754,2251786,0.2061,10413,819125,0.0000,0,0
2021-08-17,Brazil,203070494,Paraíba,3974687,0.5756,36174,2287960,0.2090,11507,830632,0.0000,0,0
2021-08-18,Brazil,203070494,Paraíba,3974687,0.5834,31001,2318961,0.2126,14409,845041,0.0000,0,0
2021-08-19,Brazil,203070494,Paraíba,3974687,0.5881,18465,2337426,0.2152,10367,855408,0.0000,0,0
2021-08-20,Brazil,203070494,Paraíba,3974687,0.5926,18075,2355501,0.2174,8651,864059,0.0000,0,0
2021-08-21,Brazil,203070494,Paraíba,3974687,0.6010,33285,2388786,0.2178,1672,865731,0.0000,0,0
2021-08-22,Brazil,203070494,Paraíba,3974687,0.6015,2009,2390795,0.2178,130,865861,0.0000,0,0
2021-08-23,Brazil,203070494,Paraíba,3974687,0.6093,31062,2421857,0.2206,10787,876648,0.0000,0,0
2021-08-24,Brazil,203070494,Paraíba,3974687,0.6179,34042,2455899,0.2241,13966,890614,0.0000,0,0
2021-08-25,Brazil,203070494,Paraíba,3974687,0.6236,22574,2478473,0.2288,18902,909516,0.0000,0,0
2021-08-26,Brazil,203070494,Paraíba,3974687,0.6274,15438,2493911,0.2333,17831,927347,0.0000,0,0
2021-08-27,Brazil,203070494,Paraíba,3974687,0.6343,27426,2521337,0.2366,13134,940481,0.0000,0,0
2021-08-28,Brazil,203070494,Paraíba,3974687,0.6352,3373,2524710,0.2381,6015,946496,0.0000,0,0
2021-08-29,Brazil,203070494,Paraíba,3974687,0.6353,330,2525040,0.2382,183,946679,0.0000,0,0
2021-08-30,Brazil,203070494,Paraíba,3974687,0.6379,10522,2535562,0.2431,19463,966142,0.0000,0,0
2021-08-31,Brazil,203070494,Paraíba,3974687,0.6400,8050,2543612,0.2479,19180,985322,0.0000,0,0
2021-09-01,Brazil,203070494,Paraíba,3974687,0.6419,7638,2551250,0.2546,26832,1012154,0.0000,0,0
2021-09-02,Brazil,203070494,Paraíba,3974687,0.6440,8643,2559893,0.2619,28641,1040795,0.0000,0,0
2021-09-03,Brazil,203070494,Paraíba,3974687,0.6506,26167,2586060,0.2675,22274,1063069,0.0000,0,0
2021-09-04,Brazil,203070494,Paraíba,3974687,0.6512,2191,2588251,0.2694,7631,1070700,0.0000,0,0
2021-09-05,Brazil,203070494,Paraíba,3974687,0.6512,74,2588325,0.2694,106,1070806,0.0000,0,0
2021-09-06,Brazil,203070494,Paraíba,3974687,0.6520,3039,2591364,0.2718,9382,1080188,0.0000,0,0
2021-09-07,Brazil,203070494,Paraíba,3974687,0.6520,199,2591563,0.2723,2304,1082492,0.0000,0,0
2021-09-08,Brazil,203070494,Paraíba,3974687,0.6532,4898,2596461,0.2813,35569,1118061,0.0000,0,0
2021-09-09,Brazil,203070494,Paraíba,3974687,0.6575,17015,2613476,0.2907,37499,1155560,0.0000,0,0
2021-09-10,Brazil,203070494,Paraíba,3974687,0.6601,10069,2623545,0.2973,26100,1181660,0.0000,0,0
2021-09-11,Brazil,203070494,Paraíba,3974687,0.6614,5356,2628901,0.2986,5035,1186695,0.0000,0,0
2021-09-12,Brazil,203070494,Paraíba,3974687,0.6614,142,2629043,0.2986,190,1186885,0.0000,0,0
2021-09-13,Brazil,203070494,Paraíba,3974687,0.6636,8601,2637644,0.3051,25709,1212594,0.0000,0,0
2021-09-14,Brazil,203070494,Paraíba,3974687,0.6668,12716,2650360,0.3112,24292,1236886,0.0000,1,1
2021-09-15,Brazil,203070494,Paraíba,3974687,0.6705,14716,2665076,0.3162,19936,1256822,0.0000,0,1
2021-09-16,Brazil,203070494,Paraíba,3974687,0.6734,11667,2676743,0.3214,20769,1277591,0.0000,0,1
2021-09-17,Brazil,203070494,Paraíba,3974687,0.6753,7304,2684047,0.3256,16477,1294068,0.0000,0,1
2021-09-18,Brazil,203070494,Paraíba,3974687,0.6758,2069,2686116,0.3272,6397,1300465,0.0000,0,1
2021-09-19,Brazil,203070494,Paraíba,3974687,0.6758,33,2686149,0.3273,461,1300926,0.0000,0,1
2021-09-20,Brazil,203070494,Paraíba,3974687,0.6773,5908,2692057,0.3326,21067,1321993,0.0000,0,1
2021-09-21,Brazil,203070494,Paraíba,3974687,0.6805,12670,2704727,0.3384,22894,1344887,0.0000,0,1
2021-09-22,Brazil,203070494,Paraíba,3974687,0.6839,13702,2718429,0.3437,21187,1366074,0.0000,0,1
2021-09-23,Brazil,203070494,Paraíba,3974687,0.6865,10009,2728438,0.3489,20504,1386578,0.0000,0,1
2021-09-24,Brazil,203070494,Paraíba,3974687,0.6887,8827,2737265,0.3524,13969,1400547,0.0000,0,1
2021-09-25,Brazil,203070494,Paraíba,3974687,0.6937,19860,2757125,0.3618,37685,1438232,0.0000,0,1
2021-09-26,Brazil,203070494,Paraíba,3974687,0.6938,511,2757636,0.3619,153,1438385,0.0000,0,1
2021-09-27,Brazil,203070494,Paraíba,3974687,0.6982,17566,2775202,0.3656,14648,1453033,0.0000,0,1
2021-09-28,Brazil,203070494,Paraíba,3974687,0.7026,17408,2792610,0.3702,18462,1471495,0.0000,0,1
2021-09-29,Brazil,203070494,Paraíba,3974687,0.7067,16361,2808971,0.3746,17563,1489058,0.0000,0,1
2021-09-30,Brazil,203070494,Paraíba,3974687,0.7097,12045,2821016,0.3796,19759,1508817,0.0000,0,1
2021-10-01,Brazil,203070494,Paraíba,3974687,0.7116,7215,2828231,0.3841,18020,1526837,0.0000,0,1
2021-10-02,Brazil,203070494,Paraíba,3974687,0.7124,3235,2831466,0.3857,6279,1533116,0.0000,0,1
2021-10-03,Brazil,203070494,Paraíba,3974687,0.7124,31,2831497,0.3857,66,1533182,0.0000,0,1
2021-10-04,Brazil,203070494,Paraíba,3974687,0.7144,8169,2839666,0.3899,16533,1549715,0.0000,0,1
2021-10-05,Brazil,203070494,Paraíba,3974687,0.7164,7860,2847526,0.3950,20414,1570129,0.0000,0,1
2021-10-06,Brazil,203070494,Paraíba,3974687,0.7182,7258,2854784,0.3995,17875,1588004,0.0000,0,1
2021-10-07,Brazil,203070494,Paraíba,3974687,0.7207,9900,2864684,0.4046,20044,1608048,0.0000,0,1
2021-10-08,Brazil,203070494,Paraíba,3974687,0.7228,8154,2872838,0.4079,13264,1621312,0.0000,0,1
2021-10-09,Brazil,203070494,Paraíba,3974687,0.7233,2100,2874938,0.4091,4572,1625884,0.0000,0,1
2021-10-10,Brazil,203070494,Paraíba,3974687,0.7233,140,2875078,0.4091,208,1626092,0.0000,0,1
2021-10-11,Brazil,203070494,Paraíba,3974687,0.7236,1088,2876166,0.4098,2911,1629003,0.0000,0,1
2021-10-12,Brazil,203070494,Paraíba,3974687,0.7236,72,2876238,0.4100,465,1629468,0.0000,0,1
2021-10-13,Brazil,203070494,Paraíba,3974687,0.7247,4304,2880542,0.4142,16780,1646248,0.0000,0,1
2021-10-14,Brazil,203070494,Paraíba,3974687,0.7258,4395,2884937,0.4272,51788,1698036,0.0000,0,1
2021-10-15,Brazil,203070494,Paraíba,3974687,0.7268,3829,2888766,0.4358,34294,1732330,0.0000,0,1
2021-10-16,Brazil,203070494,Paraíba,3974687,0.7270,1014,2889780,0.4382,9289,1741619,0.0000,0,1
2021-10-17,Brazil,203070494,Paraíba,3974687,0.7271,23,2889803,0.4382,152,1741771,0.0000,0,1
2021-10-18,Brazil,203070494,Paraíba,3974687,0.7279,3285,2893088,0.4468,34044,1775815,0.0000,0,1
2021-10-19,Brazil,203070494,Paraíba,3974687,0.7288,3490,2896578,0.4549,32276,1808091,0.0000,0,1
2021-10-20,Brazil,203070494,Paraíba,3974687,0.7313,10162,2906740,0.4623,29477,1837568,0.0000,0,1
2021-10-21,Brazil,203070494,Paraíba,3974687,0.7366,21036,2927776,0.4677,21485,1859053,0.0000,0,1
2021-10-22,Brazil,203070494,Paraíba,3974687,0.7407,16388,2944164,0.4715,15173,1874226,0.0000,0,1
2021-10-23,Brazil,203070494,Paraíba,3974687,0.7419,4731,2948895,0.4738,8808,1883034,0.0000,0,1
2021-10-24,Brazil,203070494,Paraíba,3974687,0.7420,201,2949096,0.4738,290,1883324,0.0000,0,1
2021-10-25,Brazil,203070494,Paraíba,3974687,0.7440,8015,2957111,0.4793,21608,1904932,0.0000,1,2
2021-10-26,Brazil,203070494,Paraíba,3974687,0.7460,8140,2965251,0.4853,24063,1928995,0.0000,1,3
2021-10-27,Brazil,203070494,Paraíba,3974687,0.7477,6485,2971736,0.4900,18446,1947441,0.0000,0,3
2021-10-28,Brazil,203070494,Paraíba,3974687,0.7487,4238,2975974,0.4947,18644,1966085,0.0000,0,3
2021-10-29,Brazil,203070494,Paraíba,3974687,0.7495,3118,2979092,0.4989,16991,1983076,0.0000,0,3
2021-10-30,Brazil,203070494,Paraíba,3974687,0.7496,409,2979501,0.4995,2410,1985486,0.0000,1,4
2021-10-31,Brazil,203070494,Paraíba,3974687,0.7496,19,2979520,0.4995,11,1985497,0.0000,0,4
2021-11-01,Brazil,203070494,Paraíba,3974687,0.7498,503,2980023,0.4998,903,1986400,0.0000,0,4
2021-11-02,Brazil,203070494,Paraíba,3974687,0.7498,18,2980041,0.4998,68,1986468,0.0000,0,4
2021-11-03,Brazil,203070494,Paraíba,3974687,0.7505,2814,2982855,0.5053,21894,2008362,0.0000,1,5
2021-11-04,Brazil,203070494,Paraíba,3974687,0.7512,2971,2985826,0.5126,29238,2037600,0.0000,0,5
2021-11-05,Brazil,203070494,Paraíba,3974687,0.7523,4406,2990232,0.5176,19790,2057390,0.0000,1,6
2021-11-06,Brazil,203070494,Paraíba,3974687,0.7529,2393,2992625,0.5195,7534,2064924,0.0000,0,6
2021-11-07,Brazil,203070494,Paraíba,3974687,0.7529,6,2992631,0.5195,36,2064960,0.0000,0,6
2021-11-08,Brazil,203070494,Paraíba,3974687,0.7549,7815,3000446,0.5251,21992,2086952,0.0000,0,6
2021-11-09,Brazil,203070494,Paraíba,3974687,0.7570,8514,3008960,0.5317,26449,2113401,0.0000,0,6
2021-11-10,Brazil,203070494,Paraíba,3974687,0.7585,5689,3014649,0.5384,26724,2140125,0.0000,0,6
2021-11-11,Brazil,203070494,Paraíba,3974687,0.7599,5856,3020505,0.5458,29238,2169363,0.0000,0,6
2021-11-12,Brazil,203070494,Paraíba,3974687,0.7610,4039,3024544,0.5506,18949,2188312,0.0000,0,6
2021-11-13,Brazil,203070494,Paraíba,3974687,0.7614,1788,3026332,0.5528,9039,2197351,0.0000,0,6
2021-11-14,Brazil,203070494,Paraíba,3974687,0.7614,16,3026348,0.5528,33,2197384,0.0000,0,6
2021-11-15,Brazil,203070494,Paraíba,3974687,0.7614,34,3026382,0.5529,388,2197772,0.0000,0,6
2021-11-16,Brazil,203070494,Paraíba,3974687,0.7622,3156,3029538,0.5590,23932,2221704,0.0000,0,6
2021-11-17,Brazil,203070494,Paraíba,3974687,0.7631,3513,3033051,0.5649,23676,2245380,0.0000,0,6
2021-11-18,Brazil,203070494,Paraíba,3974687,0.7638,2931,3035982,0.5730,32297,2277677,0.0000,0,6
2021-11-19,Brazil,203070494,Paraíba,3974687,0.7645,2798,3038780,0.5783,20825,2298502,0.0000,0,6
2021-11-20,Brazil,203070494,Paraíba,3974687,0.7695,19741,3058521,0.5915,52409,2350911,0.0000,1,7
2021-11-21,Brazil,203070494,Paraíba,3974687,0.7695,122,3058643,0.5915,116,2351027,0.0000,0,7
2021-11-22,Brazil,203070494,Paraíba,3974687,0.7703,3064,3061707,0.5956,16316,2367343,0.0000,1,8
2021-11-23,Brazil,203070494,Paraíba,3974687,0.7713,4033,3065740,0.6018,24689,2392032,0.0000,0,8
2021-11-24,Brazil,203070494,Paraíba,3974687,0.7722,3456,3069196,0.6088,27749,2419781,0.0000,0,8
2021-11-25,Brazil,203070494,Paraíba,3974687,0.7730,3220,3072416,0.6148,23778,2443559,0.0000,1,9
2021-11-26,Brazil,203070494,Paraíba,3974687,0.7738,3382,3075798,0.6184,14490,2458049,0.0000,0,9
2021-11-27,Brazil,203070494,Paraíba,3974687,0.7743,1914,3077712,0.6202,6929,2464978,0.0000,0,9
2021-11-28,Brazil,203070494,Paraíba,3974687,0.7743,18,3077730,0.6204,760,2465738,0.0000,0,9
2021-11-29,Brazil,203070494,Paraíba,3974687,0.7750,2481,3080211,0.6241,14837,2480575,0.0000,1,10
2021-11-30,Brazil,203070494,Paraíba,3974687,0.7757,2907,3083118,0.6288,18669,2499244,0.0000,0,10
2021-12-01,Brazil,203070494,Paraíba,3974687,0.7763,2611,3085729,0.6326,14966,2514210,0.0000,0,10
2021-12-02,Brazil,203070494,Paraíba,3974687,0.7770,2423,3088152,0.6361,13932,2528142,0.0000,0,10
2021-12-03,Brazil,203070494,Paraíba,3974687,0.7775,2230,3090382,0.6384,9229,2537371,0.0000,1,11
2021-12-04,Brazil,203070494,Paraíba,3974687,0.7778,941,3091323,0.6392,3282,2540653,0.0000,0,11
2021-12-05,Brazil,203070494,Paraíba,3974687,0.7778,23,3091346,0.6392,92,2540745,0.0000,0,11
2021-12-06,Brazil,203070494,Paraíba,3974687,0.7783,2224,3093570,0.6417,9751,2550496,0.0000,0,11
2021-12-07,Brazil,203070494,Paraíba,3974687,0.7790,2602,3096172,0.6446,11601,2562097,0.0000,1,12
2021-12-08,Brazil,203070494,Paraíba,3974687,0.7792,844,3097016,0.6457,4213,2566310,0.0000,0,12
2021-12-09,Brazil,203070494,Paraíba,3974687,0.7799,2820,3099836,0.6487,12041,2578351,0.0000,1,13
2021-12-10,Brazil,203070494,Paraíba,3974687,0.7804,1896,3101732,0.6504,6851,2585202,0.0000,2,15
2021-12-11,Brazil,203070494,Paraíba,3974687,0.7820,6334,3108066,0.6559,21639,2606841,0.0000,7,22
2021-12-12,Brazil,203070494,Paraíba,3974687,0.7820,28,3108094,0.6559,158,2606999,0.0000,0,22
2021-12-13,Brazil,203070494,Paraíba,3974687,0.7824,1838,3109932,0.6581,8892,2615891,0.0000,3,25
2021-12-14,Brazil,203070494,Paraíba,3974687,0.7830,2056,3111988,0.6606,9827,2625718,0.0000,0,25
2021-12-15,Brazil,203070494,Paraíba,3974687,0.7834,1931,3113919,0.6638,12490,2638208,0.0000,3,28
2021-12-16,Brazil,203070494,Paraíba,3974687,0.7840,2072,3115991,0.6670,13009,2651217,0.0000,3,31
2021-12-17,Brazil,203070494,Paraíba,3974687,0.7843,1417,3117408,0.6691,8339,2659556,0.0000,1,32
2021-12-18,Brazil,203070494,Paraíba,3974687,0.7845,811,3118219,0.6702,4133,2663689,0.0000,0,32
2021-12-19,Brazil,203070494,Paraíba,3974687,0.7845,61,3118280,0.6702,188,2663877,0.0000,0,32
2021-12-20,Brazil,203070494,Paraíba,3974687,0.7849,1620,3119900,0.6729,10643,2674520,0.0000,1,33
2021-12-21,Brazil,203070494,Paraíba,3974687,0.7855,2029,3121929,0.6762,13101,2687621,0.0000,1,34
2021-12-22,Brazil,203070494,Paraíba,3974687,0.7862,2853,3124782,0.6801,15650,2703271,0.0000,0,34
2021-12-23,Brazil,203070494,Paraíba,3974687,0.7864,1044,3125826,0.6815,5362,2708633,0.0000,1,35
2021-12-24,Brazil,203070494,Paraíba,3974687,0.7864,62,3125888,0.6816,402,2709035,0.0000,0,35
2021-12-25,Brazil,203070494,Paraíba,3974687,0.7865,21,3125909,0.6816,69,2709104,0.0000,0,35
2021-12-26,Brazil,203070494,Paraíba,3974687,0.7865,33,3125942,0.6816,94,2709198,0.0000,0,35
2021-12-27,Brazil,203070494,Paraíba,3974687,0.7866,597,3126539,0.6828,4808,2714006,0.0000,0,35
2021-12-28,Brazil,203070494,Paraíba,3974687,0.7868,853,3127392,0.6843,5836,2719842,0.0000,1,36
2021-12-29,Brazil,203070494,Paraíba,3974687,0.7873,1929,3129321,0.6870,10766,2730608,0.0000,0,36
2021-12-30,Brazil,203070494,Paraíba,3974687,0.7874,316,3129637,0.6874,1454,2732062,0.0000,0,36
2021-12-31,Brazil,203070494,Paraíba,3974687,0.7874,9,3129646,0.6874,11,2732073,0.0000,0,36
2021-01-09,Brazil,203070494,Pará,8121025,0.0000,12,12,0.0000,0,0,0.0000,0,0
2021-01-10,Brazil,203070494,Pará,8121025,0.0000,0,12,0.0000,1,1,0.0000,0,0
2021-01-11,Brazil,203070494,Pará,8121025,0.0000,0,12,0.0000,1,2,0.0000,0,0
2021-01-16,Brazil,203070494,Pará,8121025,0.0000,1,13,0.0000,0,2,0.0000,0,0
2021-01-17,Brazil,203070494,Pará,8121025,0.0000,41,54,0.0000,5,7,0.0000,0,0
2021-01-18,Brazil,203070494,Pará,8121025,0.0000,57,111,0.0000,8,15,0.0000,0,0
2021-01-19,Brazil,203070494,Pará,8121025,0.0005,3699,3810,0.0000,6,21,0.0000,0,0
2021-01-20,Brazil,203070494,Pará,8121025,0.0018,11022,14832,0.0000,11,32,0.0000,0,0
2021-01-21,Brazil,203070494,Pará,8121025,0.0030,9231,24063,0.0000,21,53,0.0000,0,0
2021-01-22,Brazil,203070494,Pará,8121025,0.0040,8546,32609,0.0000,14,67,0.0000,0,0
2021-01-23,Brazil,203070494,Pará,8121025,0.0043,2524,35133,0.0000,28,95,0.0000,0,0
2021-01-24,Brazil,203070494,Pará,8121025,0.0044,800,35933,0.0000,10,105,0.0000,0,0
2021-01-25,Brazil,203070494,Pará,8121025,0.0050,4393,40326,0.0000,8,113,0.0000,0,0
2021-01-26,Brazil,203070494,Pará,8121025,0.0055,4104,44430,0.0000,11,124,0.0000,0,0
2021-01-27,Brazil,203070494,Pará,8121025,0.0064,7295,51725,0.0000,7,131,0.0000,0,0
2021-01-28,Brazil,203070494,Pará,8121025,0.0073,7399,59124,0.0000,16,147,0.0000,0,0
2021-01-29,Brazil,203070494,Pará,8121025,0.0082,7225,66349,0.0000,12,159,0.0000,0,0
2021-01-30,Brazil,203070494,Pará,8121025,0.0083,1050,67399,0.0000,23,182,0.0000,0,0
2021-01-31,Brazil,203070494,Pará,8121025,0.0084,458,67857,0.0000,4,186,0.0000,0,0
2021-02-01,Brazil,203070494,Pará,8121025,0.0091,5824,73681,0.0000,13,199,0.0000,0,0
2021-02-02,Brazil,203070494,Pará,8121025,0.0097,5035,78716,0.0000,14,213,0.0000,0,0
2021-02-03,Brazil,203070494,Pará,8121025,0.0109,9775,88491,0.0000,36,249,0.0000,0,0
2021-02-04,Brazil,203070494,Pará,8121025,0.0119,7853,96344,0.0000,28,277,0.0000,0,0
2021-02-05,Brazil,203070494,Pará,8121025,0.0127,7072,103416,0.0000,23,300,0.0000,0,0
2021-02-06,Brazil,203070494,Pará,8121025,0.0131,2626,106042,0.0000,13,313,0.0000,0,0
2021-02-07,Brazil,203070494,Pará,8121025,0.0132,1185,107227,0.0000,8,321,0.0000,0,0
2021-02-08,Brazil,203070494,Pará,8121025,0.0136,3333,110560,0.0000,44,365,0.0000,0,0
2021-02-09,Brazil,203070494,Pará,8121025,0.0140,2934,113494,0.0001,250,615,0.0000,0,0
2021-02-10,Brazil,203070494,Pará,8121025,0.0144,3741,117235,0.0006,4313,4928,0.0000,0,0
2021-02-11,Brazil,203070494,Pará,8121025,0.0149,4038,121273,0.0014,6652,11580,0.0000,0,0
2021-02-12,Brazil,203070494,Pará,8121025,0.0154,4132,125405,0.0021,5426,17006,0.0000,0,0
2021-02-13,Brazil,203070494,Pará,8121025,0.0157,2190,127595,0.0022,934,17940,0.0000,0,0
2021-02-14,Brazil,203070494,Pará,8121025,0.0158,1089,128684,0.0022,258,18198,0.0000,0,0
2021-02-15,Brazil,203070494,Pará,8121025,0.0164,4123,132807,0.0028,4272,22470,0.0000,0,0
2021-02-16,Brazil,203070494,Pará,8121025,0.0167,2987,135794,0.0031,2744,25214,0.0000,0,0
2021-02-17,Brazil,203070494,Pará,8121025,0.0172,3907,139701,0.0038,5290,30504,0.0000,0,0
2021-02-18,Brazil,203070494,Pará,8121025,0.0176,2949,142650,0.0046,6725,37229,0.0000,0,0
2021-02-19,Brazil,203070494,Pará,8121025,0.0180,3565,146215,0.0052,5302,42531,0.0000,0,0
2021-02-20,Brazil,203070494,Pará,8121025,0.0182,1218,147433,0.0053,902,43433,0.0000,0,0
2021-02-21,Brazil,203070494,Pará,8121025,0.0182,345,147778,0.0054,570,44003,0.0000,0,0
2021-02-22,Brazil,203070494,Pará,8121025,0.0184,1983,149761,0.0058,3032,47035,0.0000,0,0
2021-02-23,Brazil,203070494,Pará,8121025,0.0189,3996,153757,0.0062,3339,50374,0.0000,0,0
2021-02-24,Brazil,203070494,Pará,8121025,0.0192,1842,155599,0.0069,5875,56249,0.0000,0,0
2021-02-25,Brazil,203070494,Pará,8121025,0.0194,1806,157405,0.0076,5257,61506,0.0000,0,0
2021-02-26,Brazil,203070494,Pará,8121025,0.0196,1792,159197,0.0081,4030,65536,0.0000,0,0
2021-02-27,Brazil,203070494,Pará,8121025,0.0198,1620,160817,0.0082,805,66341,0.0000,0,0
2021-02-28,Brazil,203070494,Pará,8121025,0.0199,958,161775,0.0082,262,66603,0.0000,0,0
2021-03-01,Brazil,203070494,Pará,8121025,0.0206,5725,167500,0.0083,1087,67690,0.0000,0,0
2021-03-02,Brazil,203070494,Pará,8121025,0.0224,14777,182277,0.0086,2289,69979,0.0000,0,0
2021-03-03,Brazil,203070494,Pará,8121025,0.0240,13012,195289,0.0089,1976,71955,0.0000,0,0
2021-03-04,Brazil,203070494,Pará,8121025,0.0252,9568,204857,0.0091,1823,73778,0.0000,0,0
2021-03-05,Brazil,203070494,Pará,8121025,0.0275,18097,222954,0.0093,2135,75913,0.0000,0,0
2021-03-06,Brazil,203070494,Pará,8121025,0.0303,23042,245996,0.0094,772,76685,0.0000,0,0
2021-03-07,Brazil,203070494,Pará,8121025,0.0319,13057,259053,0.0095,175,76860,0.0000,0,0
2021-03-08,Brazil,203070494,Pará,8121025,0.0344,20475,279528,0.0097,1870,78730,0.0000,0,0
2021-03-09,Brazil,203070494,Pará,8121025,0.0350,4654,284182,0.0099,1810,80540,0.0000,0,0
2021-03-10,Brazil,203070494,Pará,8121025,0.0357,6119,290301,0.0104,4166,84706,0.0000,0,0
2021-03-11,Brazil,203070494,Pará,8121025,0.0364,5273,295574,0.0108,3138,87844,0.0000,0,0
2021-03-12,Brazil,203070494,Pará,8121025,0.0369,3870,299444,0.0111,2247,90091,0.0000,0,0
2021-03-13,Brazil,203070494,Pará,8121025,0.0371,1709,301153,0.0112,630,90721,0.0000,0,0
2021-03-14,Brazil,203070494,Pará,8121025,0.0371,118,301271,0.0112,317,91038,0.0000,0,0
2021-03-15,Brazil,203070494,Pará,8121025,0.0375,3499,304770,0.0114,1931,92969,0.0000,0,0
2021-03-16,Brazil,203070494,Pará,8121025,0.0382,5635,310405,0.0119,3835,96804,0.0000,0,0
2021-03-17,Brazil,203070494,Pará,8121025,0.0386,3420,313825,0.0121,1192,97996,0.0000,0,0
2021-03-18,Brazil,203070494,Pará,8121025,0.0390,3031,316856,0.0122,1375,99371,0.0000,0,0
2021-03-19,Brazil,203070494,Pará,8121025,0.0405,11962,328818,0.0125,2264,101635,0.0000,0,0
2021-03-20,Brazil,203070494,Pará,8121025,0.0433,23180,351998,0.0126,1067,102702,0.0000,0,0
2021-03-21,Brazil,203070494,Pará,8121025,0.0446,10033,362031,0.0127,559,103261,0.0000,0,0
2021-03-22,Brazil,203070494,Pará,8121025,0.0461,12313,374344,0.0128,1093,104354,0.0000,0,0
2021-03-23,Brazil,203070494,Pará,8121025,0.0490,23437,397781,0.0141,9772,114126,0.0000,0,0
2021-03-24,Brazil,203070494,Pará,8121025,0.0544,43714,441495,0.0144,2571,116697,0.0000,0,0
2021-03-25,Brazil,203070494,Pará,8121025,0.0599,44560,486055,0.0147,2934,119631,0.0000,0,0
2021-03-26,Brazil,203070494,Pará,8121025,0.0651,42998,529053,0.0152,3850,123481,0.0000,0,0
2021-03-27,Brazil,203070494,Pará,8121025,0.0684,26816,555869,0.0156,3600,127081,0.0000,0,0
2021-03-28,Brazil,203070494,Pará,8121025,0.0711,21356,577225,0.0158,969,128050,0.0000,0,0
2021-03-29,Brazil,203070494,Pará,8121025,0.0751,32888,610113,0.0171,10858,138908,0.0000,0,0
2021-03-30,Brazil,203070494,Pará,8121025,0.0811,48877,658990,0.0188,13796,152704,0.0000,0,0
2021-03-31,Brazil,203070494,Pará,8121025,0.0859,38529,697519,0.0205,13493,166197,0.0000,0,0
2021-04-01,Brazil,203070494,Pará,8121025,0.0882,18835,716354,0.0227,18030,184227,0.0000,0,0
2021-04-02,Brazil,203070494,Pará,8121025,0.0885,1964,718318,0.0227,206,184433,0.0000,0,0
2021-04-03,Brazil,203070494,Pará,8121025,0.0890,4351,722669,0.0227,135,184568,0.0000,0,0
2021-04-04,Brazil,203070494,Pará,8121025,0.0891,759,723428,0.0227,54,184622,0.0000,0,0
2021-04-05,Brazil,203070494,Pará,8121025,0.0910,15981,739409,0.0233,4230,188852,0.0000,0,0
2021-04-06,Brazil,203070494,Pará,8121025,0.0931,17029,756438,0.0239,5001,193853,0.0000,0,0
2021-04-07,Brazil,203070494,Pará,8121025,0.0950,14961,771399,0.0243,3419,197272,0.0000,0,0
2021-04-08,Brazil,203070494,Pará,8121025,0.0968,14489,785888,0.0248,3835,201107,0.0000,0,0
2021-04-09,Brazil,203070494,Pará,8121025,0.0981,10773,796661,0.0254,5227,206334,0.0000,0,0
2021-04-10,Brazil,203070494,Pará,8121025,0.0987,4696,801357,0.0257,2083,208417,0.0000,0,0
2021-04-11,Brazil,203070494,Pará,8121025,0.0989,1776,803133,0.0257,91,208508,0.0000,0,0
2021-04-12,Brazil,203070494,Pará,8121025,0.0999,8169,811302,0.0269,9980,218488,0.0000,0,0
2021-04-13,Brazil,203070494,Pará,8121025,0.1011,9734,821036,0.0284,12286,230774,0.0000,0,0
2021-04-14,Brazil,203070494,Pará,8121025,0.1019,6834,827870,0.0295,8950,239724,0.0000,0,0
2021-04-15,Brazil,203070494,Pará,8121025,0.1027,6368,834238,0.0313,14843,254567,0.0000,0,0
2021-04-16,Brazil,203070494,Pará,8121025,0.1036,6922,841160,0.0336,17936,272503,0.0000,0,0
2021-04-17,Brazil,203070494,Pará,8121025,0.1041,4141,845301,0.0341,4719,277222,0.0000,0,0
2021-04-18,Brazil,203070494,Pará,8121025,0.1042,552,845853,0.0342,244,277466,0.0000,0,0
2021-04-19,Brazil,203070494,Pará,8121025,0.1050,6563,852416,0.0370,22649,300115,0.0000,0,0
2021-04-20,Brazil,203070494,Pará,8121025,0.1061,9265,861681,0.0407,30451,330566,0.0000,0,0
2021-04-21,Brazil,203070494,Pará,8121025,0.1069,6655,868336,0.0428,16775,347341,0.0000,0,0
2021-04-22,Brazil,203070494,Pará,8121025,0.1081,9763,878099,0.0460,26121,373462,0.0000,0,0
2021-04-23,Brazil,203070494,Pará,8121025,0.1092,8539,886638,0.0470,7858,381320,0.0000,0,0
2021-04-24,Brazil,203070494,Pará,8121025,0.1097,4317,890955,0.0472,2355,383675,0.0000,0,0
2021-04-25,Brazil,203070494,Pará,8121025,0.1099,1786,892741,0.0473,796,384471,0.0000,0,0
2021-04-26,Brazil,203070494,Pará,8121025,0.1111,9481,902222,0.0485,9369,393840,0.0000,0,0
2021-04-27,Brazil,203070494,Pará,8121025,0.1124,10986,913208,0.0496,8779,402619,0.0000,0,0
2021-04-28,Brazil,203070494,Pará,8121025,0.1141,13592,926800,0.0508,9809,412428,0.0000,0,0
2021-04-29,Brazil,203070494,Pará,8121025,0.1155,11427,938227,0.0518,8382,420810,0.0000,0,0
2021-04-30,Brazil,203070494,Pará,8121025,0.1167,9336,947563,0.0526,6670,427480,0.0000,0,0
2021-05-01,Brazil,203070494,Pará,8121025,0.1172,3947,951510,0.0530,2746,430226,0.0000,0,0
2021-05-02,Brazil,203070494,Pará,8121025,0.1172,450,951960,0.0531,952,431178,0.0000,0,0
2021-05-03,Brazil,203070494,Pará,8121025,0.1179,5224,957184,0.0540,7357,438535,0.0000,0,0
2021-05-04,Brazil,203070494,Pará,8121025,0.1187,6998,964182,0.0549,7197,445732,0.0000,0,0
2021-05-05,Brazil,203070494,Pará,8121025,0.1201,11317,975499,0.0560,8777,454509,0.0000,0,0
2021-05-06,Brazil,203070494,Pará,8121025,0.1219,14434,989933,0.0568,6755,461264,0.0000,0,0
2021-05-07,Brazil,203070494,Pará,8121025,0.1236,14087,1004020,0.0574,5146,466410,0.0000,0,0
2021-05-08,Brazil,203070494,Pará,8121025,0.1244,6474,1010494,0.0576,1259,467669,0.0000,0,0
2021-05-09,Brazil,203070494,Pará,8121025,0.1245,365,1010859,0.0576,99,467768,0.0000,0,0
2021-05-10,Brazil,203070494,Pará,8121025,0.1256,8968,1019827,0.0588,9983,477751,0.0000,0,0
2021-05-11,Brazil,203070494,Pará,8121025,0.1268,10313,1030140,0.0604,12633,490384,0.0000,0,0
2021-05-12,Brazil,203070494,Pará,8121025,0.1284,12601,1042741,0.0612,6526,496910,0.0000,0,0
2021-05-13,Brazil,203070494,Pará,8121025,0.1310,20961,1063702,0.0620,6484,503394,0.0000,0,0
2021-05-14,Brazil,203070494,Pará,8121025,0.1334,19282,1082984,0.0627,5494,508888,0.0000,0,0
2021-05-15,Brazil,203070494,Pará,8121025,0.1347,10938,1093922,0.0628,1487,510375,0.0000,0,0
2021-05-16,Brazil,203070494,Pará,8121025,0.1363,12926,1106848,0.0629,168,510543,0.0000,0,0
2021-05-17,Brazil,203070494,Pará,8121025,0.1376,10347,1117195,0.0634,4190,514733,0.0000,0,0
2021-05-18,Brazil,203070494,Pará,8121025,0.1394,14623,1131818,0.0642,6615,521348,0.0000,0,0
2021-05-19,Brazil,203070494,Pará,8121025,0.1414,16825,1148643,0.0652,8216,529564,0.0000,0,0
2021-05-20,Brazil,203070494,Pará,8121025,0.1438,19156,1167799,0.0663,8562,538126,0.0000,0,0
2021-05-21,Brazil,203070494,Pará,8121025,0.1462,19533,1187332,0.0671,7122,545248,0.0000,0,0
2021-05-22,Brazil,203070494,Pará,8121025,0.1473,8754,1196086,0.0675,2971,548219,0.0000,0,0
2021-05-23,Brazil,203070494,Pará,8121025,0.1476,2682,1198768,0.0675,246,548465,0.0000,0,0
2021-05-24,Brazil,203070494,Pará,8121025,0.1501,19880,1218648,0.0684,7293,555758,0.0000,0,0
2021-05-25,Brazil,203070494,Pará,8121025,0.1540,32056,1250704,0.0694,8086,563844,0.0000,0,0
2021-05-26,Brazil,203070494,Pará,8121025,0.1577,30221,1280925,0.0704,8067,571911,0.0000,0,0
2021-05-27,Brazil,203070494,Pará,8121025,0.1614,29834,1310759,0.0714,7702,579613,0.0000,0,0
2021-05-28,Brazil,203070494,Pará,8121025,0.1648,27528,1338287,0.0722,7030,586643,0.0000,0,0
2021-05-29,Brazil,203070494,Pará,8121025,0.1670,17647,1355934,0.0724,1010,587653,0.0000,0,0
2021-05-30,Brazil,203070494,Pará,8121025,0.1671,1287,1357221,0.0724,174,587827,0.0000,0,0
2021-05-31,Brazil,203070494,Pará,8121025,0.1695,19179,1376400,0.0732,6700,594527,0.0000,0,0
2021-06-01,Brazil,203070494,Pará,8121025,0.1720,20694,1397094,0.0750,14481,609008,0.0000,0,0
2021-06-02,Brazil,203070494,Pará,8121025,0.1758,30228,1427322,0.0759,7609,616617,0.0000,0,0
2021-06-03,Brazil,203070494,Pará,8121025,0.1771,11200,1438522,0.0761,1755,618372,0.0000,0,0
2021-06-04,Brazil,203070494,Pará,8121025,0.1790,15422,1453944,0.0766,3767,622139,0.0000,0,0
2021-06-05,Brazil,203070494,Pará,8121025,0.1797,5607,1459551,0.0767,617,622756,0.0000,0,0
2021-06-06,Brazil,203070494,Pará,8121025,0.1799,1610,1461161,0.0767,258,623014,0.0000,0,0
2021-06-07,Brazil,203070494,Pará,8121025,0.1822,18228,1479389,0.0779,9717,632731,0.0000,0,0
2021-06-08,Brazil,203070494,Pará,8121025,0.1847,20727,1500116,0.0788,6823,639554,0.0000,0,0
2021-06-09,Brazil,203070494,Pará,8121025,0.1881,27740,1527856,0.0799,9683,649237,0.0000,0,0
2021-06-10,Brazil,203070494,Pará,8121025,0.1920,31366,1559222,0.0808,6945,656182,0.0000,0,0
2021-06-11,Brazil,203070494,Pará,8121025,0.1961,33181,1592403,0.0815,5404,661586,0.0000,0,0
2021-06-12,Brazil,203070494,Pará,8121025,0.1978,14248,1606651,0.0816,810,662396,0.0000,0,0
2021-06-13,Brazil,203070494,Pará,8121025,0.1983,3508,1610159,0.0817,1043,663439,0.0000,0,0
2021-06-14,Brazil,203070494,Pará,8121025,0.2030,38441,1648600,0.0825,6282,669721,0.0000,0,0
2021-06-15,Brazil,203070494,Pará,8121025,0.2098,55435,1704035,0.0834,7786,677507,0.0000,0,0
2021-06-16,Brazil,203070494,Pará,8121025,0.2166,55016,1759051,0.0866,25833,703340,0.0000,0,0
2021-06-17,Brazil,203070494,Pará,8121025,0.2246,64852,1823903,0.0885,15310,718650,0.0000,0,0
2021-06-18,Brazil,203070494,Pará,8121025,0.2326,64699,1888602,0.0897,10144,728794,0.0000,0,0
2021-06-19,Brazil,203070494,Pará,8121025,0.2380,43944,1932546,0.0904,5542,734336,0.0000,0,0
2021-06-20,Brazil,203070494,Pará,8121025,0.2419,31787,1964333,0.0905,736,735072,0.0000,0,0
2021-06-21,Brazil,203070494,Pará,8121025,0.2469,40550,2004883,0.0916,8944,744016,0.0000,0,0
2021-06-22,Brazil,203070494,Pará,8121025,0.2552,67480,2072363,0.0936,15974,759990,0.0000,0,0
2021-06-23,Brazil,203070494,Pará,8121025,0.2601,39849,2112212,0.0953,13841,773831,0.0000,0,0
2021-06-24,Brazil,203070494,Pará,8121025,0.2632,25571,2137783,0.0966,10469,784300,0.0000,0,0
2021-06-25,Brazil,203070494,Pará,8121025,0.2665,26803,2164586,0.0982,13273,797573,0.0000,0,0
2021-06-26,Brazil,203070494,Pará,8121025,0.2716,41011,2205597,0.0988,4609,802182,0.0000,0,0
2021-06-27,Brazil,203070494,Pará,8121025,0.2729,10567,2216164,0.0988,395,802577,0.0000,0,0
2021-06-28,Brazil,203070494,Pará,8121025,0.2759,24418,2240582,0.1008,16092,818669,0.0000,0,0
2021-06-29,Brazil,203070494,Pará,8121025,0.2831,58350,2298932,0.1027,15671,834340,0.0000,0,0
2021-06-30,Brazil,203070494,Pará,8121025,0.2871,32303,2331235,0.1049,17759,852099,0.0000,0,0
2021-07-01,Brazil,203070494,Pará,8121025,0.2913,34646,2365881,0.1067,14700,866799,0.0000,0,0
2021-07-02,Brazil,203070494,Pará,8121025,0.2981,55018,2420899,0.1079,9530,876329,0.0000,0,0
2021-07-03,Brazil,203070494,Pará,8121025,0.2995,11120,2432019,0.1082,2384,878713,0.0000,0,0
2021-07-04,Brazil,203070494,Pará,8121025,0.3000,4006,2436025,0.1082,117,878830,0.0000,0,0
2021-07-05,Brazil,203070494,Pará,8121025,0.3055,44820,2480845,0.1095,10631,889461,0.0000,0,0
2021-07-06,Brazil,203070494,Pará,8121025,0.3102,38312,2519157,0.1108,10570,900031,0.0000,0,0
2021-07-07,Brazil,203070494,Pará,8121025,0.3167,53034,2572191,0.1120,9921,909952,0.0000,0,0
2021-07-08,Brazil,203070494,Pará,8121025,0.3213,37063,2609254,0.1131,8268,918220,0.0000,0,0
2021-07-09,Brazil,203070494,Pará,8121025,0.3249,29522,2638776,0.1140,7870,926090,0.0000,0,0
2021-07-10,Brazil,203070494,Pará,8121025,0.3308,47510,2686286,0.1143,2156,928246,0.0000,0,0
2021-07-11,Brazil,203070494,Pará,8121025,0.3309,793,2687079,0.1143,179,928425,0.0000,0,0
2021-07-12,Brazil,203070494,Pará,8121025,0.3350,33780,2720859,0.1154,8996,937421,0.0000,0,0
2021-07-13,Brazil,203070494,Pará,8121025,0.3391,33139,2753998,0.1166,9330,946751,0.0000,0,0
2021-07-14,Brazil,203070494,Pará,8121025,0.3459,54797,2808795,0.1179,10476,957227,0.0000,0,0
2021-07-15,Brazil,203070494,Pará,8121025,0.3497,31102,2839897,0.1190,9129,966356,0.0000,0,0
2021-07-16,Brazil,203070494,Pará,8121025,0.3523,21286,2861183,0.1199,7021,973377,0.0000,0,0
2021-07-17,Brazil,203070494,Pará,8121025,0.3558,27930,2889113,0.1201,2089,975466,0.0000,0,0
2021-07-18,Brazil,203070494,Pará,8121025,0.3559,1469,2890582,0.1202,322,975788,0.0000,0,0
2021-07-19,Brazil,203070494,Pará,8121025,0.3588,22839,2913421,0.1213,9296,985084,0.0000,0,0
2021-07-20,Brazil,203070494,Pará,8121025,0.3630,34123,2947544,0.1231,14455,999539,0.0000,0,0
2021-07-21,Brazil,203070494,Pará,8121025,0.3662,26642,2974186,0.1245,11207,1010746,0.0000,0,0
2021-07-22,Brazil,203070494,Pará,8121025,0.3729,54290,3028476,0.1257,9870,1020616,0.0000,0,0
2021-07-23,Brazil,203070494,Pará,8121025,0.3763,27758,3056234,0.1266,7746,1028362,0.0000,0,0
2021-07-24,Brazil,203070494,Pará,8121025,0.3785,17815,3074049,0.1271,4009,1032371,0.0000,0,0
2021-07-25,Brazil,203070494,Pará,8121025,0.3787,1704,3075753,0.1271,212,1032583,0.0000,0,0
2021-07-26,Brazil,203070494,Pará,8121025,0.3812,19861,3095614,0.1287,12884,1045467,0.0000,0,0
2021-07-27,Brazil,203070494,Pará,8121025,0.3842,24670,3120284,0.1306,14888,1060355,0.0000,0,0
2021-07-28,Brazil,203070494,Pará,8121025,0.3872,24160,3144444,0.1337,25820,1086175,0.0000,0,0
2021-07-29,Brazil,203070494,Pará,8121025,0.3942,57125,3201569,0.1353,12762,1098937,0.0000,0,0
2021-07-30,Brazil,203070494,Pará,8121025,0.4003,48978,3250547,0.1368,12396,1111333,0.0000,0,0
2021-07-31,Brazil,203070494,Pará,8121025,0.4007,3449,3253996,0.1371,1862,1113195,0.0000,0,0
2021-08-01,Brazil,203070494,Pará,8121025,0.4008,1294,3255290,0.1371,180,1113375,0.0000,0,0
2021-08-02,Brazil,203070494,Pará,8121025,0.4079,57175,3312465,0.1385,11256,1124631,0.0000,0,0
2021-08-03,Brazil,203070494,Pará,8121025,0.4170,73996,3386461,0.1403,15091,1139722,0.0000,0,0
2021-08-04,Brazil,203070494,Pará,8121025,0.4214,35345,3421806,0.1420,13343,1153065,0.0000,0,0
2021-08-05,Brazil,203070494,Pará,8121025,0.4272,47244,3469050,0.1443,18420,1171485,0.0000,0,0
2021-08-06,Brazil,203070494,Pará,8121025,0.4349,62922,3531972,0.1461,14782,1186267,0.0000,0,0
2021-08-07,Brazil,203070494,Pará,8121025,0.4406,45829,3577801,0.1464,2657,1188924,0.0000,0,0
2021-08-08,Brazil,203070494,Pará,8121025,0.4406,637,3578438,0.1465,456,1189380,0.0000,0,0
2021-08-09,Brazil,203070494,Pará,8121025,0.4440,27043,3605481,0.1477,10385,1199765,0.0000,0,0
2021-08-10,Brazil,203070494,Pará,8121025,0.4476,29658,3635139,0.1496,15143,1214908,0.0000,0,0
2021-08-11,Brazil,203070494,Pará,8121025,0.4520,35870,3671009,0.1513,13400,1228308,0.0000,0,0
2021-08-12,Brazil,203070494,Pará,8121025,0.4569,39435,3710444,0.1552,32337,1260645,0.0000,0,0
2021-08-13,Brazil,203070494,Pará,8121025,0.4611,34056,3744500,0.1585,26825,1287470,0.0000,0,0
2021-08-14,Brazil,203070494,Pará,8121025,0.4653,34248,3778748,0.1588,1852,1289322,0.0000,0,0
2021-08-15,Brazil,203070494,Pará,8121025,0.4658,4229,3782977,0.1588,368,1289690,0.0000,0,0
2021-08-16,Brazil,203070494,Pará,8121025,0.4689,25220,3808197,0.1627,31332,1321022,0.0000,0,0
2021-08-17,Brazil,203070494,Pará,8121025,0.4735,36845,3845042,0.1650,18825,1339847,0.0000,0,0
2021-08-18,Brazil,203070494,Pará,8121025,0.4780,36925,3881967,0.1673,18419,1358266,0.0000,0,0
2021-08-19,Brazil,203070494,Pará,8121025,0.4833,42603,3924570,0.1710,30828,1389094,0.0000,0,0
2021-08-20,Brazil,203070494,Pará,8121025,0.4876,35235,3959805,0.1759,39093,1428187,0.0000,0,0
2021-08-21,Brazil,203070494,Pará,8121025,0.4887,8811,3968616,0.1766,6244,1434431,0.0000,0,0
2021-08-22,Brazil,203070494,Pará,8121025,0.4887,412,3969028,0.1769,2171,1436602,0.0000,0,0
2021-08-23,Brazil,203070494,Pará,8121025,0.4915,22345,3991373,0.1802,27201,1463803,0.0000,0,0
2021-08-24,Brazil,203070494,Pará,8121025,0.4954,31469,4022842,0.1847,35803,1499606,0.0000,0,0
2021-08-25,Brazil,203070494,Pará,8121025,0.5017,51403,4074245,0.1870,19080,1518686,0.0000,0,0
2021-08-26,Brazil,203070494,Pará,8121025,0.5098,65472,4139717,0.1898,22672,1541358,0.0000,0,0
2021-08-27,Brazil,203070494,Pará,8121025,0.5143,36992,4176709,0.1944,37151,1578509,0.0000,0,0
2021-08-28,Brazil,203070494,Pará,8121025,0.5167,19359,4196068,0.1949,4591,1583100,0.0000,0,0
2021-08-29,Brazil,203070494,Pará,8121025,0.5174,6016,4202084,0.1950,808,1583908,0.0000,0,0
2021-08-30,Brazil,203070494,Pará,8121025,0.5211,29874,4231958,0.1990,32101,1616009,0.0000,0,0
2021-08-31,Brazil,203070494,Pará,8121025,0.5258,38397,4270355,0.2036,37116,1653125,0.0000,0,0
2021-09-01,Brazil,203070494,Pará,8121025,0.5319,49125,4319480,0.2085,40181,1693306,0.0000,0,0
2021-09-02,Brazil,203070494,Pará,8121025,0.5383,52080,4371560,0.2152,54548,1747854,0.0000,0,0
2021-09-03,Brazil,203070494,Pará,8121025,0.5477,76104,4447664,0.2191,31567,1779421,0.0000,0,0
2021-09-04,Brazil,203070494,Pará,8121025,0.5506,24020,4471684,0.2235,35987,1815408,0.0000,0,0
2021-09-05,Brazil,203070494,Pará,8121025,0.5509,1970,4473654,0.2236,339,1815747,0.0000,0,0
2021-09-06,Brazil,203070494,Pará,8121025,0.5527,14585,4488239,0.2248,9503,1825250,0.0000,0,0
2021-09-07,Brazil,203070494,Pará,8121025,0.5530,2311,4490550,0.2248,442,1825692,0.0000,0,0
2021-09-08,Brazil,203070494,Pará,8121025,0.5566,29559,4520109,0.2284,29401,1855093,0.0000,0,0
2021-09-09,Brazil,203070494,Pará,8121025,0.5605,31947,4552056,0.2349,52141,1907234,0.0000,0,0
2021-09-10,Brazil,203070494,Pará,8121025,0.5667,50445,4602501,0.2380,25519,1932753,0.0000,0,0
2021-09-11,Brazil,203070494,Pará,8121025,0.5685,14315,4616816,0.2399,15393,1948146,0.0000,0,0
2021-09-12,Brazil,203070494,Pará,8121025,0.5687,1426,4618242,0.2400,842,1948988,0.0000,0,0
2021-09-13,Brazil,203070494,Pará,8121025,0.5729,34545,4652787,0.2427,21876,1970864,0.0000,0,0
2021-09-14,Brazil,203070494,Pará,8121025,0.5787,46450,4699237,0.2463,29511,2000375,0.0000,0,0
2021-09-15,Brazil,203070494,Pará,8121025,0.5825,31652,4730889,0.2524,49044,2049419,0.0000,0,0
2021-09-16,Brazil,203070494,Pará,8121025,0.5859,27361,4758250,0.2589,53496,2102915,0.0000,0,0
2021-09-17,Brazil,203070494,Pará,8121025,0.5886,21595,4779845,0.2653,51656,2154571,0.0000,0,0
2021-09-18,Brazil,203070494,Pará,8121025,0.5897,8819,4788664,0.2658,3888,2158459,0.0000,0,0
2021-09-19,Brazil,203070494,Pará,8121025,0.5898,1098,4789762,0.2659,574,2159033,0.0000,0,0
2021-09-20,Brazil,203070494,Pará,8121025,0.5913,12474,4802236,0.2703,35894,2194927,0.0000,0,0
2021-09-21,Brazil,203070494,Pará,8121025,0.5933,15923,4818159,0.2752,40156,2235083,0.0000,0,0
2021-09-22,Brazil,203070494,Pará,8121025,0.5978,36806,4854965,0.2788,28726,2263809,0.0000,0,0
2021-09-23,Brazil,203070494,Pará,8121025,0.6004,21277,4876242,0.2838,41238,2305047,0.0000,0,0
2021-09-24,Brazil,203070494,Pará,8121025,0.6025,16518,4892760,0.2873,28286,2333333,0.0000,0,0
2021-09-25,Brazil,203070494,Pará,8121025,0.6050,20638,4913398,0.2883,7707,2341040,0.0000,0,0
2021-09-26,Brazil,203070494,Pará,8121025,0.6052,1097,4914495,0.2884,869,2341909,0.0000,0,0
2021-09-27,Brazil,203070494,Pará,8121025,0.6067,12873,4927368,0.2919,28535,2370444,0.0000,0,0
2021-09-28,Brazil,203070494,Pará,8121025,0.6088,16755,4944123,0.2952,26517,2396961,0.0000,0,0
2021-09-29,Brazil,203070494,Pará,8121025,0.6106,14180,4958303,0.2987,28575,2425536,0.0000,0,0
2021-09-30,Brazil,203070494,Pará,8121025,0.6129,19387,4977690,0.3022,28452,2453988,0.0000,0,0
2021-10-01,Brazil,203070494,Pará,8121025,0.6144,12140,4989830,0.3047,20441,2474429,0.0000,0,0
2021-10-02,Brazil,203070494,Pará,8121025,0.6186,33599,5023429,0.3056,7332,2481761,0.0000,0,0
2021-10-03,Brazil,203070494,Pará,8121025,0.6187,726,5024155,0.3056,403,2482164,0.0000,0,0
2021-10-04,Brazil,203070494,Pará,8121025,0.6196,7642,5031797,0.3112,45103,2527267,0.0000,0,0
2021-10-05,Brazil,203070494,Pará,8121025,0.6215,15370,5047167,0.3152,32760,2560027,0.0000,0,0
2021-10-06,Brazil,203070494,Pará,8121025,0.6232,13781,5060948,0.3198,37246,2597273,0.0000,0,0
2021-10-07,Brazil,203070494,Pará,8121025,0.6247,12275,5073223,0.3265,53903,2651176,0.0000,0,0
2021-10-08,Brazil,203070494,Pará,8121025,0.6294,37961,5111184,0.3296,25795,2676971,0.0000,1,1
2021-10-09,Brazil,203070494,Pará,8121025,0.6319,20851,5132035,0.3306,8099,2685070,0.0000,0,1
2021-10-10,Brazil,203070494,Pará,8121025,0.6320,696,5132731,0.3307,759,2685829,0.0000,0,1
2021-10-11,Brazil,203070494,Pará,8121025,0.6325,4036,5136767,0.3323,12767,2698596,0.0000,0,1
2021-10-12,Brazil,203070494,Pará,8121025,0.6328,2055,5138822,0.3327,3062,2701658,0.0000,0,1
2021-10-13,Brazil,203070494,Pará,8121025,0.6346,14501,5153323,0.3376,40198,2741856,0.0000,0,1
2021-10-14,Brazil,203070494,Pará,8121025,0.6372,21231,5174554,0.3424,38416,2780272,0.0000,0,1
2021-10-15,Brazil,203070494,Pará,8121025,0.6388,13091,5187645,0.3485,49644,2829916,0.0000,0,1
2021-10-16,Brazil,203070494,Pará,8121025,0.6396,6402,5194047,0.3497,9845,2839761,0.0000,0,1
2021-10-17,Brazil,203070494,Pará,8121025,0.6397,1244,5195291,0.3498,1369,2841130,0.0000,0,1
2021-10-18,Brazil,203070494,Pará,8121025,0.6406,6666,5201957,0.3558,48038,2889168,0.0000,0,1
2021-10-19,Brazil,203070494,Pará,8121025,0.6416,8360,5210317,0.3621,51524,2940692,0.0000,0,1
2021-10-20,Brazil,203070494,Pará,8121025,0.6426,8163,5218480,0.3686,52950,2993642,0.0000,0,1
2021-10-21,Brazil,203070494,Pará,8121025,0.6437,9022,5227502,0.3739,42455,3036097,0.0000,0,1
2021-10-22,Brazil,203070494,Pará,8121025,0.6448,8662,5236164,0.3803,51992,3088089,0.0000,0,1
2021-10-23,Brazil,203070494,Pará,8121025,0.6453,3929,5240093,0.3810,6418,3094507,0.0000,0,1
2021-10-24,Brazil,203070494,Pará,8121025,0.6453,500,5240593,0.3813,1792,3096299,0.0000,0,1
2021-10-25,Brazil,203070494,Pará,8121025,0.6463,8316,5248909,0.3845,26268,3122567,0.0000,0,1
2021-10-26,Brazil,203070494,Pará,8121025,0.6473,7760,5256669,0.3906,49627,3172194,0.0000,0,1
2021-10-27,Brazil,203070494,Pará,8121025,0.6485,9749,5266418,0.3975,55828,3228022,0.0000,0,1
2021-10-28,Brazil,203070494,Pará,8121025,0.6493,6388,5272806,0.4021,37590,3265612,0.0000,0,1
2021-10-29,Brazil,203070494,Pará,8121025,0.6500,5739,5278545,0.4042,16968,3282580,0.0000,0,1
2021-10-30,Brazil,203070494,Pará,8121025,0.6520,16571,5295116,0.4077,28533,3311113,0.0000,0,1
2021-10-31,Brazil,203070494,Pará,8121025,0.6528,6531,5301647,0.4096,15567,3326680,0.0000,0,1
2021-11-01,Brazil,203070494,Pará,8121025,0.6539,8663,5310310,0.4136,32138,3358818,0.0000,0,1
2021-11-02,Brazil,203070494,Pará,8121025,0.6545,4985,5315295,0.4182,37354,3396172,0.0000,0,1
2021-11-03,Brazil,203070494,Pará,8121025,0.6555,7812,5323107,0.4255,59307,3455479,0.0000,0,1
2021-11-04,Brazil,203070494,Pará,8121025,0.6566,9214,5332321,0.4332,62726,3518205,0.0000,0,1
2021-11-05,Brazil,203070494,Pará,8121025,0.6579,10783,5343104,0.4402,57076,3575281,0.0000,0,1
2021-11-06,Brazil,203070494,Pará,8121025,0.6582,1925,5345029,0.4409,5509,3580790,0.0000,0,1
2021-11-07,Brazil,203070494,Pará,8121025,0.6582,470,5345499,0.4411,1773,3582563,0.0000,0,1
2021-11-08,Brazil,203070494,Pará,8121025,0.6589,5814,5351313,0.4444,26200,3608763,0.0000,0,1
2021-11-09,Brazil,203070494,Pará,8121025,0.6597,5865,5357178,0.4487,35339,3644102,0.0000,0,1
2021-11-10,Brazil,203070494,Pará,8121025,0.6604,5708,5362886,0.4527,32279,3676381,0.0000,1,2
2021-11-11,Brazil,203070494,Pará,8121025,0.6611,6314,5369200,0.4570,34828,3711209,0.0000,0,2
2021-11-12,Brazil,203070494,Pará,8121025,0.6620,6589,5375789,0.4610,32390,3743599,0.0000,0,2
2021-11-13,Brazil,203070494,Pará,8121025,0.6621,1464,5377253,0.4618,6724,3750323,0.0000,0,2
2021-11-14,Brazil,203070494,Pará,8121025,0.6622,445,5377698,0.4620,1369,3751692,0.0000,0,2
2021-11-15,Brazil,203070494,Pará,8121025,0.6623,639,5378337,0.4624,3504,3755196,0.0000,0,2
2021-11-16,Brazil,203070494,Pará,8121025,0.6630,5687,5384024,0.4656,25814,3781010,0.0000,0,2
2021-11-17,Brazil,203070494,Pará,8121025,0.6639,7424,5391448,0.4685,23482,3804492,0.0000,1,3
2021-11-18,Brazil,203070494,Pará,8121025,0.6647,6295,5397743,0.4714,23652,3828144,0.0000,0,3
2021-11-19,Brazil,203070494,Pará,8121025,0.6655,6636,5404379,0.4742,23100,3851244,0.0000,0,3
2021-11-20,Brazil,203070494,Pará,8121025,0.6657,1991,5406370,0.4748,4948,3856192,0.0000,0,3
2021-11-21,Brazil,203070494,Pará,8121025,0.6658,664,5407034,0.4750,1484,3857676,0.0000,0,3
2021-11-22,Brazil,203070494,Pará,8121025,0.6664,4914,5411948,0.4772,17996,3875672,0.0000,0,3
2021-11-23,Brazil,203070494,Pará,8121025,0.6673,6896,5418844,0.4802,24074,3899746,0.0000,0,3
2021-11-24,Brazil,203070494,Pará,8121025,0.6680,6395,5425239,0.4830,22816,3922562,0.0000,0,3
2021-11-25,Brazil,203070494,Pará,8121025,0.6689,6783,5432022,0.4860,24642,3947204,0.0000,0,3
2021-11-26,Brazil,203070494,Pará,8121025,0.6697,6932,5438954,0.4886,20907,3968111,0.0000,0,3
2021-11-27,Brazil,203070494,Pará,8121025,0.6699,1221,5440175,0.4889,2655,3970766,0.0000,0,3
2021-11-28,Brazil,203070494,Pará,8121025,0.6699,308,5440483,0.4890,567,3971333,0.0000,0,3
2021-11-29,Brazil,203070494,Pará,8121025,0.6708,7173,5447656,0.4920,24004,3995337,0.0000,0,3
2021-11-30,Brazil,203070494,Pará,8121025,0.6720,9760,5457416,0.4957,30210,4025547,0.0000,0,3
2021-12-01,Brazil,203070494,Pará,8121025,0.6735,12391,5469807,0.5000,35134,4060681,0.0000,0,3
2021-12-02,Brazil,203070494,Pará,8121025,0.6751,12846,5482653,0.5041,33357,4094038,0.0000,0,3
2021-12-03,Brazil,203070494,Pará,8121025,0.6767,12609,5495262,0.5081,32114,4126152,0.0000,2,5
2021-12-04,Brazil,203070494,Pará,8121025,0.6772,4320,5499582,0.5092,9251,4135403,0.0000,0,5
2021-12-05,Brazil,203070494,Pará,8121025,0.6775,2235,5501817,0.5097,3773,4139176,0.0000,0,5
2021-12-06,Brazil,203070494,Pará,8121025,0.6801,21270,5523087,0.5141,35520,4174696,0.0000,0,5
2021-12-07,Brazil,203070494,Pará,8121025,0.6830,23507,5546594,0.5189,39452,4214148,0.0000,0,5
2021-12-08,Brazil,203070494,Pará,8121025,0.6847,13827,5560421,0.5216,22029,4236177,0.0000,1,6
2021-12-09,Brazil,203070494,Pará,8121025,0.6879,25731,5586152,0.5268,41926,4278103,0.0000,0,6
2021-12-10,Brazil,203070494,Pará,8121025,0.6906,21851,5608003,0.5309,33667,4311770,0.0000,0,6
2021-12-11,Brazil,203070494,Pará,8121025,0.6912,4904,5612907,0.5318,7047,4318817,0.0000,0,6
2021-12-12,Brazil,203070494,Pará,8121025,0.6915,2510,5615417,0.5323,3948,4322765,0.0000,0,6
2021-12-13,Brazil,203070494,Pará,8121025,0.6936,17505,5632922,0.5354,25618,4348383,0.0000,0,6
2021-12-14,Brazil,203070494,Pará,8121025,0.6957,17278,5650200,0.5391,29538,4377921,0.0000,0,6
2021-12-15,Brazil,203070494,Pará,8121025,0.6977,15926,5666126,0.5425,27748,4405669,0.0000,0,6
2021-12-16,Brazil,203070494,Pará,8121025,0.6994,13387,5679513,0.5454,23551,4429220,0.0000,1,7
2021-12-17,Brazil,203070494,Pará,8121025,0.7009,12598,5692111,0.5480,21375,4450595,0.0000,0,7
2021-12-18,Brazil,203070494,Pará,8121025,0.7012,2261,5694372,0.5484,3309,4453904,0.0000,0,7
2021-12-19,Brazil,203070494,Pará,8121025,0.7013,745,5695117,0.5486,1084,4454988,0.0000,0,7
2021-12-20,Brazil,203070494,Pará,8121025,0.7026,10451,5705568,0.5506,16290,4471278,0.0000,0,7
2021-12-21,Brazil,203070494,Pará,8121025,0.7037,9557,5715125,0.5528,17956,4489234,0.0000,0,7
2021-12-22,Brazil,203070494,Pará,8121025,0.7046,7290,5722415,0.5547,15445,4504679,0.0000,1,8
2021-12-23,Brazil,203070494,Pará,8121025,0.7052,4406,5726821,0.5557,8355,4513034,0.0000,0,8
2021-12-24,Brazil,203070494,Pará,8121025,0.7052,426,5727247,0.5558,616,4513650,0.0000,0,8
2021-12-25,Brazil,203070494,Pará,8121025,0.7052,55,5727302,0.5558,84,4513734,0.0000,0,8
2021-12-26,Brazil,203070494,Pará,8121025,0.7053,96,5727398,0.5558,227,4513961,0.0000,0,8
2021-12-27,Brazil,203070494,Pará,8121025,0.7057,3630,5731028,0.5568,7860,4521821,0.0000,0,8
2021-12-28,Brazil,203070494,Pará,8121025,0.7061,3387,5734415,0.5579,8640,4530461,0.0000,0,8
2021-12-29,Brazil,203070494,Pará,8121025,0.7065,2737,5737152,0.5587,7137,4537598,0.0000,0,8
2021-12-30,Brazil,203070494,Pará,8121025,0.7067,1904,5739056,0.5593,4494,4542092,0.0000,0,8
2021-12-31,Brazil,203070494,Pará,8121025,0.7067,93,5739149,0.5593,248,4542340,0.0000,0,8
2021-01-03,Brazil,203070494,Pernambuco,9058931,0.0000,0,0,0.0000,1,1,0.0000,0,0
2021-01-06,Brazil,203070494,Pernambuco,9058931,0.0000,0,0,0.0000,1,2,0.0000,0,0
2021-01-10,Brazil,203070494,Pernambuco,9058931,0.0000,1,1,0.0000,0,2,0.0000,0,0
2021-01-11,Brazil,203070494,Pernambuco,9058931,0.0000,0,1,0.0000,0,2,0.0000,0,0
2021-01-12,Brazil,203070494,Pernambuco,9058931,0.0000,5,6,0.0000,0,2,0.0000,0,0
2021-01-13,Brazil,203070494,Pernambuco,9058931,0.0000,1,7,0.0000,0,2,0.0000,0,0
2021-01-14,Brazil,203070494,Pernambuco,9058931,0.0000,1,8,0.0000,0,2,0.0000,0,0
2021-01-15,Brazil,203070494,Pernambuco,9058931,0.0000,1,9,0.0000,0,2,0.0000,0,0
2021-01-17,Brazil,203070494,Pernambuco,9058931,0.0000,39,48,0.0000,3,5,0.0000,0,0
2021-01-18,Brazil,203070494,Pernambuco,9058931,0.0000,58,106,0.0000,14,19,0.0000,0,0
2021-01-19,Brazil,203070494,Pernambuco,9058931,0.0004,3189,3295,0.0000,26,45,0.0000,0,0
2021-01-20,Brazil,203070494,Pernambuco,9058931,0.0016,11549,14844,0.0000,22,67,0.0000,0,0
2021-01-21,Brazil,203070494,Pernambuco,9058931,0.0032,14516,29360,0.0000,35,102,0.0000,0,0
2021-01-22,Brazil,203070494,Pernambuco,9058931,0.0045,11312,40672,0.0000,69,171,0.0000,0,0
2021-01-23,Brazil,203070494,Pernambuco,9058931,0.0048,2734,43406,0.0000,12,183,0.0000,0,0
2021-01-24,Brazil,203070494,Pernambuco,9058931,0.0049,1349,44755,0.0000,10,193,0.0000,0,0
2021-01-25,Brazil,203070494,Pernambuco,9058931,0.0059,8622,53377,0.0000,36,229,0.0000,0,0
2021-01-26,Brazil,203070494,Pernambuco,9058931,0.0069,9024,62401,0.0000,37,266,0.0000,0,0
2021-01-27,Brazil,203070494,Pernambuco,9058931,0.0083,13151,75552,0.0000,23,289,0.0000,0,0
2021-01-28,Brazil,203070494,Pernambuco,9058931,0.0108,21988,97540,0.0000,75,364,0.0000,0,0
2021-01-29,Brazil,203070494,Pernambuco,9058931,0.0129,19363,116903,0.0000,54,418,0.0000,0,0
2021-01-30,Brazil,203070494,Pernambuco,9058931,0.0135,5010,121913,0.0000,18,436,0.0000,0,0
2021-01-31,Brazil,203070494,Pernambuco,9058931,0.0137,2387,124300,0.0000,4,440,0.0000,0,0
2021-02-01,Brazil,203070494,Pernambuco,9058931,0.0153,14241,138541,0.0001,58,498,0.0000,0,0
2021-02-02,Brazil,203070494,Pernambuco,9058931,0.0168,13876,152417,0.0001,395,893,0.0000,0,0
2021-02-03,Brazil,203070494,Pernambuco,9058931,0.0182,12464,164881,0.0003,1721,2614,0.0000,0,0
2021-02-04,Brazil,203070494,Pernambuco,9058931,0.0193,9942,174823,0.0006,2749,5363,0.0000,0,0
2021-02-05,Brazil,203070494,Pernambuco,9058931,0.0203,8883,183706,0.0008,2085,7448,0.0000,0,0
2021-02-06,Brazil,203070494,Pernambuco,9058931,0.0205,1656,185362,0.0008,139,7587,0.0000,0,0
2021-02-07,Brazil,203070494,Pernambuco,9058931,0.0205,493,185855,0.0008,87,7674,0.0000,0,0
2021-02-08,Brazil,203070494,Pernambuco,9058931,0.0211,5455,191310,0.0013,4253,11927,0.0000,0,0
2021-02-09,Brazil,203070494,Pernambuco,9058931,0.0221,8568,199878,0.0019,5047,16974,0.0000,0,0
2021-02-10,Brazil,203070494,Pernambuco,9058931,0.0233,11214,211092,0.0026,6579,23553,0.0000,0,0
2021-02-11,Brazil,203070494,Pernambuco,9058931,0.0245,10437,221529,0.0037,9639,33192,0.0000,1,1
2021-02-12,Brazil,203070494,Pernambuco,9058931,0.0256,10434,231963,0.0046,8530,41722,0.0000,1,2
2021-02-13,Brazil,203070494,Pernambuco,9058931,0.0261,4146,236109,0.0048,2049,43771,0.0000,0,2
2021-02-14,Brazil,203070494,Pernambuco,9058931,0.0264,3012,239121,0.0049,721,44492,0.0000,0,2
2021-02-15,Brazil,203070494,Pernambuco,9058931,0.0270,5773,244894,0.0057,6806,51298,0.0000,0,2
2021-02-16,Brazil,203070494,Pernambuco,9058931,0.0275,4646,249540,0.0064,6840,58138,0.0000,0,2
2021-02-17,Brazil,203070494,Pernambuco,9058931,0.0281,5359,254899,0.0072,6650,64788,0.0000,0,2
2021-02-18,Brazil,203070494,Pernambuco,9058931,0.0288,5726,260625,0.0083,10383,75171,0.0000,0,2
2021-02-19,Brazil,203070494,Pernambuco,9058931,0.0293,4631,265256,0.0092,8294,83465,0.0000,0,2
2021-02-20,Brazil,203070494,Pernambuco,9058931,0.0294,750,266006,0.0094,1678,85143,0.0000,0,2
2021-02-21,Brazil,203070494,Pernambuco,9058931,0.0296,1841,267847,0.0095,597,85740,0.0000,0,2
2021-02-22,Brazil,203070494,Pernambuco,9058931,0.0300,4266,272113,0.0103,7262,93002,0.0000,0,2
2021-02-23,Brazil,203070494,Pernambuco,9058931,0.0306,5192,277305,0.0110,6725,99727,0.0000,0,2
2021-02-24,Brazil,203070494,Pernambuco,9058931,0.0310,3570,280875,0.0117,6050,105777,0.0000,0,2
2021-02-25,Brazil,203070494,Pernambuco,9058931,0.0316,5781,286656,0.0123,5621,111398,0.0000,0,2
2021-02-26,Brazil,203070494,Pernambuco,9058931,0.0329,11753,298409,0.0129,5331,116729,0.0000,0,2
2021-02-27,Brazil,203070494,Pernambuco,9058931,0.0336,6132,304541,0.0130,640,117369,0.0000,0,2
2021-02-28,Brazil,203070494,Pernambuco,9058931,0.0342,5035,309576,0.0130,500,117869,0.0000,0,2
2021-03-01,Brazil,203070494,Pernambuco,9058931,0.0358,14719,324295,0.0134,3384,121253,0.0000,0,2
2021-03-02,Brazil,203070494,Pernambuco,9058931,0.0376,16064,340359,0.0140,5603,126856,0.0000,0,2
2021-03-03,Brazil,203070494,Pernambuco,9058931,0.0392,14320,354679,0.0148,7210,134066,0.0000,0,2
2021-03-04,Brazil,203070494,Pernambuco,9058931,0.0408,14535,369214,0.0155,6290,140356,0.0000,0,2
2021-03-05,Brazil,203070494,Pernambuco,9058931,0.0423,13650,382864,0.0162,6488,146844,0.0000,0,2
2021-03-06,Brazil,203070494,Pernambuco,9058931,0.0430,6459,389323,0.0165,2859,149703,0.0000,0,2
2021-03-07,Brazil,203070494,Pernambuco,9058931,0.0435,4453,393776,0.0168,2668,152371,0.0000,1,3
2021-03-08,Brazil,203070494,Pernambuco,9058931,0.0448,12162,405938,0.0173,4639,157010,0.0000,1,4
2021-03-09,Brazil,203070494,Pernambuco,9058931,0.0461,12002,417940,0.0179,4692,161702,0.0000,0,4
2021-03-10,Brazil,203070494,Pernambuco,9058931,0.0473,10597,428537,0.0184,5001,166703,0.0000,0,4
2021-03-11,Brazil,203070494,Pernambuco,9058931,0.0488,13416,441953,0.0190,5011,171714,0.0000,0,4
2021-03-12,Brazil,203070494,Pernambuco,9058931,0.0502,13253,455206,0.0195,4540,176254,0.0000,0,4
2021-03-13,Brazil,203070494,Pernambuco,9058931,0.0510,6959,462165,0.0196,1197,177451,0.0000,0,4
2021-03-14,Brazil,203070494,Pernambuco,9058931,0.0516,5286,467451,0.0198,1474,178925,0.0000,0,4
2021-03-15,Brazil,203070494,Pernambuco,9058931,0.0533,15643,483094,0.0200,2187,181112,0.0000,0,4
2021-03-16,Brazil,203070494,Pernambuco,9058931,0.0548,13592,496686,0.0204,3363,184475,0.0000,0,4
2021-03-17,Brazil,203070494,Pernambuco,9058931,0.0560,10642,507328,0.0208,4163,188638,0.0000,0,4
2021-03-18,Brazil,203070494,Pernambuco,9058931,0.0581,18630,525958,0.0213,4050,192688,0.0000,0,4
2021-03-19,Brazil,203070494,Pernambuco,9058931,0.0599,17061,543019,0.0216,3144,195832,0.0000,0,4
2021-03-20,Brazil,203070494,Pernambuco,9058931,0.0609,8970,551989,0.0218,1308,197140,0.0000,0,4
2021-03-21,Brazil,203070494,Pernambuco,9058931,0.0613,3118,555107,0.0219,1000,198140,0.0000,0,4
2021-03-22,Brazil,203070494,Pernambuco,9058931,0.0650,33571,588678,0.0221,2324,200464,0.0000,1,5
2021-03-23,Brazil,203070494,Pernambuco,9058931,0.0705,49896,638574,0.0225,3391,203855,0.0000,0,5
2021-03-24,Brazil,203070494,Pernambuco,9058931,0.0756,46356,684930,0.0229,3630,207485,0.0000,0,5
2021-03-25,Brazil,203070494,Pernambuco,9058931,0.0802,41298,726228,0.0235,5161,212646,0.0000,0,5
2021-03-26,Brazil,203070494,Pernambuco,9058931,0.0840,34678,760906,0.0241,5854,218500,0.0000,0,5
2021-03-27,Brazil,203070494,Pernambuco,9058931,0.0860,18041,778947,0.0245,3839,222339,0.0000,0,5
2021-03-28,Brazil,203070494,Pernambuco,9058931,0.0867,6788,785735,0.0250,3960,226299,0.0000,0,5
2021-03-29,Brazil,203070494,Pernambuco,9058931,0.0920,47628,833363,0.0257,6177,232476,0.0000,0,5
2021-03-30,Brazil,203070494,Pernambuco,9058931,0.0977,51868,885231,0.0265,7390,239866,0.0000,0,5
2021-03-31,Brazil,203070494,Pernambuco,9058931,0.1018,37368,922599,0.0274,8790,248656,0.0000,0,5
2021-04-01,Brazil,203070494,Pernambuco,9058931,0.1036,16041,938640,0.0282,6411,255067,0.0000,0,5
2021-04-02,Brazil,203070494,Pernambuco,9058931,0.1044,7188,945828,0.0286,3857,258924,0.0000,0,5
2021-04-03,Brazil,203070494,Pernambuco,9058931,0.1055,10034,955862,0.0292,5680,264604,0.0000,0,5
2021-04-04,Brazil,203070494,Pernambuco,9058931,0.1059,3845,959707,0.0298,5716,270320,0.0000,0,5
2021-04-05,Brazil,203070494,Pernambuco,9058931,0.1093,30153,989860,0.0313,12884,283204,0.0000,0,5
2021-04-06,Brazil,203070494,Pernambuco,9058931,0.1127,31247,1021107,0.0325,11072,294276,0.0000,0,5
2021-04-07,Brazil,203070494,Pernambuco,9058931,0.1158,27675,1048782,0.0338,11852,306128,0.0000,0,5
2021-04-08,Brazil,203070494,Pernambuco,9058931,0.1183,22639,1071421,0.0357,17641,323769,0.0000,1,6
2021-04-09,Brazil,203070494,Pernambuco,9058931,0.1204,18874,1090295,0.0375,15747,339516,0.0000,0,6
2021-04-10,Brazil,203070494,Pernambuco,9058931,0.1217,12589,1102884,0.0382,6561,346077,0.0000,0,6
2021-04-11,Brazil,203070494,Pernambuco,9058931,0.1223,4726,1107610,0.0385,3078,349155,0.0000,0,6
2021-04-12,Brazil,203070494,Pernambuco,9058931,0.1242,17566,1125176,0.0408,20327,369482,0.0000,0,6
2021-04-13,Brazil,203070494,Pernambuco,9058931,0.1260,16317,1141493,0.0433,22984,392466,0.0000,0,6
2021-04-14,Brazil,203070494,Pernambuco,9058931,0.1275,13734,1155227,0.0457,21675,414141,0.0000,1,7
2021-04-15,Brazil,203070494,Pernambuco,9058931,0.1290,13384,1168611,0.0483,22984,437125,0.0000,0,7
2021-04-16,Brazil,203070494,Pernambuco,9058931,0.1305,13784,1182395,0.0503,18773,455898,0.0000,0,7
2021-04-17,Brazil,203070494,Pernambuco,9058931,0.1319,12130,1194525,0.0511,6901,462799,0.0000,1,8
2021-04-18,Brazil,203070494,Pernambuco,9058931,0.1322,3350,1197875,0.0516,4879,467678,0.0000,0,8
2021-04-19,Brazil,203070494,Pernambuco,9058931,0.1350,25493,1223368,0.0550,30341,498019,0.0000,0,8
2021-04-20,Brazil,203070494,Pernambuco,9058931,0.1383,29823,1253191,0.0591,37173,535192,0.0000,0,8
2021-04-21,Brazil,203070494,Pernambuco,9058931,0.1394,9206,1262397,0.0604,12242,547434,0.0000,1,9
2021-04-22,Brazil,203070494,Pernambuco,9058931,0.1418,22493,1284890,0.0644,36133,583567,0.0000,0,9
2021-04-23,Brazil,203070494,Pernambuco,9058931,0.1437,17078,1301968,0.0673,25680,609247,0.0000,0,9
2021-04-24,Brazil,203070494,Pernambuco,9058931,0.1445,7168,1309136,0.0685,10995,620242,0.0000,0,9
2021-04-25,Brazil,203070494,Pernambuco,9058931,0.1449,3413,1312549,0.0692,6215,626457,0.0000,1,10
2021-04-26,Brazil,203070494,Pernambuco,9058931,0.1471,19598,1332147,0.0725,30008,656465,0.0000,0,10
2021-04-27,Brazil,203070494,Pernambuco,9058931,0.1492,19477,1351624,0.0758,29780,686245,0.0000,0,10
2021-04-28,Brazil,203070494,Pernambuco,9058931,0.1509,15180,1366804,0.0787,26256,712501,0.0000,0,10
2021-04-29,Brazil,203070494,Pernambuco,9058931,0.1526,15160,1381964,0.0805,16657,729158,0.0000,0,10
2021-04-30,Brazil,203070494,Pernambuco,9058931,0.1541,13626,1395590,0.0818,11884,741042,0.0000,0,10
2021-05-01,Brazil,203070494,Pernambuco,9058931,0.1549,8033,1403623,0.0820,1846,742888,0.0000,0,10
2021-05-02,Brazil,203070494,Pernambuco,9058931,0.1558,7309,1410932,0.0821,758,743646,0.0000,0,10
2021-05-03,Brazil,203070494,Pernambuco,9058931,0.1574,15276,1426208,0.0837,14795,758441,0.0000,0,10
2021-05-04,Brazil,203070494,Pernambuco,9058931,0.1597,20336,1446544,0.0852,13552,771993,0.0000,0,10
2021-05-05,Brazil,203070494,Pernambuco,9058931,0.1620,21126,1467670,0.0863,10157,782150,0.0000,0,10
2021-05-06,Brazil,203070494,Pernambuco,9058931,0.1645,22477,1490147,0.0872,7612,789762,0.0000,0,10
2021-05-07,Brazil,203070494,Pernambuco,9058931,0.1669,21907,1512054,0.0878,5703,795465,0.0000,0,10
2021-05-08,Brazil,203070494,Pernambuco,9058931,0.1683,12855,1524909,0.0880,1900,797365,0.0000,0,10
2021-05-09,Brazil,203070494,Pernambuco,9058931,0.1690,5762,1530671,0.0881,303,797668,0.0000,0,10
2021-05-10,Brazil,203070494,Pernambuco,9058931,0.1709,17050,1547721,0.0895,12746,810414,0.0000,0,10
2021-05-11,Brazil,203070494,Pernambuco,9058931,0.1730,19893,1567614,0.0908,11807,822221,0.0000,0,10
2021-05-12,Brazil,203070494,Pernambuco,9058931,0.1751,18429,1586043,0.0921,12406,834627,0.0000,0,10
2021-05-13,Brazil,203070494,Pernambuco,9058931,0.1770,17325,1603368,0.0927,5284,839911,0.0000,0,10
2021-05-14,Brazil,203070494,Pernambuco,9058931,0.1787,15560,1618928,0.0938,9537,849448,0.0000,0,10
2021-05-15,Brazil,203070494,Pernambuco,9058931,0.1798,9644,1628572,0.0948,9369,858817,0.0000,0,10
2021-05-16,Brazil,203070494,Pernambuco,9058931,0.1804,5525,1634097,0.0955,6312,865129,0.0000,1,11
2021-05-17,Brazil,203070494,Pernambuco,9058931,0.1822,16891,1650988,0.0972,15154,880283,0.0000,0,11
2021-05-18,Brazil,203070494,Pernambuco,9058931,0.1846,20951,1671939,0.0984,10960,891243,0.0000,0,11
2021-05-19,Brazil,203070494,Pernambuco,9058931,0.1870,22258,1694197,0.0993,7957,899200,0.0000,0,11
2021-05-20,Brazil,203070494,Pernambuco,9058931,0.1897,24531,1718728,0.1000,6984,906184,0.0000,0,11
2021-05-21,Brazil,203070494,Pernambuco,9058931,0.1924,23820,1742548,0.1009,8161,914345,0.0000,2,13
2021-05-22,Brazil,203070494,Pernambuco,9058931,0.1937,12041,1754589,0.1016,6205,920550,0.0000,0,13
2021-05-23,Brazil,203070494,Pernambuco,9058931,0.1943,5430,1760019,0.1020,3344,923894,0.0000,0,13
2021-05-24,Brazil,203070494,Pernambuco,9058931,0.1962,17646,1777665,0.1033,11563,935457,0.0000,0,13
2021-05-25,Brazil,203070494,Pernambuco,9058931,0.1988,23292,1800957,0.1045,10896,946353,0.0000,0,13
2021-05-26,Brazil,203070494,Pernambuco,9058931,0.2016,25602,1826559,0.1056,10158,956511,0.0000,0,13
2021-05-27,Brazil,203070494,Pernambuco,9058931,0.2046,26712,1853271,0.1065,7882,964393,0.0000,0,13
2021-05-28,Brazil,203070494,Pernambuco,9058931,0.2078,29210,1882481,0.1071,5574,969967,0.0000,0,13
2021-05-29,Brazil,203070494,Pernambuco,9058931,0.2094,14450,1896931,0.1073,2141,972108,0.0000,0,13
2021-05-30,Brazil,203070494,Pernambuco,9058931,0.2103,7940,1904871,0.1074,1168,973276,0.0000,0,13
2021-05-31,Brazil,203070494,Pernambuco,9058931,0.2138,32284,1937155,0.1078,3597,976873,0.0000,0,13
2021-06-01,Brazil,203070494,Pernambuco,9058931,0.2192,48396,1985551,0.1086,7277,984150,0.0000,0,13
2021-06-02,Brazil,203070494,Pernambuco,9058931,0.2255,57088,2042639,0.1096,8894,993044,0.0000,0,13
2021-06-03,Brazil,203070494,Pernambuco,9058931,0.2288,29771,2072410,0.1100,3634,996678,0.0000,0,13
2021-06-04,Brazil,203070494,Pernambuco,9058931,0.2338,45299,2117709,0.1108,6961,1003639,0.0000,0,13
2021-06-05,Brazil,203070494,Pernambuco,9058931,0.2372,30990,2148699,0.1109,1066,1004705,0.0000,0,13
2021-06-06,Brazil,203070494,Pernambuco,9058931,0.2385,12225,2160924,0.1109,294,1004999,0.0000,0,13
2021-06-07,Brazil,203070494,Pernambuco,9058931,0.2453,60819,2221743,0.1116,6146,1011145,0.0000,0,13
2021-06-08,Brazil,203070494,Pernambuco,9058931,0.2520,60716,2282459,0.1122,5567,1016712,0.0000,0,13
2021-06-09,Brazil,203070494,Pernambuco,9058931,0.2588,62058,2344517,0.1127,3824,1020536,0.0000,0,13
2021-06-10,Brazil,203070494,Pernambuco,9058931,0.2653,59224,2403741,0.1131,3665,1024201,0.0000,0,13
2021-06-11,Brazil,203070494,Pernambuco,9058931,0.2718,58336,2462077,0.1134,2968,1027169,0.0000,0,13
2021-06-12,Brazil,203070494,Pernambuco,9058931,0.2753,32182,2494259,0.1134,380,1027549,0.0000,0,13
2021-06-13,Brazil,203070494,Pernambuco,9058931,0.2771,16198,2510457,0.1134,153,1027702,0.0000,0,13
2021-06-14,Brazil,203070494,Pernambuco,9058931,0.2843,65450,2575907,0.1137,1877,1029579,0.0000,0,13
2021-06-15,Brazil,203070494,Pernambuco,9058931,0.2923,72340,2648247,0.1139,2637,1032216,0.0000,0,13
2021-06-16,Brazil,203070494,Pernambuco,9058931,0.2995,64737,2712984,0.1142,2478,1034694,0.0000,0,13
2021-06-17,Brazil,203070494,Pernambuco,9058931,0.3057,56569,2769553,0.1146,3141,1037835,0.0000,0,13
2021-06-18,Brazil,203070494,Pernambuco,9058931,0.3112,49302,2818855,0.1147,1415,1039250,0.0000,0,13
2021-06-19,Brazil,203070494,Pernambuco,9058931,0.3143,28578,2847433,0.1166,17382,1056632,0.0000,0,13
2021-06-20,Brazil,203070494,Pernambuco,9058931,0.3156,11332,2858765,0.1173,5917,1062549,0.0000,0,13
2021-06-21,Brazil,203070494,Pernambuco,9058931,0.3206,45310,2904075,0.1178,4438,1066987,0.0000,0,13
2021-06-22,Brazil,203070494,Pernambuco,9058931,0.3251,40577,2944652,0.1184,5731,1072718,0.0000,0,13
2021-06-23,Brazil,203070494,Pernambuco,9058931,0.3288,34042,2978694,0.1188,3125,1075843,0.0000,0,13
2021-06-24,Brazil,203070494,Pernambuco,9058931,0.3301,11865,2990559,0.1188,803,1076646,0.0000,0,13
2021-06-25,Brazil,203070494,Pernambuco,9058931,0.3329,25275,3015834,0.1191,2481,1079127,0.0000,0,13
2021-06-26,Brazil,203070494,Pernambuco,9058931,0.3355,23441,3039275,0.1193,1284,1080411,0.0000,0,13
2021-06-27,Brazil,203070494,Pernambuco,9058931,0.3370,13321,3052596,0.1193,648,1081059,0.0000,0,13
2021-06-28,Brazil,203070494,Pernambuco,9058931,0.3422,47284,3099880,0.1198,4494,1085553,0.0000,0,13
2021-06-29,Brazil,203070494,Pernambuco,9058931,0.3478,50935,3150815,0.1205,5621,1091174,0.0000,0,13
2021-06-30,Brazil,203070494,Pernambuco,9058931,0.3542,57710,3208525,0.1212,6775,1097949,0.0000,0,13
2021-07-01,Brazil,203070494,Pernambuco,9058931,0.3598,51057,3259582,0.1219,6376,1104325,0.0000,0,13
2021-07-02,Brazil,203070494,Pernambuco,9058931,0.3653,49488,3309070,0.1223,3638,1107963,0.0000,0,13
2021-07-03,Brazil,203070494,Pernambuco,9058931,0.3686,30486,3339556,0.1225,1348,1109311,0.0000,0,13
2021-07-04,Brazil,203070494,Pernambuco,9058931,0.3699,11479,3351035,0.1226,1303,1110614,0.0000,0,13
2021-07-05,Brazil,203070494,Pernambuco,9058931,0.3754,49417,3400452,0.1233,5996,1116610,0.0000,0,13
2021-07-06,Brazil,203070494,Pernambuco,9058931,0.3833,71732,3472184,0.1239,5356,1121966,0.0000,0,13
2021-07-07,Brazil,203070494,Pernambuco,9058931,0.3911,70566,3542750,0.1246,6728,1128694,0.0000,0,13
2021-07-08,Brazil,203070494,Pernambuco,9058931,0.3982,64618,3607368,0.1257,10094,1138788,0.0000,0,13
2021-07-09,Brazil,203070494,Pernambuco,9058931,0.4037,49699,3657067,0.1272,13107,1151895,0.0000,0,13
2021-07-10,Brazil,203070494,Pernambuco,9058931,0.4074,33438,3690505,0.1280,8052,1159947,0.0000,0,13
2021-07-11,Brazil,203070494,Pernambuco,9058931,0.4087,12254,3702759,0.1286,4999,1164946,0.0000,0,13
2021-07-12,Brazil,203070494,Pernambuco,9058931,0.4143,50574,3753333,0.1311,23129,1188075,0.0000,0,13
2021-07-13,Brazil,203070494,Pernambuco,9058931,0.4198,49376,3802709,0.1340,25517,1213592,0.0000,0,13
2021-07-14,Brazil,203070494,Pernambuco,9058931,0.4242,40054,3842763,0.1364,21870,1235462,0.0000,0,13
2021-07-15,Brazil,203070494,Pernambuco,9058931,0.4275,30160,3872923,0.1394,27539,1263001,0.0000,0,13
2021-07-16,Brazil,203070494,Pernambuco,9058931,0.4309,30208,3903131,0.1418,21274,1284275,0.0000,0,13
2021-07-17,Brazil,203070494,Pernambuco,9058931,0.4336,24776,3927907,0.1429,10088,1294363,0.0000,0,13
2021-07-18,Brazil,203070494,Pernambuco,9058931,0.4346,9443,3937350,0.1434,4784,1299147,0.0000,0,13
2021-07-19,Brazil,203070494,Pernambuco,9058931,0.4396,44920,3982270,0.1462,25198,1324345,0.0000,1,14
2021-07-20,Brazil,203070494,Pernambuco,9058931,0.4445,44490,4026760,0.1493,28467,1352812,0.0000,0,14
2021-07-21,Brazil,203070494,Pernambuco,9058931,0.4496,45848,4072608,0.1522,25889,1378701,0.0000,0,14
2021-07-22,Brazil,203070494,Pernambuco,9058931,0.4556,54261,4126869,0.1549,24259,1402960,0.0000,0,14
2021-07-23,Brazil,203070494,Pernambuco,9058931,0.4611,50414,4177283,0.1570,19104,1422064,0.0000,0,14
2021-07-24,Brazil,203070494,Pernambuco,9058931,0.4639,25136,4202419,0.1580,9134,1431198,0.0000,0,14
2021-07-25,Brazil,203070494,Pernambuco,9058931,0.4650,10013,4212432,0.1585,4363,1435561,0.0000,0,14
2021-07-26,Brazil,203070494,Pernambuco,9058931,0.4691,37306,4249738,0.1607,20550,1456111,0.0000,0,14
2021-07-27,Brazil,203070494,Pernambuco,9058931,0.4738,42133,4291871,0.1634,24406,1480517,0.0000,0,14
2021-07-28,Brazil,203070494,Pernambuco,9058931,0.4779,36950,4328821,0.1657,20820,1501337,0.0000,0,14
2021-07-29,Brazil,203070494,Pernambuco,9058931,0.4820,37323,4366144,0.1680,20880,1522217,0.0000,0,14
2021-07-30,Brazil,203070494,Pernambuco,9058931,0.4862,37933,4404077,0.1706,23347,1545564,0.0000,1,15
2021-07-31,Brazil,203070494,Pernambuco,9058931,0.4881,17822,4421899,0.1717,9924,1555488,0.0000,0,15
2021-08-01,Brazil,203070494,Pernambuco,9058931,0.4890,7784,4429683,0.1725,7529,1563017,0.0000,0,15
2021-08-02,Brazil,203070494,Pernambuco,9058931,0.4934,40100,4469783,0.1754,25868,1588885,0.0000,0,15
2021-08-03,Brazil,203070494,Pernambuco,9058931,0.4994,54674,4524457,0.1784,26936,1615821,0.0000,0,15
2021-08-04,Brazil,203070494,Pernambuco,9058931,0.5052,51858,4576315,0.1812,25281,1641102,0.0000,0,15
2021-08-05,Brazil,203070494,Pernambuco,9058931,0.5105,48286,4624601,0.1839,25228,1666330,0.0000,0,15
2021-08-06,Brazil,203070494,Pernambuco,9058931,0.5155,45649,4670250,0.1870,27906,1694236,0.0000,0,15
2021-08-07,Brazil,203070494,Pernambuco,9058931,0.5182,24314,4694564,0.1887,14754,1708990,0.0000,0,15
2021-08-08,Brazil,203070494,Pernambuco,9058931,0.5194,10675,4705239,0.1895,7331,1716321,0.0000,0,15
2021-08-09,Brazil,203070494,Pernambuco,9058931,0.5243,43988,4749227,0.1933,34624,1750945,0.0000,0,15
2021-08-10,Brazil,203070494,Pernambuco,9058931,0.5311,61985,4811212,0.1974,36952,1787897,0.0000,0,15
2021-08-11,Brazil,203070494,Pernambuco,9058931,0.5378,60521,4871733,0.2013,35474,1823371,0.0000,1,16
2021-08-12,Brazil,203070494,Pernambuco,9058931,0.5440,56122,4927855,0.2050,33787,1857158,0.0000,0,16
2021-08-13,Brazil,203070494,Pernambuco,9058931,0.5501,55128,4982983,0.2084,30746,1887904,0.0000,1,17
2021-08-14,Brazil,203070494,Pernambuco,9058931,0.5531,27079,5010062,0.2098,12778,1900682,0.0000,0,17
2021-08-15,Brazil,203070494,Pernambuco,9058931,0.5548,15600,5025662,0.2108,8560,1909242,0.0000,0,17
2021-08-16,Brazil,203070494,Pernambuco,9058931,0.5602,49436,5075098,0.2155,42523,1951765,0.0000,0,17
2021-08-17,Brazil,203070494,Pernambuco,9058931,0.5679,69247,5144345,0.2201,42489,1994254,0.0000,0,17
2021-08-18,Brazil,203070494,Pernambuco,9058931,0.5746,61268,5205613,0.2245,39368,2033622,0.0000,0,17
2021-08-19,Brazil,203070494,Pernambuco,9058931,0.5805,53500,5259113,0.2288,39196,2072818,0.0000,1,18
2021-08-20,Brazil,203070494,Pernambuco,9058931,0.5859,48586,5307699,0.2327,35065,2107883,0.0000,0,18
2021-08-21,Brazil,203070494,Pernambuco,9058931,0.5903,39430,5347129,0.2343,14580,2122463,0.0000,1,19
2021-08-22,Brazil,203070494,Pernambuco,9058931,0.5921,16390,5363519,0.2354,10079,2132542,0.0000,0,19
2021-08-23,Brazil,203070494,Pernambuco,9058931,0.5974,47906,5411425,0.2389,32051,2164593,0.0000,0,19
2021-08-24,Brazil,203070494,Pernambuco,9058931,0.6048,67424,5478849,0.2428,35047,2199640,0.0000,1,20
2021-08-25,Brazil,203070494,Pernambuco,9058931,0.6111,57461,5536310,0.2473,40629,2240269,0.0000,0,20
2021-08-26,Brazil,203070494,Pernambuco,9058931,0.6182,63481,5599791,0.2519,41607,2281876,0.0000,0,20
2021-08-27,Brazil,203070494,Pernambuco,9058931,0.6233,46671,5646462,0.2558,35253,2317129,0.0000,0,20
2021-08-28,Brazil,203070494,Pernambuco,9058931,0.6268,31299,5677761,0.2575,15222,2332351,0.0000,0,20
2021-08-29,Brazil,203070494,Pernambuco,9058931,0.6289,19409,5697170,0.2580,5112,2337463,0.0000,0,20
2021-08-30,Brazil,203070494,Pernambuco,9058931,0.6344,50082,5747252,0.2621,36903,2374366,0.0000,0,20
2021-08-31,Brazil,203070494,Pernambuco,9058931,0.6401,51635,5798887,0.2661,36428,2410794,0.0000,0,20
2021-09-01,Brazil,203070494,Pernambuco,9058931,0.6460,53007,5851894,0.2706,40102,2450896,0.0000,1,21
2021-09-02,Brazil,203070494,Pernambuco,9058931,0.6511,46013,5897907,0.2752,42480,2493376,0.0000,1,22
2021-09-03,Brazil,203070494,Pernambuco,9058931,0.6556,40847,5938754,0.2790,33956,2527332,0.0000,1,23
2021-09-04,Brazil,203070494,Pernambuco,9058931,0.6587,28669,5967423,0.2804,12667,2539999,0.0000,0,23
2021-09-05,Brazil,203070494,Pernambuco,9058931,0.6602,13301,5980724,0.2813,7884,2547883,0.0000,0,23
2021-09-06,Brazil,203070494,Pernambuco,9058931,0.6627,22995,6003719,0.2834,19555,2567438,0.0000,1,24
2021-09-07,Brazil,203070494,Pernambuco,9058931,0.6641,11877,6015596,0.2843,7585,2575023,0.0000,1,25
2021-09-08,Brazil,203070494,Pernambuco,9058931,0.6688,43171,6058767,0.2904,56136,2631159,0.0000,4,29
2021-09-09,Brazil,203070494,Pernambuco,9058931,0.6733,40278,6099045,0.2965,55203,2686362,0.0000,63,92
2021-09-10,Brazil,203070494,Pernambuco,9058931,0.6773,36574,6135619,0.3011,41059,2727421,0.0000,105,197
2021-09-11,Brazil,203070494,Pernambuco,9058931,0.6796,21236,6156855,0.3029,16293,2743714,0.0000,33,230
2021-09-12,Brazil,203070494,Pernambuco,9058931,0.6813,15297,6172152,0.3039,8922,2752636,0.0000,81,311
2021-09-13,Brazil,203070494,Pernambuco,9058931,0.6853,36068,6208220,0.3093,49533,2802169,0.0001,186,497
2021-09-14,Brazil,203070494,Pernambuco,9058931,0.6896,38886,6247106,0.3155,55673,2857842,0.0001,73,570
2021-09-15,Brazil,203070494,Pernambuco,9058931,0.6941,40854,6287960,0.3216,55819,2913661,0.0001,95,665
2021-09-16,Brazil,203070494,Pernambuco,9058931,0.6984,39241,6327201,0.3274,51805,2965466,0.0001,260,925
2021-09-17,Brazil,203070494,Pernambuco,9058931,0.7026,37895,6365096,0.3322,43749,3009215,0.0001,83,1008
2021-09-18,Brazil,203070494,Pernambuco,9058931,0.7047,18851,6383947,0.3342,18364,3027579,0.0001,76,1084
2021-09-19,Brazil,203070494,Pernambuco,9058931,0.7065,16238,6400185,0.3353,9934,3037513,0.0002,365,1449
2021-09-20,Brazil,203070494,Pernambuco,9058931,0.7092,24293,6424478,0.3408,49931,3087444,0.0003,991,2440
2021-09-21,Brazil,203070494,Pernambuco,9058931,0.7123,28277,6452755,0.3473,59027,3146471,0.0004,1319,3759
2021-09-22,Brazil,203070494,Pernambuco,9058931,0.7153,26814,6479569,0.3538,58302,3204773,0.0006,1523,5282
2021-09-23,Brazil,203070494,Pernambuco,9058931,0.7182,26988,6506557,0.3593,50275,3255048,0.0007,1274,6556
2021-09-24,Brazil,203070494,Pernambuco,9058931,0.7207,22450,6529007,0.3640,42278,3297326,0.0009,1800,8356
2021-09-25,Brazil,203070494,Pernambuco,9058931,0.7232,22430,6551437,0.3720,72953,3370279,0.0011,1707,10063
2021-09-26,Brazil,203070494,Pernambuco,9058931,0.7240,7294,6558731,0.3733,11800,3382079,0.0013,1263,11326
2021-09-27,Brazil,203070494,Pernambuco,9058931,0.7260,18055,6576786,0.3782,44446,3426525,0.0015,2549,13875
2021-09-28,Brazil,203070494,Pernambuco,9058931,0.7287,24731,6601517,0.3840,52163,3478688,0.0018,2305,16180
2021-09-29,Brazil,203070494,Pernambuco,9058931,0.7315,25191,6626708,0.3896,51089,3529777,0.0020,1971,18151
2021-09-30,Brazil,203070494,Pernambuco,9058931,0.7341,23829,6650537,0.3953,51057,3580834,0.0022,2104,20255
2021-10-01,Brazil,203070494,Pernambuco,9058931,0.7363,19966,6670503,0.3999,41541,3622375,0.0025,2254,22509
2021-10-02,Brazil,203070494,Pernambuco,9058931,0.7376,11635,6682138,0.4019,18529,3640904,0.0028,3208,25717
2021-10-03,Brazil,203070494,Pernambuco,9058931,0.7387,9890,6692028,0.4033,12812,3653716,0.0032,3123,28840
2021-10-04,Brazil,203070494,Pernambuco,9058931,0.7405,16301,6708329,0.4082,44000,3697716,0.0035,2909,31749
2021-10-05,Brazil,203070494,Pernambuco,9058931,0.7427,19651,6727980,0.4141,53858,3751574,0.0039,3465,35214
2021-10-06,Brazil,203070494,Pernambuco,9058931,0.7445,16647,6744627,0.4200,52911,3804485,0.0043,4148,39362
2021-10-07,Brazil,203070494,Pernambuco,9058931,0.7467,19517,6764144,0.4257,52062,3856547,0.0048,3811,43173
2021-10-08,Brazil,203070494,Pernambuco,9058931,0.7481,13239,6777383,0.4309,46699,3903246,0.0051,3053,46226
2021-10-09,Brazil,203070494,Pernambuco,9058931,0.7489,7068,6784451,0.4331,19937,3923183,0.0055,3420,49646
2021-10-10,Brazil,203070494,Pernambuco,9058931,0.7491,1898,6786349,0.4344,12107,3935290,0.0058,2914,52560
2021-10-11,Brazil,203070494,Pernambuco,9058931,0.7496,4474,6790823,0.4370,23549,3958839,0.0062,3910,56470
2021-10-12,Brazil,203070494,Pernambuco,9058931,0.7499,2095,6792918,0.4380,8640,3967479,0.0067,3793,60263
2021-10-13,Brazil,203070494,Pernambuco,9058931,0.7512,11959,6804877,0.4440,54363,4021842,0.0072,4953,65216
2021-10-14,Brazil,203070494,Pernambuco,9058931,0.7526,13110,6817987,0.4502,56291,4078133,0.0077,4729,69945
2021-10-15,Brazil,203070494,Pernambuco,9058931,0.7540,12691,6830678,0.4549,42580,4120713,0.0081,3712,73657
2021-10-16,Brazil,203070494,Pernambuco,9058931,0.7553,11365,6842043,0.4580,28020,4148733,0.0085,3503,77160
2021-10-17,Brazil,203070494,Pernambuco,9058931,0.7558,4603,6846646,0.4594,13283,4162016,0.0088,2587,79747
2021-10-18,Brazil,203070494,Pernambuco,9058931,0.7572,13188,6859834,0.4645,45955,4207971,0.0092,3610,83357
2021-10-19,Brazil,203070494,Pernambuco,9058931,0.7587,13538,6873372,0.4706,55548,4263519,0.0096,3767,87124
2021-10-20,Brazil,203070494,Pernambuco,9058931,0.7613,23416,6896788,0.4768,56037,4319556,0.0100,3141,90265
2021-10-21,Brazil,203070494,Pernambuco,9058931,0.7637,21116,6917904,0.4826,52091,4371647,0.0103,3228,93493
2021-10-22,Brazil,203070494,Pernambuco,9058931,0.7653,14971,6932875,0.4874,43332,4414979,0.0106,2815,96308
2021-10-23,Brazil,203070494,Pernambuco,9058931,0.7659,5560,6938435,0.4901,24611,4439590,0.0109,2683,98991
2021-10-24,Brazil,203070494,Pernambuco,9058931,0.7663,3010,6941445,0.4915,12841,4452431,0.0112,2846,101837
2021-10-25,Brazil,203070494,Pernambuco,9058931,0.7678,13738,6955183,0.4961,42066,4494497,0.0116,3614,105451
2021-10-26,Brazil,203070494,Pernambuco,9058931,0.7695,15340,6970523,0.5017,50422,4544919,0.0120,3271,108722
2021-10-27,Brazil,203070494,Pernambuco,9058931,0.7712,15463,6985986,0.5078,54973,4599892,0.0123,2657,111379
2021-10-28,Brazil,203070494,Pernambuco,9058931,0.7727,14079,7000065,0.5119,37071,4636963,0.0123,188,111567
2021-10-29,Brazil,203070494,Pernambuco,9058931,0.7739,10352,7010417,0.5156,34001,4670964,0.0126,2199,113766
2021-10-30,Brazil,203070494,Pernambuco,9058931,0.7742,3140,7013557,0.5177,18627,4689591,0.0128,1819,115585
2021-10-31,Brazil,203070494,Pernambuco,9058931,0.7744,1464,7015021,0.5189,10683,4700274,0.0129,1408,116993
2021-11-01,Brazil,203070494,Pernambuco,9058931,0.7746,1713,7016734,0.5201,11169,4711443,0.0131,1330,118323
2021-11-02,Brazil,203070494,Pernambuco,9058931,0.7748,2044,7018778,0.5209,7635,4719078,0.0132,1220,119543
2021-11-03,Brazil,203070494,Pernambuco,9058931,0.7758,8928,7027706,0.5260,45494,4764572,0.0134,1496,121039
2021-11-04,Brazil,203070494,Pernambuco,9058931,0.7768,9089,7036795,0.5311,46915,4811487,0.0135,1673,122712
2021-11-05,Brazil,203070494,Pernambuco,9058931,0.7778,9281,7046076,0.5353,37363,4848850,0.0137,1324,124036
2021-11-06,Brazil,203070494,Pernambuco,9058931,0.7782,3973,7050049,0.5372,17699,4866549,0.0138,1419,125455
2021-11-07,Brazil,203070494,Pernambuco,9058931,0.7785,2696,7052745,0.5382,9353,4875902,0.0140,1244,126699
2021-11-08,Brazil,203070494,Pernambuco,9058931,0.7792,6301,7059046,0.5418,32394,4908296,0.0142,1820,128519
2021-11-09,Brazil,203070494,Pernambuco,9058931,0.7800,6707,7065753,0.5460,38011,4946307,0.0144,1706,130225
2021-11-10,Brazil,203070494,Pernambuco,9058931,0.7810,9096,7074849,0.5504,39329,4985636,0.0146,2246,132471
2021-11-11,Brazil,203070494,Pernambuco,9058931,0.7823,12021,7086870,0.5551,42791,5028427,0.0150,2996,135467
2021-11-12,Brazil,203070494,Pernambuco,9058931,0.7832,8449,7095319,0.5588,33453,5061880,0.0153,3132,138599
2021-11-13,Brazil,203070494,Pernambuco,9058931,0.7835,2295,7097614,0.5601,12461,5074341,0.0156,2963,141562
2021-11-14,Brazil,203070494,Pernambuco,9058931,0.7836,1115,7098729,0.5610,7520,5081861,0.0159,2209,143771
2021-11-15,Brazil,203070494,Pernambuco,9058931,0.7837,685,7099414,0.5618,7368,5089229,0.0161,2391,146162
2021-11-16,Brazil,203070494,Pernambuco,9058931,0.7844,6233,7105647,0.5666,43125,5132354,0.0165,2960,149122
2021-11-17,Brazil,203070494,Pernambuco,9058931,0.7852,7240,7112887,0.5716,45350,5177704,0.0168,3450,152572
2021-11-18,Brazil,203070494,Pernambuco,9058931,0.7859,6927,7119814,0.5762,41950,5219654,0.0172,3600,156172
2021-11-19,Brazil,203070494,Pernambuco,9058931,0.7865,4999,7124813,0.5799,33436,5253090,0.0176,3560,159732
2021-11-20,Brazil,203070494,Pernambuco,9058931,0.7869,3665,7128478,0.5822,20715,5273805,0.0180,3453,163185
2021-11-21,Brazil,203070494,Pernambuco,9058931,0.7872,2567,7131045,0.5833,10380,5284185,0.0184,3095,166280
2021-11-22,Brazil,203070494,Pernambuco,9058931,0.7879,6397,7137442,0.5872,35619,5319804,0.0188,3851,170131
2021-11-23,Brazil,203070494,Pernambuco,9058931,0.7889,9066,7146508,0.5920,43368,5363172,0.0192,4108,174239
2021-11-24,Brazil,203070494,Pernambuco,9058931,0.7899,8893,7155401,0.5968,43027,5406199,0.0197,4595,178834
2021-11-25,Brazil,203070494,Pernambuco,9058931,0.7908,8192,7163593,0.6011,39292,5445491,0.0202,4415,183249
2021-11-26,Brazil,203070494,Pernambuco,9058931,0.7916,7025,7170618,0.6046,31795,5477286,0.0207,4307,187556
2021-11-27,Brazil,203070494,Pernambuco,9058931,0.7919,3137,7173755,0.6062,14405,5491691,0.0211,3601,191157
2021-11-28,Brazil,203070494,Pernambuco,9058931,0.7920,1228,7174983,0.6071,8346,5500037,0.0215,3531,194688
2021-11-29,Brazil,203070494,Pernambuco,9058931,0.7927,6061,7181044,0.6109,34138,5534175,0.0220,4692,199380
2021-11-30,Brazil,203070494,Pernambuco,9058931,0.7936,7850,7188894,0.6153,40021,5574196,0.0226,5266,204646
2021-12-01,Brazil,203070494,Pernambuco,9058931,0.7944,7120,7196014,0.6193,35576,5609772,0.0226,0,204646
2021-12-02,Brazil,203070494,Pernambuco,9058931,0.7952,7774,7203788,0.6229,33123,5642895,0.0226,0,204646
2021-12-03,Brazil,203070494,Pernambuco,9058931,0.7959,6501,7210289,0.6258,26108,5669003,0.0226,262,204908
2021-12-04,Brazil,203070494,Pernambuco,9058931,0.7962,2616,7212905,0.6271,11566,5680569,0.0226,178,205086
2021-12-05,Brazil,203070494,Pernambuco,9058931,0.7964,1606,7214511,0.6279,7198,5687767,0.0227,187,205273
2021-12-06,Brazil,203070494,Pernambuco,9058931,0.7973,7823,7222334,0.6309,27367,5715134,0.0227,260,205533
2021-12-07,Brazil,203070494,Pernambuco,9058931,0.7983,9700,7232034,0.6344,32039,5747173,0.0227,320,205853
2021-12-08,Brazil,203070494,Pernambuco,9058931,0.7989,5577,7237611,0.6365,19202,5766375,0.0227,0,205853
2021-12-09,Brazil,203070494,Pernambuco,9058931,0.7999,8330,7245941,0.6394,25455,5791830,0.0228,272,206125
2021-12-10,Brazil,203070494,Pernambuco,9058931,0.8006,7005,7252946,0.6414,18385,5810215,0.0228,229,206354
2021-12-11,Brazil,203070494,Pernambuco,9058931,0.8009,2562,7255508,0.6425,10190,5820405,0.0228,194,206548
2021-12-12,Brazil,203070494,Pernambuco,9058931,0.8011,1270,7256778,0.6431,5141,5825546,0.0228,96,206644
2021-12-13,Brazil,203070494,Pernambuco,9058931,0.8018,6861,7263639,0.6453,19806,5845352,0.0228,245,206889
2021-12-14,Brazil,203070494,Pernambuco,9058931,0.8027,8145,7271784,0.6478,23009,5868361,0.0229,261,207150
2021-12-15,Brazil,203070494,Pernambuco,9058931,0.8035,6918,7278702,0.6503,22650,5891011,0.0229,253,207403
2021-12-16,Brazil,203070494,Pernambuco,9058931,0.8042,6551,7285253,0.6526,20607,5911618,0.0229,261,207664
2021-12-17,Brazil,203070494,Pernambuco,9058931,0.8048,5591,7290844,0.6545,17135,5928753,0.0230,244,207908
2021-12-18,Brazil,203070494,Pernambuco,9058931,0.8050,2039,7292883,0.6553,7555,5936308,0.0230,146,208054
2021-12-19,Brazil,203070494,Pernambuco,9058931,0.8052,1075,7293958,0.6557,3978,5940286,0.0230,70,208124
2021-12-20,Brazil,203070494,Pernambuco,9058931,0.8058,5370,7299328,0.6579,19548,5959834,0.0230,261,208385
2021-12-21,Brazil,203070494,Pernambuco,9058931,0.8064,5518,7304846,0.6602,20820,5980654,0.0231,810,209195
2021-12-22,Brazil,203070494,Pernambuco,9058931,0.8069,4931,7309777,0.6623,18636,5999290,0.0232,998,210193
2021-12-23,Brazil,203070494,Pernambuco,9058931,0.8073,3761,7313538,0.6638,13835,6013125,0.0233,984,211177
2021-12-24,Brazil,203070494,Pernambuco,9058931,0.8074,655,7314193,0.6640,2191,6015316,0.0233,235,211412
2021-12-25,Brazil,203070494,Pernambuco,9058931,0.8074,182,7314375,0.6641,738,6016054,0.0233,0,211412
2021-12-26,Brazil,203070494,Pernambuco,9058931,0.8075,637,7315012,0.6643,1632,6017686,0.0234,185,211597
2021-12-27,Brazil,203070494,Pernambuco,9058931,0.8078,3193,7318205,0.6657,12758,6030444,0.0234,501,212098
2021-12-28,Brazil,203070494,Pernambuco,9058931,0.8082,3455,7321660,0.6672,13554,6043998,0.0235,740,212838
2021-12-29,Brazil,203070494,Pernambuco,9058931,0.8086,3389,7325049,0.6686,12563,6056561,0.0235,443,213281
2021-12-30,Brazil,203070494,Pernambuco,9058931,0.8088,2229,7327278,0.6695,8020,6064581,0.0236,356,213637
2021-12-31,Brazil,203070494,Pernambuco,9058931,0.8089,301,7327579,0.6696,1025,6065606,0.0236,0,213637
2021-01-04,Brazil,203070494,Piauí,3260937,0.0000,0,0,0.0000,9,9,0.0000,0,0
2021-01-09,Brazil,203070494,Piauí,3260937,0.0000,1,1,0.0000,0,9,0.0000,0,0
2021-01-10,Brazil,203070494,Piauí,3260937,0.0000,1,2,0.0000,0,9,0.0000,0,0
2021-01-15,Brazil,203070494,Piauí,3260937,0.0000,0,2,0.0000,2,11,0.0000,0,0
2021-01-17,Brazil,203070494,Piauí,3260937,0.0000,8,10,0.0000,3,14,0.0000,0,0
2021-01-18,Brazil,203070494,Piauí,3260937,0.0000,24,34,0.0000,2,16,0.0000,0,0
2021-01-19,Brazil,203070494,Piauí,3260937,0.0003,970,1004,0.0000,7,23,0.0000,0,0
2021-01-20,Brazil,203070494,Piauí,3260937,0.0017,4658,5662,0.0000,10,33,0.0000,0,0
2021-01-21,Brazil,203070494,Piauí,3260937,0.0032,4839,10501,0.0000,14,47,0.0000,0,0
2021-01-22,Brazil,203070494,Piauí,3260937,0.0043,3451,13952,0.0000,12,59,0.0000,0,0
2021-01-23,Brazil,203070494,Piauí,3260937,0.0044,241,14193,0.0000,2,61,0.0000,0,0
2021-01-24,Brazil,203070494,Piauí,3260937,0.0044,142,14335,0.0000,2,63,0.0000,0,0
2021-01-25,Brazil,203070494,Piauí,3260937,0.0053,3037,17372,0.0000,3,66,0.0000,0,0
2021-01-26,Brazil,203070494,Piauí,3260937,0.0068,4658,22030,0.0000,8,74,0.0000,0,0
2021-01-27,Brazil,203070494,Piauí,3260937,0.0087,6315,28345,0.0000,9,83,0.0000,0,0
2021-01-28,Brazil,203070494,Piauí,3260937,0.0106,6169,34514,0.0000,6,89,0.0000,0,0
2021-01-29,Brazil,203070494,Piauí,3260937,0.0120,4632,39146,0.0000,3,92,0.0000,0,0
2021-01-30,Brazil,203070494,Piauí,3260937,0.0121,258,39404,0.0000,3,95,0.0000,0,0
2021-01-31,Brazil,203070494,Piauí,3260937,0.0121,24,39428,0.0000,0,95,0.0000,0,0
2021-02-01,Brazil,203070494,Piauí,3260937,0.0131,3370,42798,0.0000,2,97,0.0000,0,0
2021-02-02,Brazil,203070494,Piauí,3260937,0.0139,2395,45193,0.0000,11,108,0.0000,0,0
2021-02-03,Brazil,203070494,Piauí,3260937,0.0146,2449,47642,0.0000,12,120,0.0000,0,0
2021-02-04,Brazil,203070494,Piauí,3260937,0.0152,1809,49451,0.0000,8,128,0.0000,0,0
2021-02-05,Brazil,203070494,Piauí,3260937,0.0156,1467,50918,0.0000,8,136,0.0000,0,0
2021-02-06,Brazil,203070494,Piauí,3260937,0.0156,30,50948,0.0000,3,139,0.0000,0,0
2021-02-07,Brazil,203070494,Piauí,3260937,0.0156,22,50970,0.0000,3,142,0.0000,0,0
2021-02-08,Brazil,203070494,Piauí,3260937,0.0160,1239,52209,0.0000,6,148,0.0000,0,0
2021-02-09,Brazil,203070494,Piauí,3260937,0.0169,2983,55192,0.0001,132,280,0.0000,0,0
2021-02-10,Brazil,203070494,Piauí,3260937,0.0179,3097,58289,0.0002,306,586,0.0000,0,0
2021-02-11,Brazil,203070494,Piauí,3260937,0.0191,3991,62280,0.0004,624,1210,0.0000,0,0
2021-02-12,Brazil,203070494,Piauí,3260937,0.0202,3730,66010,0.0006,749,1959,0.0000,0,0
2021-02-13,Brazil,203070494,Piauí,3260937,0.0203,273,66283,0.0006,19,1978,0.0000,0,0
2021-02-14,Brazil,203070494,Piauí,3260937,0.0203,34,66317,0.0006,15,1993,0.0000,0,0
2021-02-15,Brazil,203070494,Piauí,3260937,0.0209,1800,68117,0.0009,1103,3096,0.0000,0,0
2021-02-16,Brazil,203070494,Piauí,3260937,0.0212,1037,69154,0.0014,1346,4442,0.0000,0,0
2021-02-17,Brazil,203070494,Piauí,3260937,0.0214,754,69908,0.0024,3412,7854,0.0000,0,0
2021-02-18,Brazil,203070494,Piauí,3260937,0.0218,1080,70988,0.0039,4935,12789,0.0000,0,0
2021-02-19,Brazil,203070494,Piauí,3260937,0.0220,719,71707,0.0049,3165,15954,0.0000,0,0
2021-02-20,Brazil,203070494,Piauí,3260937,0.0220,78,71785,0.0049,68,16022,0.0000,0,0
2021-02-21,Brazil,203070494,Piauí,3260937,0.0220,15,71800,0.0049,15,16037,0.0000,0,0
2021-02-22,Brazil,203070494,Piauí,3260937,0.0222,649,72449,0.0056,2226,18263,0.0000,0,0
2021-02-23,Brazil,203070494,Piauí,3260937,0.0224,484,72933,0.0063,2129,20392,0.0000,0,0
2021-02-24,Brazil,203070494,Piauí,3260937,0.0225,441,73374,0.0068,1708,22100,0.0000,0,0
2021-02-25,Brazil,203070494,Piauí,3260937,0.0226,323,73697,0.0073,1814,23914,0.0000,0,0
2021-02-26,Brazil,203070494,Piauí,3260937,0.0232,1981,75678,0.0076,901,24815,0.0000,0,0
2021-02-27,Brazil,203070494,Piauí,3260937,0.0239,2136,77814,0.0076,57,24872,0.0000,0,0
2021-02-28,Brazil,203070494,Piauí,3260937,0.0242,1017,78831,0.0076,29,24901,0.0000,0,0
2021-03-01,Brazil,203070494,Piauí,3260937,0.0249,2386,81217,0.0080,1044,25945,0.0000,0,0
2021-03-02,Brazil,203070494,Piauí,3260937,0.0262,4094,85311,0.0082,710,26655,0.0000,0,0
2021-03-03,Brazil,203070494,Piauí,3260937,0.0276,4634,89945,0.0084,612,27267,0.0000,0,0
2021-03-04,Brazil,203070494,Piauí,3260937,0.0288,3935,93880,0.0086,856,28123,0.0000,0,0
2021-03-05,Brazil,203070494,Piauí,3260937,0.0305,5660,99540,0.0088,713,28836,0.0000,0,0
2021-03-06,Brazil,203070494,Piauí,3260937,0.0317,3971,103511,0.0089,348,29184,0.0000,0,0
2021-03-07,Brazil,203070494,Piauí,3260937,0.0318,72,103583,0.0090,27,29211,0.0000,0,0
2021-03-08,Brazil,203070494,Piauí,3260937,0.0331,4368,107951,0.0093,1258,30469,0.0000,0,0
2021-03-09,Brazil,203070494,Piauí,3260937,0.0344,4135,112086,0.0102,2935,33404,0.0000,0,0
2021-03-10,Brazil,203070494,Piauí,3260937,0.0355,3562,115648,0.0112,3004,36408,0.0000,0,0
2021-03-11,Brazil,203070494,Piauí,3260937,0.0364,2996,118644,0.0121,3050,39458,0.0000,0,0
2021-03-12,Brazil,203070494,Piauí,3260937,0.0378,4539,123183,0.0128,2240,41698,0.0000,0,0
2021-03-13,Brazil,203070494,Piauí,3260937,0.0383,1558,124741,0.0128,177,41875,0.0000,0,0
2021-03-14,Brazil,203070494,Piauí,3260937,0.0383,132,124873,0.0129,40,41915,0.0000,0,0
2021-03-15,Brazil,203070494,Piauí,3260937,0.0392,3025,127898,0.0132,1272,43187,0.0000,0,0
2021-03-16,Brazil,203070494,Piauí,3260937,0.0406,4470,132368,0.0136,1077,44264,0.0000,0,0
2021-03-17,Brazil,203070494,Piauí,3260937,0.0419,4104,136472,0.0139,930,45194,0.0000,0,0
2021-03-18,Brazil,203070494,Piauí,3260937,0.0424,1729,138201,0.0140,403,45597,0.0000,0,0
2021-03-19,Brazil,203070494,Piauí,3260937,0.0438,4475,142676,0.0141,446,46043,0.0000,0,0
2021-03-20,Brazil,203070494,Piauí,3260937,0.0450,4159,146835,0.0141,77,46120,0.0000,0,0
2021-03-21,Brazil,203070494,Piauí,3260937,0.0452,417,147252,0.0141,22,46142,0.0000,0,0
2021-03-22,Brazil,203070494,Piauí,3260937,0.0469,5800,153052,0.0144,806,46948,0.0000,0,0
2021-03-23,Brazil,203070494,Piauí,3260937,0.0516,15242,168294,0.0146,794,47742,0.0000,0,0
2021-03-24,Brazil,203070494,Piauí,3260937,0.0576,19396,187690,0.0148,588,48330,0.0000,0,0
2021-03-25,Brazil,203070494,Piauí,3260937,0.0654,25520,213210,0.0151,1020,49350,0.0000,0,0
2021-03-26,Brazil,203070494,Piauí,3260937,0.0694,13222,226432,0.0153,684,50034,0.0000,0,0
2021-03-27,Brazil,203070494,Piauí,3260937,0.0715,6763,233195,0.0154,143,50177,0.0000,0,0
2021-03-28,Brazil,203070494,Piauí,3260937,0.0717,525,233720,0.0154,44,50221,0.0000,0,0
2021-03-29,Brazil,203070494,Piauí,3260937,0.0775,18885,252605,0.0158,1365,51586,0.0000,0,0
2021-03-30,Brazil,203070494,Piauí,3260937,0.0847,23719,276324,0.0168,3332,54918,0.0000,0,0
2021-03-31,Brazil,203070494,Piauí,3260937,0.0901,17359,293683,0.0177,2897,57815,0.0000,0,0
2021-04-01,Brazil,203070494,Piauí,3260937,0.0930,9548,303231,0.0180,796,58611,0.0000,0,0
2021-04-02,Brazil,203070494,Piauí,3260937,0.0931,242,303473,0.0180,44,58655,0.0000,0,0
2021-04-03,Brazil,203070494,Piauí,3260937,0.0937,2079,305552,0.0181,480,59135,0.0000,0,0
2021-04-04,Brazil,203070494,Piauí,3260937,0.0942,1537,307089,0.0182,161,59296,0.0000,0,0
2021-04-05,Brazil,203070494,Piauí,3260937,0.0961,6449,313538,0.0193,3750,63046,0.0000,0,0
2021-04-06,Brazil,203070494,Piauí,3260937,0.0989,8934,322472,0.0204,3567,66613,0.0000,0,0
2021-04-07,Brazil,203070494,Piauí,3260937,0.1021,10336,332808,0.0215,3534,70147,0.0000,0,0
2021-04-08,Brazil,203070494,Piauí,3260937,0.1040,6226,339034,0.0227,3857,74004,0.0000,0,0
2021-04-09,Brazil,203070494,Piauí,3260937,0.1052,3860,342894,0.0245,5855,79859,0.0000,0,0
2021-04-10,Brazil,203070494,Piauí,3260937,0.1055,1038,343932,0.0246,378,80237,0.0000,0,0
2021-04-11,Brazil,203070494,Piauí,3260937,0.1070,4893,348825,0.0248,650,80887,0.0000,0,0
2021-04-12,Brazil,203070494,Piauí,3260937,0.1079,3092,351917,0.0264,5249,86136,0.0000,0,0
2021-04-13,Brazil,203070494,Piauí,3260937,0.1097,5712,357629,0.0287,7481,93617,0.0000,0,0
2021-04-14,Brazil,203070494,Piauí,3260937,0.1113,5392,363021,0.0309,7045,100662,0.0000,0,0
2021-04-15,Brazil,203070494,Piauí,3260937,0.1130,5329,368350,0.0333,8045,108707,0.0000,0,0
2021-04-16,Brazil,203070494,Piauí,3260937,0.1141,3666,372016,0.0354,6885,115592,0.0000,0,0
2021-04-17,Brazil,203070494,Piauí,3260937,0.1160,6155,378171,0.0364,3261,118853,0.0000,0,0
2021-04-18,Brazil,203070494,Piauí,3260937,0.1177,5764,383935,0.0366,448,119301,0.0000,0,0
2021-04-19,Brazil,203070494,Piauí,3260937,0.1190,3989,387924,0.0404,12333,131634,0.0000,0,0
2021-04-20,Brazil,203070494,Piauí,3260937,0.1218,9114,397038,0.0457,17403,149037,0.0000,0,0
2021-04-21,Brazil,203070494,Piauí,3260937,0.1228,3432,400470,0.0488,10014,159051,0.0000,0,0
2021-04-22,Brazil,203070494,Piauí,3260937,0.1251,7348,407818,0.0537,16199,175250,0.0000,0,0
2021-04-23,Brazil,203070494,Piauí,3260937,0.1264,4395,412213,0.0573,11703,186953,0.0000,0,0
2021-04-24,Brazil,203070494,Piauí,3260937,0.1267,870,413083,0.0593,6319,193272,0.0000,0,0
2021-04-25,Brazil,203070494,Piauí,3260937,0.1268,339,413422,0.0594,314,193586,0.0000,0,0
2021-04-26,Brazil,203070494,Piauí,3260937,0.1283,4909,418331,0.0635,13353,206939,0.0000,0,0
2021-04-27,Brazil,203070494,Piauí,3260937,0.1315,10622,428953,0.0674,12865,219804,0.0000,0,0
2021-04-28,Brazil,203070494,Piauí,3260937,0.1348,10512,439465,0.0705,10240,230044,0.0000,0,0
2021-04-29,Brazil,203070494,Piauí,3260937,0.1364,5352,444817,0.0731,8479,238523,0.0000,0,0
2021-04-30,Brazil,203070494,Piauí,3260937,0.1377,4365,449182,0.0740,2715,241238,0.0000,0,0
2021-05-01,Brazil,203070494,Piauí,3260937,0.1379,544,449726,0.0742,784,242022,0.0000,0,0
2021-05-02,Brazil,203070494,Piauí,3260937,0.1398,6311,456037,0.0742,50,242072,0.0000,0,0
2021-05-03,Brazil,203070494,Piauí,3260937,0.1435,11854,467891,0.0753,3456,245528,0.0000,0,0
2021-05-04,Brazil,203070494,Piauí,3260937,0.1489,17633,485524,0.0765,4093,249621,0.0000,0,0
2021-05-05,Brazil,203070494,Piauí,3260937,0.1553,20829,506353,0.0779,4291,253912,0.0000,0,0
2021-05-06,Brazil,203070494,Piauí,3260937,0.1589,11671,518024,0.0787,2690,256602,0.0000,0,0
2021-05-07,Brazil,203070494,Piauí,3260937,0.1624,11514,529538,0.0791,1221,257823,0.0000,0,0
2021-05-08,Brazil,203070494,Piauí,3260937,0.1634,3342,532880,0.0791,246,258069,0.0000,0,0
2021-05-09,Brazil,203070494,Piauí,3260937,0.1637,964,533844,0.0791,10,258079,0.0000,0,0
2021-05-10,Brazil,203070494,Piauí,3260937,0.1660,7443,541287,0.0795,1301,259380,0.0000,0,0
2021-05-11,Brazil,203070494,Piauí,3260937,0.1686,8566,549853,0.0804,2894,262274,0.0000,0,0
2021-05-12,Brazil,203070494,Piauí,3260937,0.1710,7694,557547,0.0816,3789,266063,0.0000,0,0
2021-05-13,Brazil,203070494,Piauí,3260937,0.1735,8094,565641,0.0827,3503,269566,0.0000,0,0
2021-05-14,Brazil,203070494,Piauí,3260937,0.1753,5923,571564,0.0834,2436,272002,0.0000,0,0
2021-05-15,Brazil,203070494,Piauí,3260937,0.1776,7679,579243,0.0835,232,272234,0.0000,0,0
2021-05-16,Brazil,203070494,Piauí,3260937,0.1777,134,579377,0.0838,1032,273266,0.0000,0,0
2021-05-17,Brazil,203070494,Piauí,3260937,0.1796,6187,585564,0.0848,3117,276383,0.0000,0,0
2021-05-18,Brazil,203070494,Piauí,3260937,0.1821,8114,593678,0.0865,5819,282202,0.0000,0,0
2021-05-19,Brazil,203070494,Piauí,3260937,0.1849,9314,602992,0.0878,3990,286192,0.0000,0,0
2021-05-20,Brazil,203070494,Piauí,3260937,0.1879,9648,612640,0.0885,2528,288720,0.0000,0,0
2021-05-21,Brazil,203070494,Piauí,3260937,0.1901,7249,619889,0.0899,4392,293112,0.0000,0,0
2021-05-22,Brazil,203070494,Piauí,3260937,0.1913,3934,623823,0.0900,324,293436,0.0000,0,0
2021-05-23,Brazil,203070494,Piauí,3260937,0.1920,2201,626024,0.0900,52,293488,0.0000,0,0
2021-05-24,Brazil,203070494,Piauí,3260937,0.1940,6651,632675,0.0906,2067,295555,0.0000,0,0
2021-05-25,Brazil,203070494,Piauí,3260937,0.1968,8926,641601,0.0913,2072,297627,0.0000,0,0
2021-05-26,Brazil,203070494,Piauí,3260937,0.1996,9270,650871,0.0919,2173,299800,0.0000,0,0
2021-05-27,Brazil,203070494,Piauí,3260937,0.2021,8267,659138,0.0925,1970,301770,0.0000,0,0
2021-05-28,Brazil,203070494,Piauí,3260937,0.2045,7852,666990,0.0934,2871,304641,0.0000,0,0
2021-05-29,Brazil,203070494,Piauí,3260937,0.2049,1219,668209,0.0935,119,304760,0.0000,0,0
2021-05-30,Brazil,203070494,Piauí,3260937,0.2052,809,669018,0.0935,22,304782,0.0000,0,0
2021-05-31,Brazil,203070494,Piauí,3260937,0.2076,7810,676828,0.0938,1249,306031,0.0000,0,0
2021-06-01,Brazil,203070494,Piauí,3260937,0.2110,11177,688005,0.0945,2215,308246,0.0000,0,0
2021-06-02,Brazil,203070494,Piauí,3260937,0.2147,12061,700066,0.0954,2826,311072,0.0000,0,0
2021-06-03,Brazil,203070494,Piauí,3260937,0.2177,9787,709853,0.0960,1825,312897,0.0000,0,0
2021-06-04,Brazil,203070494,Piauí,3260937,0.2207,9904,719757,0.0965,1846,314743,0.0000,0,0
2021-06-05,Brazil,203070494,Piauí,3260937,0.2237,9789,729546,0.0966,245,314988,0.0000,0,0
2021-06-06,Brazil,203070494,Piauí,3260937,0.2239,515,730061,0.0966,12,315000,0.0000,0,0
2021-06-07,Brazil,203070494,Piauí,3260937,0.2292,17202,747263,0.0969,970,315970,0.0000,0,0
2021-06-08,Brazil,203070494,Piauí,3260937,0.2347,18122,765385,0.0973,1170,317140,0.0000,0,0
2021-06-09,Brazil,203070494,Piauí,3260937,0.2410,20366,785751,0.0977,1317,318457,0.0000,0,0
2021-06-10,Brazil,203070494,Piauí,3260937,0.2473,20788,806539,0.0980,1069,319526,0.0000,0,0
2021-06-11,Brazil,203070494,Piauí,3260937,0.2534,19692,826231,0.0984,1314,320840,0.0000,0,0
2021-06-12,Brazil,203070494,Piauí,3260937,0.2575,13406,839637,0.0984,112,320952,0.0000,0,0
2021-06-13,Brazil,203070494,Piauí,3260937,0.2577,598,840235,0.0984,48,321000,0.0000,0,0
2021-06-14,Brazil,203070494,Piauí,3260937,0.2635,18953,859188,0.0987,934,321934,0.0000,0,0
2021-06-15,Brazil,203070494,Piauí,3260937,0.2716,26399,885587,0.0992,1460,323394,0.0000,0,0
2021-06-16,Brazil,203070494,Piauí,3260937,0.2779,20594,906181,0.0998,2125,325519,0.0000,0,0
2021-06-17,Brazil,203070494,Piauí,3260937,0.2841,20278,926459,0.1004,1891,327410,0.0000,0,0
2021-06-18,Brazil,203070494,Piauí,3260937,0.2892,16453,942912,0.1007,1074,328484,0.0000,0,0
2021-06-19,Brazil,203070494,Piauí,3260937,0.2905,4534,947446,0.1014,2165,330649,0.0000,0,0
2021-06-20,Brazil,203070494,Piauí,3260937,0.2908,838,948284,0.1017,965,331614,0.0000,0,0
2021-06-21,Brazil,203070494,Piauí,3260937,0.2942,11207,959491,0.1021,1458,333072,0.0000,0,0
2021-06-22,Brazil,203070494,Piauí,3260937,0.2998,18277,977768,0.1034,3975,337047,0.0000,0,0
2021-06-23,Brazil,203070494,Piauí,3260937,0.3065,21669,999437,0.1046,4018,341065,0.0000,0,0
2021-06-24,Brazil,203070494,Piauí,3260937,0.3124,19351,1018788,0.1055,2922,343987,0.0000,0,0
2021-06-25,Brazil,203070494,Piauí,3260937,0.3166,13755,1032543,0.1062,2317,346304,0.0000,0,0
2021-06-26,Brazil,203070494,Piauí,3260937,0.3174,2619,1035162,0.1066,1217,347521,0.0000,0,0
2021-06-27,Brazil,203070494,Piauí,3260937,0.3179,1607,1036769,0.1067,420,347941,0.0000,0,0
2021-06-28,Brazil,203070494,Piauí,3260937,0.3220,13300,1050069,0.1078,3599,351540,0.0000,0,0
2021-06-29,Brazil,203070494,Piauí,3260937,0.3289,22521,1072590,0.1087,2884,354424,0.0000,0,0
2021-06-30,Brazil,203070494,Piauí,3260937,0.3353,20684,1093274,0.1099,3988,358412,0.0000,0,0
2021-07-01,Brazil,203070494,Piauí,3260937,0.3425,23527,1116801,0.1110,3655,362067,0.0000,0,0
2021-07-02,Brazil,203070494,Piauí,3260937,0.3470,14659,1131460,0.1116,1757,363824,0.0000,0,0
2021-07-03,Brazil,203070494,Piauí,3260937,0.3477,2411,1133871,0.1117,494,364318,0.0000,0,0
2021-07-04,Brazil,203070494,Piauí,3260937,0.3479,485,1134356,0.1131,4431,368749,0.0000,0,0
2021-07-05,Brazil,203070494,Piauí,3260937,0.3520,13507,1147863,0.1136,1703,370452,0.0000,0,0
2021-07-06,Brazil,203070494,Piauí,3260937,0.3589,22329,1170192,0.1148,4041,374493,0.0000,0,0
2021-07-07,Brazil,203070494,Piauí,3260937,0.3643,17613,1187805,0.1162,4352,378845,0.0000,0,0
2021-07-08,Brazil,203070494,Piauí,3260937,0.3708,21464,1209269,0.1177,5074,383919,0.0000,0,0
2021-07-09,Brazil,203070494,Piauí,3260937,0.3761,17191,1226460,0.1190,4062,387981,0.0000,0,0
2021-07-10,Brazil,203070494,Piauí,3260937,0.3769,2733,1229193,0.1206,5287,393268,0.0000,0,0
2021-07-11,Brazil,203070494,Piauí,3260937,0.3771,599,1229792,0.1221,4781,398049,0.0000,0,0
2021-07-12,Brazil,203070494,Piauí,3260937,0.3802,9941,1239733,0.1234,4191,402240,0.0000,0,0
2021-07-13,Brazil,203070494,Piauí,3260937,0.3845,14173,1253906,0.1253,6238,408478,0.0000,0,0
2021-07-14,Brazil,203070494,Piauí,3260937,0.3904,19216,1273122,0.1273,6513,414991,0.0000,0,0
2021-07-15,Brazil,203070494,Piauí,3260937,0.3953,15976,1289098,0.1290,5721,420712,0.0000,0,0
2021-07-16,Brazil,203070494,Piauí,3260937,0.3986,10833,1299931,0.1302,3759,424471,0.0000,0,0
2021-07-17,Brazil,203070494,Piauí,3260937,0.3993,2005,1301936,0.1305,1095,425566,0.0000,0,0
2021-07-18,Brazil,203070494,Piauí,3260937,0.3993,108,1302044,0.1305,102,425668,0.0000,0,0
2021-07-19,Brazil,203070494,Piauí,3260937,0.4030,12225,1314269,0.1319,4459,430127,0.0000,0,0
2021-07-20,Brazil,203070494,Piauí,3260937,0.4098,21958,1336227,0.1351,10520,440647,0.0000,0,0
2021-07-21,Brazil,203070494,Piauí,3260937,0.4171,23911,1360138,0.1384,10748,451395,0.0000,0,0
2021-07-22,Brazil,203070494,Piauí,3260937,0.4210,12706,1372844,0.1411,8688,460083,0.0000,0,0
2021-07-23,Brazil,203070494,Piauí,3260937,0.4271,19756,1392600,0.1431,6656,466739,0.0000,0,0
2021-07-24,Brazil,203070494,Piauí,3260937,0.4280,3170,1395770,0.1434,856,467595,0.0000,0,0
2021-07-25,Brazil,203070494,Piauí,3260937,0.4282,434,1396204,0.1451,5605,473200,0.0000,0,0
2021-07-26,Brazil,203070494,Piauí,3260937,0.4314,10510,1406714,0.1487,11733,484933,0.0000,0,0
2021-07-27,Brazil,203070494,Piauí,3260937,0.4361,15355,1422069,0.1536,16028,500961,0.0000,0,0
2021-07-28,Brazil,203070494,Piauí,3260937,0.4411,16212,1438281,0.1588,16844,517805,0.0000,0,0
2021-07-29,Brazil,203070494,Piauí,3260937,0.4452,13622,1451903,0.1622,10972,528777,0.0000,0,0
2021-07-30,Brazil,203070494,Piauí,3260937,0.4487,11424,1463327,0.1649,8984,537761,0.0000,0,0
2021-07-31,Brazil,203070494,Piauí,3260937,0.4498,3291,1466618,0.1653,1244,539005,0.0000,0,0
2021-08-01,Brazil,203070494,Piauí,3260937,0.4498,93,1466711,0.1653,90,539095,0.0000,0,0
2021-08-02,Brazil,203070494,Piauí,3260937,0.4525,8869,1475580,0.1675,7083,546178,0.0000,0,0
2021-08-03,Brazil,203070494,Piauí,3260937,0.4561,11878,1487458,0.1698,7416,553594,0.0000,0,0
2021-08-04,Brazil,203070494,Piauí,3260937,0.4617,17999,1505457,0.1721,7552,561146,0.0000,0,0
2021-08-05,Brazil,203070494,Piauí,3260937,0.4693,24784,1530241,0.1750,9608,570754,0.0000,0,0
2021-08-06,Brazil,203070494,Piauí,3260937,0.4740,15322,1545563,0.1773,7352,578106,0.0000,0,0
2021-08-07,Brazil,203070494,Piauí,3260937,0.4767,8944,1554507,0.1796,7703,585809,0.0000,0,0
2021-08-08,Brazil,203070494,Piauí,3260937,0.4767,131,1554638,0.1797,22,585831,0.0000,0,0
2021-08-09,Brazil,203070494,Piauí,3260937,0.4820,16994,1571632,0.1814,5746,591577,0.0000,0,0
2021-08-10,Brazil,203070494,Piauí,3260937,0.4872,17154,1588786,0.1845,9945,601522,0.0000,0,0
2021-08-11,Brazil,203070494,Piauí,3260937,0.4954,26648,1615434,0.1880,11586,613108,0.0000,0,0
2021-08-12,Brazil,203070494,Piauí,3260937,0.5042,28881,1644315,0.1915,11333,624441,0.0000,0,0
2021-08-13,Brazil,203070494,Piauí,3260937,0.5093,16400,1660715,0.1940,8249,632690,0.0000,0,0
2021-08-14,Brazil,203070494,Piauí,3260937,0.5119,8535,1669250,0.1943,786,633476,0.0000,0,0
2021-08-15,Brazil,203070494,Piauí,3260937,0.5120,215,1669465,0.1943,74,633550,0.0000,0,0
2021-08-16,Brazil,203070494,Piauí,3260937,0.5158,12607,1682072,0.1967,7867,641417,0.0000,0,0
2021-08-17,Brazil,203070494,Piauí,3260937,0.5214,18247,1700319,0.1996,9566,650983,0.0000,0,0
2021-08-18,Brazil,203070494,Piauí,3260937,0.5313,32213,1732532,0.2029,10741,661724,0.0000,0,0
2021-08-19,Brazil,203070494,Piauí,3260937,0.5404,29730,1762262,0.2059,9644,671368,0.0000,0,0
2021-08-20,Brazil,203070494,Piauí,3260937,0.5485,26505,1788767,0.2088,9379,680747,0.0000,0,0
2021-08-21,Brazil,203070494,Piauí,3260937,0.5525,12781,1801548,0.2091,1060,681807,0.0000,0,0
2021-08-22,Brazil,203070494,Piauí,3260937,0.5550,8403,1809951,0.2092,323,682130,0.0000,0,0
2021-08-23,Brazil,203070494,Piauí,3260937,0.5612,19963,1829914,0.2121,9467,691597,0.0000,0,0
2021-08-24,Brazil,203070494,Piauí,3260937,0.5693,26518,1856432,0.2159,12577,704174,0.0000,0,0
2021-08-25,Brazil,203070494,Piauí,3260937,0.5780,28467,1884899,0.2211,16856,721030,0.0000,0,0
2021-08-26,Brazil,203070494,Piauí,3260937,0.5869,29052,1913951,0.2252,13194,734224,0.0000,0,0
2021-08-27,Brazil,203070494,Piauí,3260937,0.5910,13273,1927224,0.2321,22681,756905,0.0000,0,0
2021-08-28,Brazil,203070494,Piauí,3260937,0.5974,20703,1947927,0.2327,1862,758767,0.0000,0,0
2021-08-29,Brazil,203070494,Piauí,3260937,0.6006,10440,1958367,0.2328,537,759304,0.0000,0,0
2021-08-30,Brazil,203070494,Piauí,3260937,0.6040,11142,1969509,0.2398,22742,782046,0.0000,0,0
2021-08-31,Brazil,203070494,Piauí,3260937,0.6115,24614,1994123,0.2445,15111,797157,0.0000,0,0
2021-09-01,Brazil,203070494,Piauí,3260937,0.6209,30503,2024626,0.2496,16901,814058,0.0000,0,0
2021-09-02,Brazil,203070494,Piauí,3260937,0.6264,18075,2042701,0.2565,22260,836318,0.0000,0,0
2021-09-03,Brazil,203070494,Piauí,3260937,0.6298,10912,2053613,0.2622,18537,854855,0.0000,0,0
2021-09-04,Brazil,203070494,Piauí,3260937,0.6311,4520,2058133,0.2652,9974,864829,0.0000,0,0
2021-09-05,Brazil,203070494,Piauí,3260937,0.6322,3275,2061408,0.2653,446,865275,0.0000,0,0
2021-09-06,Brazil,203070494,Piauí,3260937,0.6350,9198,2070606,0.2736,26838,892113,0.0000,0,0
2021-09-07,Brazil,203070494,Piauí,3260937,0.6356,2081,2072687,0.2770,11243,903356,0.0000,0,0
2021-09-08,Brazil,203070494,Piauí,3260937,0.6397,13436,2086123,0.2829,19083,922439,0.0000,0,0
2021-09-09,Brazil,203070494,Piauí,3260937,0.6440,14080,2100203,0.2897,22157,944596,0.0000,0,0
2021-09-10,Brazil,203070494,Piauí,3260937,0.6492,16835,2117038,0.2936,12934,957530,0.0000,0,0
2021-09-11,Brazil,203070494,Piauí,3260937,0.6523,10025,2127063,0.2940,1337,958867,0.0000,0,0
2021-09-12,Brazil,203070494,Piauí,3260937,0.6527,1284,2128347,0.2941,50,958917,0.0000,0,0
2021-09-13,Brazil,203070494,Piauí,3260937,0.6548,7001,2135348,0.2985,14591,973508,0.0000,0,0
2021-09-14,Brazil,203070494,Piauí,3260937,0.6584,11735,2147083,0.3042,18613,992121,0.0000,0,0
2021-09-15,Brazil,203070494,Piauí,3260937,0.6619,11380,2158463,0.3113,23095,1015216,0.0000,0,0
2021-09-16,Brazil,203070494,Piauí,3260937,0.6646,8692,2167155,0.3173,19544,1034760,0.0000,0,0
2021-09-17,Brazil,203070494,Piauí,3260937,0.6668,7079,2174234,0.3213,12965,1047725,0.0000,0,0
2021-09-18,Brazil,203070494,Piauí,3260937,0.6674,2136,2176370,0.3219,1849,1049574,0.0000,0,0
2021-09-19,Brazil,203070494,Piauí,3260937,0.6678,1259,2177629,0.3219,94,1049668,0.0000,0,0
2021-09-20,Brazil,203070494,Piauí,3260937,0.6705,8955,2186584,0.3257,12393,1062061,0.0000,0,0
2021-09-21,Brazil,203070494,Piauí,3260937,0.6747,13729,2200313,0.3306,16135,1078196,0.0000,0,0
2021-09-22,Brazil,203070494,Piauí,3260937,0.6783,11463,2211776,0.3366,19558,1097754,0.0000,0,0
2021-09-23,Brazil,203070494,Piauí,3260937,0.6818,11569,2223345,0.3425,19225,1116979,0.0000,0,0
2021-09-24,Brazil,203070494,Piauí,3260937,0.6844,8375,2231720,0.3476,16458,1133437,0.0000,0,0
2021-09-25,Brazil,203070494,Piauí,3260937,0.6851,2481,2234201,0.3503,8834,1142271,0.0000,0,0
2021-09-26,Brazil,203070494,Piauí,3260937,0.6853,514,2234715,0.3521,5969,1148240,0.0000,0,0
2021-09-27,Brazil,203070494,Piauí,3260937,0.6887,11236,2245951,0.3581,19528,1167768,0.0000,0,0
2021-09-28,Brazil,203070494,Piauí,3260937,0.6913,8180,2254131,0.3670,29082,1196850,0.0000,0,0
2021-09-29,Brazil,203070494,Piauí,3260937,0.6951,12485,2266616,0.3759,28855,1225705,0.0000,0,0
2021-09-30,Brazil,203070494,Piauí,3260937,0.6997,15221,2281837,0.3829,22952,1248657,0.0000,0,0
2021-10-01,Brazil,203070494,Piauí,3260937,0.7029,10227,2292064,0.3885,18327,1266984,0.0000,0,0
2021-10-02,Brazil,203070494,Piauí,3260937,0.7035,2043,2294107,0.3904,6062,1273046,0.0000,0,0
2021-10-03,Brazil,203070494,Piauí,3260937,0.7035,104,2294211,0.3905,275,1273321,0.0000,0,0
2021-10-04,Brazil,203070494,Piauí,3260937,0.7048,4049,2298260,0.3949,14299,1287620,0.0000,0,0
2021-10-05,Brazil,203070494,Piauí,3260937,0.7083,11561,2309821,0.4006,18797,1306417,0.0000,0,0
2021-10-06,Brazil,203070494,Piauí,3260937,0.7125,13457,2323278,0.4082,24854,1331271,0.0000,0,0
2021-10-07,Brazil,203070494,Piauí,3260937,0.7171,15235,2338513,0.4141,19037,1350308,0.0000,0,0
2021-10-08,Brazil,203070494,Piauí,3260937,0.7191,6434,2344947,0.4190,16163,1366471,0.0000,0,0
2021-10-09,Brazil,203070494,Piauí,3260937,0.7197,1871,2346818,0.4202,3873,1370344,0.0000,0,0
2021-10-10,Brazil,203070494,Piauí,3260937,0.7200,1056,2347874,0.4203,148,1370492,0.0000,0,0
2021-10-11,Brazil,203070494,Piauí,3260937,0.7212,3874,2351748,0.4271,22174,1392666,0.0000,0,0
2021-10-12,Brazil,203070494,Piauí,3260937,0.7228,5364,2357112,0.4310,12653,1405319,0.0000,0,0
2021-10-13,Brazil,203070494,Piauí,3260937,0.7259,9917,2367029,0.4406,31305,1436624,0.0000,0,0
2021-10-14,Brazil,203070494,Piauí,3260937,0.7274,5009,2372038,0.4500,30802,1467426,0.0000,0,0
2021-10-15,Brazil,203070494,Piauí,3260937,0.7286,3765,2375803,0.4572,23339,1490765,0.0000,0,0
2021-10-16,Brazil,203070494,Piauí,3260937,0.7288,885,2376688,0.4583,3784,1494549,0.0000,0,0
2021-10-17,Brazil,203070494,Piauí,3260937,0.7292,1201,2377889,0.4585,652,1495201,0.0000,0,0
2021-10-18,Brazil,203070494,Piauí,3260937,0.7304,4013,2381902,0.4637,17020,1512221,0.0000,0,0
2021-10-19,Brazil,203070494,Piauí,3260937,0.7318,4340,2386242,0.4697,19594,1531815,0.0000,0,0
2021-10-20,Brazil,203070494,Piauí,3260937,0.7337,6357,2392599,0.4800,33511,1565326,0.0000,0,0
2021-10-21,Brazil,203070494,Piauí,3260937,0.7353,5081,2397680,0.4897,31691,1597017,0.0000,0,0
2021-10-22,Brazil,203070494,Piauí,3260937,0.7365,3963,2401643,0.4966,22280,1619297,0.0000,0,0
2021-10-23,Brazil,203070494,Piauí,3260937,0.7367,530,2402173,0.4974,2541,1621838,0.0000,0,0
2021-10-24,Brazil,203070494,Piauí,3260937,0.7367,46,2402219,0.4974,102,1621940,0.0000,0,0
2021-10-25,Brazil,203070494,Piauí,3260937,0.7378,3586,2405805,0.5024,16477,1638417,0.0000,0,0
2021-10-26,Brazil,203070494,Piauí,3260937,0.7395,5786,2411591,0.5105,26151,1664568,0.0000,0,0
2021-10-27,Brazil,203070494,Piauí,3260937,0.7422,8568,2420159,0.5196,29859,1694427,0.0000,0,0
2021-10-28,Brazil,203070494,Piauí,3260937,0.7476,17666,2437825,0.5247,16586,1711013,0.0000,0,0
2021-10-29,Brazil,203070494,Piauí,3260937,0.7497,6835,2444660,0.5288,13519,1724532,0.0000,0,0
2021-10-30,Brazil,203070494,Piauí,3260937,0.7505,2587,2447247,0.5296,2463,1726995,0.0000,0,0
2021-10-31,Brazil,203070494,Piauí,3260937,0.7508,1140,2448387,0.5296,63,1727058,0.0000,0,0
2021-11-01,Brazil,203070494,Piauí,3260937,0.7513,1503,2449890,0.5320,7857,1734915,0.0000,0,0
2021-11-02,Brazil,203070494,Piauí,3260937,0.7514,445,2450335,0.5335,4848,1739763,0.0000,0,0
2021-11-03,Brazil,203070494,Piauí,3260937,0.7534,6399,2456734,0.5408,23781,1763544,0.0000,0,0
2021-11-04,Brazil,203070494,Piauí,3260937,0.7587,17428,2474162,0.5470,20077,1783621,0.0000,0,0
2021-11-05,Brazil,203070494,Piauí,3260937,0.7614,8718,2482880,0.5506,11998,1795619,0.0000,0,0
2021-11-06,Brazil,203070494,Piauí,3260937,0.7619,1685,2484565,0.5515,2652,1798271,0.0000,0,0
2021-11-07,Brazil,203070494,Piauí,3260937,0.7620,242,2484807,0.5516,547,1798818,0.0000,0,0
2021-11-08,Brazil,203070494,Piauí,3260937,0.7645,8168,2492975,0.5571,17812,1816630,0.0000,0,0
2021-11-09,Brazil,203070494,Piauí,3260937,0.7683,12432,2505407,0.5634,20646,1837276,0.0000,0,0
2021-11-10,Brazil,203070494,Piauí,3260937,0.7713,9900,2515307,0.5696,20137,1857413,0.0000,0,0
2021-11-11,Brazil,203070494,Piauí,3260937,0.7738,7880,2523187,0.5756,19424,1876837,0.0000,0,0
2021-11-12,Brazil,203070494,Piauí,3260937,0.7751,4292,2527479,0.5790,11331,1888168,0.0000,0,0
2021-11-13,Brazil,203070494,Piauí,3260937,0.7752,392,2527871,0.5799,2974,1891142,0.0000,0,0
2021-11-14,Brazil,203070494,Piauí,3260937,0.7752,26,2527897,0.5800,126,1891268,0.0000,0,0
2021-11-15,Brazil,203070494,Piauí,3260937,0.7759,2174,2530071,0.5824,7842,1899110,0.0000,0,0
2021-11-16,Brazil,203070494,Piauí,3260937,0.7771,4086,2534157,0.5880,18466,1917576,0.0000,0,0
2021-11-17,Brazil,203070494,Piauí,3260937,0.7788,5559,2539716,0.5935,17848,1935424,0.0000,0,0
2021-11-18,Brazil,203070494,Piauí,3260937,0.7800,3799,2543515,0.5995,19494,1954918,0.0000,1,1
2021-11-19,Brazil,203070494,Piauí,3260937,0.7809,2810,2546325,0.6032,12119,1967037,0.0000,0,1
2021-11-20,Brazil,203070494,Piauí,3260937,0.7811,890,2547215,0.6038,1917,1968954,0.0000,0,1
2021-11-21,Brazil,203070494,Piauí,3260937,0.7811,16,2547231,0.6038,96,1969050,0.0000,0,1
2021-11-22,Brazil,203070494,Piauí,3260937,0.7821,3057,2550288,0.6079,13199,1982249,0.0000,0,1
2021-11-23,Brazil,203070494,Piauí,3260937,0.7832,3732,2554020,0.6126,15511,1997760,0.0000,0,1
2021-11-24,Brazil,203070494,Piauí,3260937,0.7847,4824,2558844,0.6175,15831,2013591,0.0000,0,1
2021-11-25,Brazil,203070494,Piauí,3260937,0.7857,3262,2562106,0.6228,17276,2030867,0.0000,0,1
2021-11-26,Brazil,203070494,Piauí,3260937,0.7866,2906,2565012,0.6287,19303,2050170,0.0000,0,1
2021-11-27,Brazil,203070494,Piauí,3260937,0.7867,330,2565342,0.6292,1628,2051798,0.0000,0,1
2021-11-28,Brazil,203070494,Piauí,3260937,0.7867,5,2565347,0.6292,66,2051864,0.0000,0,1
2021-11-29,Brazil,203070494,Piauí,3260937,0.7873,2104,2567451,0.6319,8740,2060604,0.0000,0,1
2021-11-30,Brazil,203070494,Piauí,3260937,0.7883,3220,2570671,0.6357,12501,2073105,0.0000,0,1
2021-12-01,Brazil,203070494,Piauí,3260937,0.7906,7301,2577972,0.6401,14077,2087182,0.0000,8,9
2021-12-02,Brazil,203070494,Piauí,3260937,0.7930,7858,2585830,0.6451,16536,2103718,0.0000,0,9
2021-12-03,Brazil,203070494,Piauí,3260937,0.7945,5119,2590949,0.6490,12475,2116193,0.0000,0,9
2021-12-04,Brazil,203070494,Piauí,3260937,0.7956,3357,2594306,0.6512,7314,2123507,0.0000,0,9
2021-12-05,Brazil,203070494,Piauí,3260937,0.7956,42,2594348,0.6513,270,2123777,0.0000,0,9
2021-12-06,Brazil,203070494,Piauí,3260937,0.7966,3475,2597823,0.6550,12286,2136063,0.0000,1,10
2021-12-07,Brazil,203070494,Piauí,3260937,0.7978,3656,2601479,0.6594,14069,2150132,0.0000,0,10
2021-12-08,Brazil,203070494,Piauí,3260937,0.7984,2139,2603618,0.6622,9106,2159238,0.0000,1,11
2021-12-09,Brazil,203070494,Piauí,3260937,0.8000,5102,2608720,0.6671,16071,2175309,0.0000,0,11
2021-12-10,Brazil,203070494,Piauí,3260937,0.8008,2624,2611344,0.6705,11103,2186412,0.0000,0,11
2021-12-11,Brazil,203070494,Piauí,3260937,0.8013,1671,2613015,0.6720,4961,2191373,0.0000,0,11
2021-12-12,Brazil,203070494,Piauí,3260937,0.8013,21,2613036,0.6721,190,2191563,0.0000,0,11
2021-12-13,Brazil,203070494,Piauí,3260937,0.8020,2075,2615111,0.6746,8214,2199777,0.0000,0,11
2021-12-14,Brazil,203070494,Piauí,3260937,0.8027,2539,2617650,0.6777,10169,2209946,0.0000,0,11
2021-12-15,Brazil,203070494,Piauí,3260937,0.8035,2591,2620241,0.6814,12010,2221956,0.0000,0,11
2021-12-16,Brazil,203070494,Piauí,3260937,0.8043,2368,2622609,0.6845,10025,2231981,0.0000,13,24
2021-12-17,Brazil,203070494,Piauí,3260937,0.8047,1499,2624108,0.6867,7446,2239427,0.0000,0,24
2021-12-18,Brazil,203070494,Piauí,3260937,0.8051,1175,2625283,0.6875,2381,2241808,0.0000,0,24
2021-12-19,Brazil,203070494,Piauí,3260937,0.8051,172,2625455,0.6877,753,2242561,0.0000,0,24
2021-12-20,Brazil,203070494,Piauí,3260937,0.8055,1168,2626623,0.6898,6837,2249398,0.0000,0,24
2021-12-21,Brazil,203070494,Piauí,3260937,0.8058,1139,2627762,0.6918,6430,2255828,0.0000,0,24
2021-12-22,Brazil,203070494,Piauí,3260937,0.8062,1258,2629020,0.6940,7179,2263007,0.0000,1,25
2021-12-23,Brazil,203070494,Piauí,3260937,0.8065,982,2630002,0.6956,5196,2268203,0.0000,0,25
2021-12-24,Brazil,203070494,Piauí,3260937,0.8065,6,2630008,0.6956,39,2268242,0.0000,0,25
2021-12-25,Brazil,203070494,Piauí,3260937,0.8065,18,2630026,0.6956,14,2268256,0.0000,0,25
2021-12-26,Brazil,203070494,Piauí,3260937,0.8065,2,2630028,0.6956,13,2268269,0.0000,0,25
2021-12-27,Brazil,203070494,Piauí,3260937,0.8067,640,2630668,0.6965,3027,2271296,0.0000,0,25
2021-12-28,Brazil,203070494,Piauí,3260937,0.8069,624,2631292,0.6975,3086,2274382,0.0000,0,25
2021-12-29,Brazil,203070494,Piauí,3260937,0.8071,576,2631868,0.6983,2648,2277030,0.0000,0,25
2021-12-30,Brazil,203070494,Piauí,3260937,0.8073,570,2632438,0.6992,2998,2280028,0.0000,0,25
2021-12-31,Brazil,203070494,Piauí,3260937,0.8073,24,2632462,0.6992,21,2280049,0.0000,0,25
2021-01-01,Brazil,203070494,Rio Grande do Norte,3302729,0.0000,5,5,0.0000,2,2,0.0000,0,0
2021-01-02,Brazil,203070494,Rio Grande do Norte,3302729,0.0000,2,7,0.0000,0,2,0.0000,0,0
2021-01-03,Brazil,203070494,Rio Grande do Norte,3302729,0.0000,2,9,0.0000,5,7,0.0000,0,0
2021-01-04,Brazil,203070494,Rio Grande do Norte,3302729,0.0000,3,12,0.0000,4,11,0.0000,0,0
2021-01-05,Brazil,203070494,Rio Grande do Norte,3302729,0.0000,4,16,0.0000,6,17,0.0000,0,0
2021-01-06,Brazil,203070494,Rio Grande do Norte,3302729,0.0000,3,19,0.0000,4,21,0.0000,0,0
2021-01-07,Brazil,203070494,Rio Grande do Norte,3302729,0.0000,5,24,0.0000,4,25,0.0000,0,0
2021-01-08,Brazil,203070494,Rio Grande do Norte,3302729,0.0000,6,30,0.0000,2,27,0.0000,0,0
2021-01-09,Brazil,203070494,Rio Grande do Norte,3302729,0.0000,2,32,0.0000,3,30,0.0000,0,0
2021-01-10,Brazil,203070494,Rio Grande do Norte,3302729,0.0000,2,34,0.0000,2,32,0.0000,1,1
2021-01-11,Brazil,203070494,Rio Grande do Norte,3302729,0.0000,6,40,0.0000,10,42,0.0000,0,1
2021-01-12,Brazil,203070494,Rio Grande do Norte,3302729,0.0000,9,49,0.0000,7,49,0.0000,0,1
2021-01-13,Brazil,203070494,Rio Grande do Norte,3302729,0.0000,0,49,0.0000,8,57,0.0000,0,1
2021-01-14,Brazil,203070494,Rio Grande do Norte,3302729,0.0000,3,52,0.0000,7,64,0.0000,0,1
2021-01-15,Brazil,203070494,Rio Grande do Norte,3302729,0.0000,9,61,0.0000,3,67,0.0000,0,1
2021-01-16,Brazil,203070494,Rio Grande do Norte,3302729,0.0000,4,65,0.0000,2,69,0.0000,0,1
2021-01-17,Brazil,203070494,Rio Grande do Norte,3302729,0.0000,5,70,0.0000,5,74,0.0000,0,1
2021-01-18,Brazil,203070494,Rio Grande do Norte,3302729,0.0000,5,75,0.0000,6,80,0.0000,0,1
2021-01-19,Brazil,203070494,Rio Grande do Norte,3302729,0.0001,122,197,0.0000,6,86,0.0000,0,1
2021-01-20,Brazil,203070494,Rio Grande do Norte,3302729,0.0029,9545,9742,0.0000,8,94,0.0000,0,1
2021-01-21,Brazil,203070494,Rio Grande do Norte,3302729,0.0058,9343,19085,0.0000,13,107,0.0000,0,1
2021-01-22,Brazil,203070494,Rio Grande do Norte,3302729,0.0076,6021,25106,0.0000,25,132,0.0000,0,1
2021-01-23,Brazil,203070494,Rio Grande do Norte,3302729,0.0077,277,25383,0.0000,0,132,0.0000,0,1
2021-01-24,Brazil,203070494,Rio Grande do Norte,3302729,0.0079,597,25980,0.0000,6,138,0.0000,0,1
2021-01-25,Brazil,203070494,Rio Grande do Norte,3302729,0.0088,3200,29180,0.0000,5,143,0.0000,0,1
2021-01-26,Brazil,203070494,Rio Grande do Norte,3302729,0.0100,3740,32920,0.0000,13,156,0.0000,0,1
2021-01-27,Brazil,203070494,Rio Grande do Norte,3302729,0.0117,5851,38771,0.0001,13,169,0.0000,0,1
2021-01-28,Brazil,203070494,Rio Grande do Norte,3302729,0.0143,8528,47299,0.0001,39,208,0.0000,0,1
2021-01-29,Brazil,203070494,Rio Grande do Norte,3302729,0.0167,7794,55093,0.0001,33,241,0.0000,0,1
2021-01-30,Brazil,203070494,Rio Grande do Norte,3302729,0.0167,133,55226,0.0001,24,265,0.0000,0,1
2021-01-31,Brazil,203070494,Rio Grande do Norte,3302729,0.0167,14,55240,0.0001,5,270,0.0000,0,1
2021-02-01,Brazil,203070494,Rio Grande do Norte,3302729,0.0183,5265,60505,0.0001,23,293,0.0000,0,1
2021-02-02,Brazil,203070494,Rio Grande do Norte,3302729,0.0195,3745,64250,0.0001,15,308,0.0000,0,1
2021-02-03,Brazil,203070494,Rio Grande do Norte,3302729,0.0203,2808,67058,0.0001,12,320,0.0000,0,1
2021-02-04,Brazil,203070494,Rio Grande do Norte,3302729,0.0207,1369,68427,0.0001,9,329,0.0000,0,1
2021-02-05,Brazil,203070494,Rio Grande do Norte,3302729,0.0214,2179,70606,0.0001,10,339,0.0000,0,1
2021-02-06,Brazil,203070494,Rio Grande do Norte,3302729,0.0214,35,70641,0.0001,8,347,0.0000,0,1
2021-02-07,Brazil,203070494,Rio Grande do Norte,3302729,0.0214,20,70661,0.0001,1,348,0.0000,0,1
2021-02-08,Brazil,203070494,Rio Grande do Norte,3302729,0.0217,868,71529,0.0001,17,365,0.0000,0,1
2021-02-09,Brazil,203070494,Rio Grande do Norte,3302729,0.0221,1501,73030,0.0001,36,401,0.0000,0,1
2021-02-10,Brazil,203070494,Rio Grande do Norte,3302729,0.0231,3168,76198,0.0011,3071,3472,0.0000,0,1
2021-02-11,Brazil,203070494,Rio Grande do Norte,3302729,0.0243,4072,80270,0.0024,4572,8044,0.0000,0,1
2021-02-12,Brazil,203070494,Rio Grande do Norte,3302729,0.0253,3435,83705,0.0034,3311,11355,0.0000,0,1
2021-02-13,Brazil,203070494,Rio Grande do Norte,3302729,0.0254,178,83883,0.0034,38,11393,0.0000,0,1
2021-02-14,Brazil,203070494,Rio Grande do Norte,3302729,0.0254,14,83897,0.0035,25,11418,0.0000,0,1
2021-02-15,Brazil,203070494,Rio Grande do Norte,3302729,0.0256,731,84628,0.0039,1446,12864,0.0000,0,1
2021-02-16,Brazil,203070494,Rio Grande do Norte,3302729,0.0258,676,85304,0.0045,1967,14831,0.0000,0,1
2021-02-17,Brazil,203070494,Rio Grande do Norte,3302729,0.0261,900,86204,0.0058,4479,19310,0.0000,0,1
2021-02-18,Brazil,203070494,Rio Grande do Norte,3302729,0.0268,2386,88590,0.0077,6165,25475,0.0000,0,1
2021-02-19,Brazil,203070494,Rio Grande do Norte,3302729,0.0274,1859,90449,0.0089,3770,29245,0.0000,0,1
2021-02-20,Brazil,203070494,Rio Grande do Norte,3302729,0.0274,72,90521,0.0089,147,29392,0.0000,0,1
2021-02-21,Brazil,203070494,Rio Grande do Norte,3302729,0.0274,8,90529,0.0089,38,29430,0.0000,0,1
2021-02-22,Brazil,203070494,Rio Grande do Norte,3302729,0.0281,2284,92813,0.0098,3086,32516,0.0000,0,1
2021-02-23,Brazil,203070494,Rio Grande do Norte,3302729,0.0286,1723,94536,0.0105,2243,34759,0.0000,0,1
2021-02-24,Brazil,203070494,Rio Grande do Norte,3302729,0.0290,1403,95939,0.0111,1774,36533,0.0000,0,1
2021-02-25,Brazil,203070494,Rio Grande do Norte,3302729,0.0294,1200,97139,0.0115,1568,38101,0.0000,0,1
2021-02-26,Brazil,203070494,Rio Grande do Norte,3302729,0.0298,1438,98577,0.0119,1167,39268,0.0000,0,1
2021-02-27,Brazil,203070494,Rio Grande do Norte,3302729,0.0299,221,98798,0.0119,18,39286,0.0000,0,1
2021-02-28,Brazil,203070494,Rio Grande do Norte,3302729,0.0299,47,98845,0.0119,25,39311,0.0000,0,1
2021-03-01,Brazil,203070494,Rio Grande do Norte,3302729,0.0316,5669,104514,0.0122,986,40297,0.0000,0,1
2021-03-02,Brazil,203070494,Rio Grande do Norte,3302729,0.0337,6851,111365,0.0125,1132,41429,0.0000,0,1
2021-03-03,Brazil,203070494,Rio Grande do Norte,3302729,0.0366,9669,121034,0.0129,1137,42566,0.0000,0,1
2021-03-04,Brazil,203070494,Rio Grande do Norte,3302729,0.0389,7577,128611,0.0132,1097,43663,0.0000,0,1
2021-03-05,Brazil,203070494,Rio Grande do Norte,3302729,0.0403,4512,133123,0.0136,1102,44765,0.0000,0,1
2021-03-06,Brazil,203070494,Rio Grande do Norte,3302729,0.0405,559,133682,0.0136,128,44893,0.0000,0,1
2021-03-07,Brazil,203070494,Rio Grande do Norte,3302729,0.0405,52,133734,0.0136,11,44904,0.0000,0,1
2021-03-08,Brazil,203070494,Rio Grande do Norte,3302729,0.0419,4492,138226,0.0142,1838,46742,0.0000,0,1
2021-03-09,Brazil,203070494,Rio Grande do Norte,3302729,0.0434,4976,143202,0.0150,2681,49423,0.0000,0,1
2021-03-10,Brazil,203070494,Rio Grande do Norte,3302729,0.0453,6435,149637,0.0160,3512,52935,0.0000,0,1
2021-03-11,Brazil,203070494,Rio Grande do Norte,3302729,0.0467,4662,154299,0.0170,3244,56179,0.0000,0,1
2021-03-12,Brazil,203070494,Rio Grande do Norte,3302729,0.0475,2506,156805,0.0175,1648,57827,0.0000,0,1
2021-03-13,Brazil,203070494,Rio Grande do Norte,3302729,0.0476,570,157375,0.0175,60,57887,0.0000,0,1
2021-03-14,Brazil,203070494,Rio Grande do Norte,3302729,0.0481,1381,158756,0.0175,43,57930,0.0000,0,1
2021-03-15,Brazil,203070494,Rio Grande do Norte,3302729,0.0503,7315,166071,0.0179,1341,59271,0.0000,0,1
2021-03-16,Brazil,203070494,Rio Grande do Norte,3302729,0.0523,6807,172878,0.0183,1224,60495,0.0000,0,1
2021-03-17,Brazil,203070494,Rio Grande do Norte,3302729,0.0541,5927,178805,0.0187,1377,61872,0.0000,1,2
2021-03-18,Brazil,203070494,Rio Grande do Norte,3302729,0.0554,4087,182892,0.0192,1545,63417,0.0000,0,2
2021-03-19,Brazil,203070494,Rio Grande do Norte,3302729,0.0563,2902,185794,0.0196,1373,64790,0.0000,0,2
2021-03-20,Brazil,203070494,Rio Grande do Norte,3302729,0.0569,1996,187790,0.0197,294,65084,0.0000,0,2
2021-03-21,Brazil,203070494,Rio Grande do Norte,3302729,0.0571,648,188438,0.0198,172,65256,0.0000,0,2
2021-03-22,Brazil,203070494,Rio Grande do Norte,3302729,0.0589,6150,194588,0.0203,1767,67023,0.0000,0,2
2021-03-23,Brazil,203070494,Rio Grande do Norte,3302729,0.0628,12814,207402,0.0208,1630,68653,0.0000,0,2
2021-03-24,Brazil,203070494,Rio Grande do Norte,3302729,0.0685,18713,226115,0.0213,1745,70398,0.0000,0,2
2021-03-25,Brazil,203070494,Rio Grande do Norte,3302729,0.0751,22061,248176,0.0220,2172,72570,0.0000,0,2
2021-03-26,Brazil,203070494,Rio Grande do Norte,3302729,0.0801,16252,264428,0.0226,1961,74531,0.0000,0,2
2021-03-27,Brazil,203070494,Rio Grande do Norte,3302729,0.0833,10667,275095,0.0226,266,74797,0.0000,0,2
2021-03-28,Brazil,203070494,Rio Grande do Norte,3302729,0.0852,6443,281538,0.0228,590,75387,0.0000,0,2
2021-03-29,Brazil,203070494,Rio Grande do Norte,3302729,0.0921,22602,304140,0.0235,2107,77494,0.0000,0,2
2021-03-30,Brazil,203070494,Rio Grande do Norte,3302729,0.1005,27941,332081,0.0251,5287,82781,0.0000,0,2
2021-03-31,Brazil,203070494,Rio Grande do Norte,3302729,0.1079,24332,356413,0.0263,4220,87001,0.0000,1,3
2021-04-01,Brazil,203070494,Rio Grande do Norte,3302729,0.1098,6366,362779,0.0268,1639,88640,0.0000,0,3
2021-04-02,Brazil,203070494,Rio Grande do Norte,3302729,0.1107,2831,365610,0.0272,1268,89908,0.0000,0,3
2021-04-03,Brazil,203070494,Rio Grande do Norte,3302729,0.1126,6203,371813,0.0275,824,90732,0.0000,0,3
2021-04-04,Brazil,203070494,Rio Grande do Norte,3302729,0.1142,5473,377286,0.0277,669,91401,0.0000,0,3
2021-04-05,Brazil,203070494,Rio Grande do Norte,3302729,0.1189,15368,392654,0.0293,5379,96780,0.0000,0,3
2021-04-06,Brazil,203070494,Rio Grande do Norte,3302729,0.1221,10750,403404,0.0314,6959,103739,0.0000,0,3
2021-04-07,Brazil,203070494,Rio Grande do Norte,3302729,0.1256,11395,414799,0.0334,6558,110297,0.0000,0,3
2021-04-08,Brazil,203070494,Rio Grande do Norte,3302729,0.1281,8209,423008,0.0353,6221,116518,0.0000,0,3
2021-04-09,Brazil,203070494,Rio Grande do Norte,3302729,0.1295,4847,427855,0.0369,5193,121711,0.0000,0,3
2021-04-10,Brazil,203070494,Rio Grande do Norte,3302729,0.1314,6242,434097,0.0376,2567,124278,0.0000,0,3
2021-04-11,Brazil,203070494,Rio Grande do Norte,3302729,0.1323,2952,437049,0.0381,1526,125804,0.0000,0,3
2021-04-12,Brazil,203070494,Rio Grande do Norte,3302729,0.1342,6244,443293,0.0398,5547,131351,0.0000,0,3
2021-04-13,Brazil,203070494,Rio Grande do Norte,3302729,0.1360,5985,449278,0.0416,5908,137259,0.0000,0,3
2021-04-14,Brazil,203070494,Rio Grande do Norte,3302729,0.1371,3660,452938,0.0442,8662,145921,0.0000,0,3
2021-04-15,Brazil,203070494,Rio Grande do Norte,3302729,0.1381,3101,456039,0.0464,7462,153383,0.0000,0,3
2021-04-16,Brazil,203070494,Rio Grande do Norte,3302729,0.1386,1815,457854,0.0479,4927,158310,0.0000,0,3
2021-04-17,Brazil,203070494,Rio Grande do Norte,3302729,0.1400,4554,462408,0.0500,6955,165265,0.0000,0,3
2021-04-18,Brazil,203070494,Rio Grande do Norte,3302729,0.1406,1992,464400,0.0514,4657,169922,0.0000,0,3
2021-04-19,Brazil,203070494,Rio Grande do Norte,3302729,0.1419,4372,468772,0.0540,8307,178229,0.0000,2,5
2021-04-20,Brazil,203070494,Rio Grande do Norte,3302729,0.1445,8518,477290,0.0586,15446,193675,0.0000,0,5
2021-04-21,Brazil,203070494,Rio Grande do Norte,3302729,0.1458,4194,481484,0.0595,2726,196401,0.0000,1,6
2021-04-22,Brazil,203070494,Rio Grande do Norte,3302729,0.1477,6451,487935,0.0644,16438,212839,0.0000,0,6
2021-04-23,Brazil,203070494,Rio Grande do Norte,3302729,0.1489,3850,491785,0.0678,10928,223767,0.0000,0,6
2021-04-24,Brazil,203070494,Rio Grande do Norte,3302729,0.1497,2637,494422,0.0695,5829,229596,0.0000,0,6
2021-04-25,Brazil,203070494,Rio Grande do Norte,3302729,0.1502,1608,496030,0.0705,3190,232786,0.0000,0,6
2021-04-26,Brazil,203070494,Rio Grande do Norte,3302729,0.1536,11395,507425,0.0737,10598,243384,0.0000,0,6
2021-04-27,Brazil,203070494,Rio Grande do Norte,3302729,0.1564,9017,516442,0.0774,12271,255655,0.0000,0,6
2021-04-28,Brazil,203070494,Rio Grande do Norte,3302729,0.1584,6692,523134,0.0797,7501,263156,0.0000,0,6
2021-04-29,Brazil,203070494,Rio Grande do Norte,3302729,0.1611,8797,531931,0.0810,4332,267488,0.0000,0,6
2021-04-30,Brazil,203070494,Rio Grande do Norte,3302729,0.1626,4975,536906,0.0819,2850,270338,0.0000,0,6
2021-05-01,Brazil,203070494,Rio Grande do Norte,3302729,0.1630,1409,538315,0.0820,592,270930,0.0000,0,6
2021-05-02,Brazil,203070494,Rio Grande do Norte,3302729,0.1634,1351,539666,0.0822,432,271362,0.0000,0,6
2021-05-03,Brazil,203070494,Rio Grande do Norte,3302729,0.1651,5639,545305,0.0835,4299,275661,0.0000,0,6
2021-05-04,Brazil,203070494,Rio Grande do Norte,3302729,0.1679,9267,554572,0.0847,4163,279824,0.0000,0,6
2021-05-05,Brazil,203070494,Rio Grande do Norte,3302729,0.1707,9209,563781,0.0862,4917,284741,0.0000,0,6
2021-05-06,Brazil,203070494,Rio Grande do Norte,3302729,0.1738,10366,574147,0.0869,2163,286904,0.0000,0,6
2021-05-07,Brazil,203070494,Rio Grande do Norte,3302729,0.1761,7363,581510,0.0875,1998,288902,0.0000,0,6
2021-05-08,Brazil,203070494,Rio Grande do Norte,3302729,0.1770,2933,584443,0.0876,364,289266,0.0000,0,6
2021-05-09,Brazil,203070494,Rio Grande do Norte,3302729,0.1770,172,584615,0.0876,21,289287,0.0000,0,6
2021-05-10,Brazil,203070494,Rio Grande do Norte,3302729,0.1790,6624,591239,0.0903,8819,298106,0.0000,0,6
2021-05-11,Brazil,203070494,Rio Grande do Norte,3302729,0.1818,9090,600329,0.0913,3414,301520,0.0000,0,6
2021-05-12,Brazil,203070494,Rio Grande do Norte,3302729,0.1845,9128,609457,0.0921,2519,304039,0.0000,0,6
2021-05-13,Brazil,203070494,Rio Grande do Norte,3302729,0.1866,6842,616299,0.0925,1336,305375,0.0000,0,6
2021-05-14,Brazil,203070494,Rio Grande do Norte,3302729,0.1886,6622,622921,0.0964,12992,318367,0.0000,1,7
2021-05-15,Brazil,203070494,Rio Grande do Norte,3302729,0.1896,3177,626098,0.0999,11698,330065,0.0000,0,7
2021-05-16,Brazil,203070494,Rio Grande do Norte,3302729,0.1907,3750,629848,0.1004,1423,331488,0.0000,0,7
2021-05-17,Brazil,203070494,Rio Grande do Norte,3302729,0.1949,13938,643786,0.1020,5343,336831,0.0000,0,7
2021-05-18,Brazil,203070494,Rio Grande do Norte,3302729,0.2010,20100,663886,0.1051,10319,347150,0.0000,0,7
2021-05-19,Brazil,203070494,Rio Grande do Norte,3302729,0.2066,18493,682379,0.1084,10979,358129,0.0000,0,7
2021-05-20,Brazil,203070494,Rio Grande do Norte,3302729,0.2117,16831,699210,0.1099,4690,362819,0.0000,0,7
2021-05-21,Brazil,203070494,Rio Grande do Norte,3302729,0.2143,8483,707693,0.1124,8516,371335,0.0000,0,7
2021-05-22,Brazil,203070494,Rio Grande do Norte,3302729,0.2159,5427,713120,0.1130,1839,373174,0.0000,0,7
2021-05-23,Brazil,203070494,Rio Grande do Norte,3302729,0.2163,1305,714425,0.1136,1901,375075,0.0000,0,7
2021-05-24,Brazil,203070494,Rio Grande do Norte,3302729,0.2195,10366,724791,0.1149,4268,379343,0.0000,0,7
2021-05-25,Brazil,203070494,Rio Grande do Norte,3302729,0.2222,8952,733743,0.1161,4099,383442,0.0000,0,7
2021-05-26,Brazil,203070494,Rio Grande do Norte,3302729,0.2252,9944,743687,0.1173,3821,387263,0.0000,0,7
2021-05-27,Brazil,203070494,Rio Grande do Norte,3302729,0.2281,9630,753317,0.1181,2714,389977,0.0000,0,7
2021-05-28,Brazil,203070494,Rio Grande do Norte,3302729,0.2328,15487,768804,0.1188,2464,392441,0.0000,0,7
2021-05-29,Brazil,203070494,Rio Grande do Norte,3302729,0.2340,4192,772996,0.1190,621,393062,0.0000,0,7
2021-05-30,Brazil,203070494,Rio Grande do Norte,3302729,0.2344,1085,774081,0.1190,111,393173,0.0000,0,7
2021-05-31,Brazil,203070494,Rio Grande do Norte,3302729,0.2380,12024,786105,0.1198,2651,395824,0.0000,0,7
2021-06-01,Brazil,203070494,Rio Grande do Norte,3302729,0.2421,13526,799631,0.1211,4136,399960,0.0000,0,7
2021-06-02,Brazil,203070494,Rio Grande do Norte,3302729,0.2468,15499,815130,0.1225,4600,404560,0.0000,0,7
2021-06-03,Brazil,203070494,Rio Grande do Norte,3302729,0.2477,3022,818152,0.1227,810,405370,0.0000,0,7
2021-06-04,Brazil,203070494,Rio Grande do Norte,3302729,0.2498,6953,825105,0.1232,1380,406750,0.0000,0,7
2021-06-05,Brazil,203070494,Rio Grande do Norte,3302729,0.2516,5706,830811,0.1232,249,406999,0.0000,0,7
2021-06-06,Brazil,203070494,Rio Grande do Norte,3302729,0.2528,4027,834838,0.1233,76,407075,0.0000,0,7
2021-06-07,Brazil,203070494,Rio Grande do Norte,3302729,0.2575,15518,850356,0.1241,2697,409772,0.0000,0,7
2021-06-08,Brazil,203070494,Rio Grande do Norte,3302729,0.2641,21757,872113,0.1249,2722,412494,0.0000,0,7
2021-06-09,Brazil,203070494,Rio Grande do Norte,3302729,0.2697,18630,890743,0.1254,1522,414016,0.0000,0,7
2021-06-10,Brazil,203070494,Rio Grande do Norte,3302729,0.2752,18214,908957,0.1259,1656,415672,0.0000,0,7
2021-06-11,Brazil,203070494,Rio Grande do Norte,3302729,0.2805,17563,926520,0.1262,1135,416807,0.0000,0,7
2021-06-12,Brazil,203070494,Rio Grande do Norte,3302729,0.2878,23964,950484,0.1263,272,417079,0.0000,0,7
2021-06-13,Brazil,203070494,Rio Grande do Norte,3302729,0.2891,4244,954728,0.1263,36,417115,0.0000,0,7
2021-06-14,Brazil,203070494,Rio Grande do Norte,3302729,0.2971,26640,981368,0.1265,634,417749,0.0000,0,7
2021-06-15,Brazil,203070494,Rio Grande do Norte,3302729,0.3073,33676,1015044,0.1268,1025,418774,0.0000,1,8
2021-06-16,Brazil,203070494,Rio Grande do Norte,3302729,0.3181,35403,1050447,0.1271,1135,419909,0.0000,0,8
2021-06-17,Brazil,203070494,Rio Grande do Norte,3302729,0.3259,26061,1076508,0.1275,1070,420979,0.0000,0,8
2021-06-18,Brazil,203070494,Rio Grande do Norte,3302729,0.3321,20247,1096755,0.1278,1154,422133,0.0000,0,8
2021-06-19,Brazil,203070494,Rio Grande do Norte,3302729,0.3352,10332,1107087,0.1279,326,422459,0.0000,0,8
2021-06-20,Brazil,203070494,Rio Grande do Norte,3302729,0.3364,3933,1111020,0.1280,228,422687,0.0000,0,8
2021-06-21,Brazil,203070494,Rio Grande do Norte,3302729,0.3427,20679,1131699,0.1284,1301,423988,0.0000,2,10
2021-06-22,Brazil,203070494,Rio Grande do Norte,3302729,0.3495,22583,1154282,0.1289,1735,425723,0.0000,0,10
2021-06-23,Brazil,203070494,Rio Grande do Norte,3302729,0.3535,13092,1167374,0.1293,1201,426924,0.0000,0,10
2021-06-24,Brazil,203070494,Rio Grande do Norte,3302729,0.3558,7759,1175133,0.1296,1226,428150,0.0000,0,10
2021-06-25,Brazil,203070494,Rio Grande do Norte,3302729,0.3580,7223,1182356,0.1300,1368,429518,0.0000,0,10
2021-06-26,Brazil,203070494,Rio Grande do Norte,3302729,0.3611,10364,1192720,0.1301,233,429751,0.0000,0,10
2021-06-27,Brazil,203070494,Rio Grande do Norte,3302729,0.3621,3323,1196043,0.1301,55,429806,0.0000,0,10
2021-06-28,Brazil,203070494,Rio Grande do Norte,3302729,0.3683,20498,1216541,0.1307,1746,431552,0.0000,0,10
2021-06-29,Brazil,203070494,Rio Grande do Norte,3302729,0.3757,24354,1240895,0.1312,1826,433378,0.0000,0,10
2021-06-30,Brazil,203070494,Rio Grande do Norte,3302729,0.3821,21206,1262101,0.1323,3586,436964,0.0000,0,10
2021-07-01,Brazil,203070494,Rio Grande do Norte,3302729,0.3862,13249,1275350,0.1329,2128,439092,0.0000,0,10
2021-07-02,Brazil,203070494,Rio Grande do Norte,3302729,0.3929,22298,1297648,0.1334,1328,440420,0.0000,1,11
2021-07-03,Brazil,203070494,Rio Grande do Norte,3302729,0.3961,10416,1308064,0.1335,385,440805,0.0000,0,11
2021-07-04,Brazil,203070494,Rio Grande do Norte,3302729,0.3972,3721,1311785,0.1336,285,441090,0.0000,0,11
2021-07-05,Brazil,203070494,Rio Grande do Norte,3302729,0.4046,24444,1336229,0.1342,2125,443215,0.0000,1,12
2021-07-06,Brazil,203070494,Rio Grande do Norte,3302729,0.4136,29616,1365845,0.1349,2395,445610,0.0000,0,12
2021-07-07,Brazil,203070494,Rio Grande do Norte,3302729,0.4225,29401,1395246,0.1359,3219,448829,0.0000,0,12
2021-07-08,Brazil,203070494,Rio Grande do Norte,3302729,0.4300,24938,1420184,0.1367,2629,451458,0.0000,0,12
2021-07-09,Brazil,203070494,Rio Grande do Norte,3302729,0.4339,12826,1433010,0.1376,2912,454370,0.0000,0,12
2021-07-10,Brazil,203070494,Rio Grande do Norte,3302729,0.4366,8819,1441829,0.1380,1507,455877,0.0000,0,12
2021-07-11,Brazil,203070494,Rio Grande do Norte,3302729,0.4377,3920,1445749,0.1382,611,456488,0.0000,0,12
2021-07-12,Brazil,203070494,Rio Grande do Norte,3302729,0.4428,16802,1462551,0.1393,3634,460122,0.0000,2,14
2021-07-13,Brazil,203070494,Rio Grande do Norte,3302729,0.4468,12980,1475531,0.1407,4638,464760,0.0000,0,14
2021-07-14,Brazil,203070494,Rio Grande do Norte,3302729,0.4491,7812,1483343,0.1421,4692,469452,0.0000,0,14
2021-07-15,Brazil,203070494,Rio Grande do Norte,3302729,0.4514,7583,1490926,0.1432,3407,472859,0.0000,0,14
2021-07-16,Brazil,203070494,Rio Grande do Norte,3302729,0.4551,12094,1503020,0.1442,3508,476367,0.0000,0,14
2021-07-17,Brazil,203070494,Rio Grande do Norte,3302729,0.4578,8895,1511915,0.1449,2156,478523,0.0000,0,14
2021-07-18,Brazil,203070494,Rio Grande do Norte,3302729,0.4587,2919,1514834,0.1453,1284,479807,0.0000,0,14
2021-07-19,Brazil,203070494,Rio Grande do Norte,3302729,0.4637,16656,1531490,0.1475,7481,487288,0.0000,0,14
2021-07-20,Brazil,203070494,Rio Grande do Norte,3302729,0.4688,16683,1548173,0.1502,8881,496169,0.0000,0,14
2021-07-21,Brazil,203070494,Rio Grande do Norte,3302729,0.4710,7574,1555747,0.1528,8340,504509,0.0000,0,14
2021-07-22,Brazil,203070494,Rio Grande do Norte,3302729,0.4764,17817,1573564,0.1548,6674,511183,0.0000,0,14
2021-07-23,Brazil,203070494,Rio Grande do Norte,3302729,0.4860,31558,1605122,0.1563,5131,516314,0.0000,0,14
2021-07-24,Brazil,203070494,Rio Grande do Norte,3302729,0.4890,10060,1615182,0.1569,2046,518360,0.0000,0,14
2021-07-25,Brazil,203070494,Rio Grande do Norte,3302729,0.4902,3704,1618886,0.1572,980,519340,0.0000,0,14
2021-07-26,Brazil,203070494,Rio Grande do Norte,3302729,0.4950,15893,1634779,0.1599,8863,528203,0.0000,0,14
2021-07-27,Brazil,203070494,Rio Grande do Norte,3302729,0.4982,10745,1645524,0.1634,11627,539830,0.0000,0,14
2021-07-28,Brazil,203070494,Rio Grande do Norte,3302729,0.5008,8451,1653975,0.1668,10926,550756,0.0000,0,14
2021-07-29,Brazil,203070494,Rio Grande do Norte,3302729,0.5069,20117,1674092,0.1700,10768,561524,0.0000,0,14
2021-07-30,Brazil,203070494,Rio Grande do Norte,3302729,0.5118,16107,1690199,0.1725,8275,569799,0.0000,0,14
2021-07-31,Brazil,203070494,Rio Grande do Norte,3302729,0.5125,2322,1692521,0.1735,3367,573166,0.0000,0,14
2021-08-01,Brazil,203070494,Rio Grande do Norte,3302729,0.5129,1530,1694051,0.1739,1119,574285,0.0000,0,14
2021-08-02,Brazil,203070494,Rio Grande do Norte,3302729,0.5185,18445,1712496,0.1767,9293,583578,0.0000,0,14
2021-08-03,Brazil,203070494,Rio Grande do Norte,3302729,0.5274,29518,1742014,0.1800,11013,594591,0.0000,0,14
2021-08-04,Brazil,203070494,Rio Grande do Norte,3302729,0.5345,23459,1765473,0.1840,13112,607703,0.0000,0,14
2021-08-05,Brazil,203070494,Rio Grande do Norte,3302729,0.5382,12176,1777649,0.1874,11224,618927,0.0000,0,14
2021-08-06,Brazil,203070494,Rio Grande do Norte,3302729,0.5446,21076,1798725,0.1896,7329,626256,0.0000,0,14
2021-08-07,Brazil,203070494,Rio Grande do Norte,3302729,0.5475,9684,1808409,0.1902,1850,628106,0.0000,0,14
2021-08-08,Brazil,203070494,Rio Grande do Norte,3302729,0.5483,2367,1810776,0.1904,662,628768,0.0000,0,14
2021-08-09,Brazil,203070494,Rio Grande do Norte,3302729,0.5559,25259,1836035,0.1939,11483,640251,0.0000,0,14
2021-08-10,Brazil,203070494,Rio Grande do Norte,3302729,0.5657,32393,1868428,0.1980,13602,653853,0.0000,0,14
2021-08-11,Brazil,203070494,Rio Grande do Norte,3302729,0.5746,29201,1897629,0.2027,15466,669319,0.0000,0,14
2021-08-12,Brazil,203070494,Rio Grande do Norte,3302729,0.5858,37084,1934713,0.2063,11873,681192,0.0000,0,14
2021-08-13,Brazil,203070494,Rio Grande do Norte,3302729,0.5941,27581,1962294,0.2090,8934,690126,0.0000,2,16
2021-08-14,Brazil,203070494,Rio Grande do Norte,3302729,0.5951,3297,1965591,0.2101,3613,693739,0.0000,0,16
2021-08-15,Brazil,203070494,Rio Grande do Norte,3302729,0.5963,3971,1969562,0.2102,490,694229,0.0000,0,16
2021-08-16,Brazil,203070494,Rio Grande do Norte,3302729,0.6054,29928,1999490,0.2133,10407,704636,0.0000,0,16
2021-08-17,Brazil,203070494,Rio Grande do Norte,3302729,0.6160,34899,2034389,0.2170,12095,716731,0.0000,0,16
2021-08-18,Brazil,203070494,Rio Grande do Norte,3302729,0.6250,29931,2064320,0.2216,15011,731742,0.0000,1,17
2021-08-19,Brazil,203070494,Rio Grande do Norte,3302729,0.6362,36861,2101181,0.2258,14146,745888,0.0000,0,17
2021-08-20,Brazil,203070494,Rio Grande do Norte,3302729,0.6425,20842,2122023,0.2294,11794,757682,0.0000,1,18
2021-08-21,Brazil,203070494,Rio Grande do Norte,3302729,0.6455,9741,2131764,0.2320,8440,766122,0.0000,0,18
2021-08-22,Brazil,203070494,Rio Grande do Norte,3302729,0.6458,1153,2132917,0.2322,683,766805,0.0000,0,18
2021-08-23,Brazil,203070494,Rio Grande do Norte,3302729,0.6509,16980,2149897,0.2361,12950,779755,0.0000,0,18
2021-08-24,Brazil,203070494,Rio Grande do Norte,3302729,0.6608,32382,2182279,0.2407,15173,794928,0.0000,0,18
2021-08-25,Brazil,203070494,Rio Grande do Norte,3302729,0.6672,21403,2203682,0.2456,16139,811067,0.0000,0,18
2021-08-26,Brazil,203070494,Rio Grande do Norte,3302729,0.6729,18587,2222269,0.2506,16474,827541,0.0000,0,18
2021-08-27,Brazil,203070494,Rio Grande do Norte,3302729,0.6773,14745,2237014,0.2551,14864,842405,0.0000,1,19
2021-08-28,Brazil,203070494,Rio Grande do Norte,3302729,0.6800,8892,2245906,0.2588,12267,854672,0.0000,0,19
2021-08-29,Brazil,203070494,Rio Grande do Norte,3302729,0.6801,440,2246346,0.2589,518,855190,0.0000,0,19
2021-08-30,Brazil,203070494,Rio Grande do Norte,3302729,0.6826,8239,2254585,0.2653,21040,876230,0.0000,0,19
2021-08-31,Brazil,203070494,Rio Grande do Norte,3302729,0.6857,10015,2264600,0.2731,25601,901831,0.0000,0,19
2021-09-01,Brazil,203070494,Rio Grande do Norte,3302729,0.6886,9673,2274273,0.2809,25954,927785,0.0000,0,19
2021-09-02,Brazil,203070494,Rio Grande do Norte,3302729,0.6915,9596,2283869,0.2886,25422,953207,0.0000,0,19
2021-09-03,Brazil,203070494,Rio Grande do Norte,3302729,0.6935,6419,2290288,0.2971,27937,981144,0.0000,0,19
2021-09-04,Brazil,203070494,Rio Grande do Norte,3302729,0.6941,2085,2292373,0.3002,10196,991340,0.0000,0,19
2021-09-05,Brazil,203070494,Rio Grande do Norte,3302729,0.6942,225,2292598,0.3008,1976,993316,0.0000,0,19
2021-09-06,Brazil,203070494,Rio Grande do Norte,3302729,0.6945,1267,2293865,0.3036,9455,1002771,0.0000,0,19
2021-09-07,Brazil,203070494,Rio Grande do Norte,3302729,0.6948,717,2294582,0.3052,5148,1007919,0.0000,0,19
2021-09-08,Brazil,203070494,Rio Grande do Norte,3302729,0.6964,5418,2300000,0.3181,42726,1050645,0.0000,0,19
2021-09-09,Brazil,203070494,Rio Grande do Norte,3302729,0.6986,7183,2307183,0.3320,46016,1096661,0.0000,0,19
2021-09-10,Brazil,203070494,Rio Grande do Norte,3302729,0.7004,5927,2313110,0.3427,35091,1131752,0.0000,0,19
2021-09-11,Brazil,203070494,Rio Grande do Norte,3302729,0.7015,3799,2316909,0.3455,9400,1141152,0.0000,0,19
2021-09-12,Brazil,203070494,Rio Grande do Norte,3302729,0.7016,357,2317266,0.3457,684,1141836,0.0000,0,19
2021-09-13,Brazil,203070494,Rio Grande do Norte,3302729,0.7048,10449,2327715,0.3545,29109,1170945,0.0000,2,21
2021-09-14,Brazil,203070494,Rio Grande do Norte,3302729,0.7080,10762,2338477,0.3633,29036,1199981,0.0000,0,21
2021-09-15,Brazil,203070494,Rio Grande do Norte,3302729,0.7129,16118,2354595,0.3718,27998,1227979,0.0000,1,22
2021-09-16,Brazil,203070494,Rio Grande do Norte,3302729,0.7185,18332,2372927,0.3784,21714,1249693,0.0000,1,23
2021-09-17,Brazil,203070494,Rio Grande do Norte,3302729,0.7226,13664,2386591,0.3835,16923,1266616,0.0000,0,23
2021-09-18,Brazil,203070494,Rio Grande do Norte,3302729,0.7242,5158,2391749,0.3854,6370,1272986,0.0000,0,23
2021-09-19,Brazil,203070494,Rio Grande do Norte,3302729,0.7245,1148,2392897,0.3857,741,1273727,0.0000,0,23
2021-09-20,Brazil,203070494,Rio Grande do Norte,3302729,0.7280,11348,2404245,0.3910,17630,1291357,0.0000,0,23
2021-09-21,Brazil,203070494,Rio Grande do Norte,3302729,0.7328,15920,2420165,0.3974,21310,1312667,0.0000,0,23
2021-09-22,Brazil,203070494,Rio Grande do Norte,3302729,0.7375,15755,2435920,0.4045,23416,1336083,0.0000,1,24
2021-09-23,Brazil,203070494,Rio Grande do Norte,3302729,0.7422,15401,2451321,0.4108,20519,1356602,0.0000,3,27
2021-09-24,Brazil,203070494,Rio Grande do Norte,3302729,0.7463,13457,2464778,0.4153,14890,1371492,0.0000,0,27
2021-09-25,Brazil,203070494,Rio Grande do Norte,3302729,0.7478,5112,2469890,0.4167,4804,1376296,0.0000,0,27
2021-09-26,Brazil,203070494,Rio Grande do Norte,3302729,0.7481,880,2470770,0.4170,964,1377260,0.0000,0,27
2021-09-27,Brazil,203070494,Rio Grande do Norte,3302729,0.7514,10942,2481712,0.4214,14624,1391884,0.0000,0,27
2021-09-28,Brazil,203070494,Rio Grande do Norte,3302729,0.7558,14559,2496271,0.4267,17330,1409214,0.0000,1,28
2021-09-29,Brazil,203070494,Rio Grande do Norte,3302729,0.7597,12947,2509218,0.4310,14196,1423410,0.0000,0,28
2021-09-30,Brazil,203070494,Rio Grande do Norte,3302729,0.7628,10074,2519292,0.4351,13670,1437080,0.0000,0,28
2021-10-01,Brazil,203070494,Rio Grande do Norte,3302729,0.7635,2265,2521557,0.4361,3381,1440461,0.0000,1,29
2021-10-02,Brazil,203070494,Rio Grande do Norte,3302729,0.7636,293,2521850,0.4363,666,1441127,0.0000,0,29
2021-10-03,Brazil,203070494,Rio Grande do Norte,3302729,0.7636,14,2521864,0.4364,108,1441235,0.0000,0,29
2021-10-04,Brazil,203070494,Rio Grande do Norte,3302729,0.7641,1679,2523543,0.4374,3221,1444456,0.0000,6,35
2021-10-05,Brazil,203070494,Rio Grande do Norte,3302729,0.7651,3265,2526808,0.4392,6261,1450717,0.0000,7,42
2021-10-06,Brazil,203070494,Rio Grande do Norte,3302729,0.7675,8050,2534858,0.4441,15910,1466627,0.0000,10,52
2021-10-07,Brazil,203070494,Rio Grande do Norte,3302729,0.7698,7743,2542601,0.4494,17568,1484195,0.0000,10,62
2021-10-08,Brazil,203070494,Rio Grande do Norte,3302729,0.7714,5185,2547786,0.4539,15053,1499248,0.0000,10,72
2021-10-09,Brazil,203070494,Rio Grande do Norte,3302729,0.7719,1717,2549503,0.4558,6079,1505327,0.0000,5,77
2021-10-10,Brazil,203070494,Rio Grande do Norte,3302729,0.7720,266,2549769,0.4563,1631,1506958,0.0000,0,77
2021-10-11,Brazil,203070494,Rio Grande do Norte,3302729,0.7723,926,2550695,0.4574,3676,1510634,0.0000,6,83
2021-10-12,Brazil,203070494,Rio Grande do Norte,3302729,0.7725,516,2551211,0.4581,2341,1512975,0.0000,7,90
2021-10-13,Brazil,203070494,Rio Grande do Norte,3302729,0.7740,4988,2556199,0.4648,21971,1534946,0.0000,6,96
2021-10-14,Brazil,203070494,Rio Grande do Norte,3302729,0.7754,4736,2560935,0.4709,20421,1555367,0.0000,2,98
2021-10-15,Brazil,203070494,Rio Grande do Norte,3302729,0.7767,4197,2565132,0.4757,15756,1571123,0.0000,15,113
2021-10-16,Brazil,203070494,Rio Grande do Norte,3302729,0.7780,4447,2569579,0.4784,8824,1579947,0.0000,6,119
2021-10-17,Brazil,203070494,Rio Grande do Norte,3302729,0.7781,140,2569719,0.4788,1347,1581294,0.0000,0,119
2021-10-18,Brazil,203070494,Rio Grande do Norte,3302729,0.7792,3613,2573332,0.4837,16163,1597457,0.0000,35,154
2021-10-19,Brazil,203070494,Rio Grande do Norte,3302729,0.7805,4586,2577918,0.4892,18261,1615718,0.0001,17,171
2021-10-20,Brazil,203070494,Rio Grande do Norte,3302729,0.7820,4664,2582582,0.4955,20685,1636403,0.0001,9,180
2021-10-21,Brazil,203070494,Rio Grande do Norte,3302729,0.7836,5549,2588131,0.5019,21099,1657502,0.0001,10,190
2021-10-22,Brazil,203070494,Rio Grande do Norte,3302729,0.7849,4178,2592309,0.5072,17566,1675068,0.0001,5,195
2021-10-23,Brazil,203070494,Rio Grande do Norte,3302729,0.7852,1094,2593403,0.5087,4875,1679943,0.0001,1,196
2021-10-24,Brazil,203070494,Rio Grande do Norte,3302729,0.7853,124,2593527,0.5089,894,1680837,0.0001,1,197
2021-10-25,Brazil,203070494,Rio Grande do Norte,3302729,0.7863,3504,2597031,0.5135,15102,1695939,0.0001,7,204
2021-10-26,Brazil,203070494,Rio Grande do Norte,3302729,0.7875,3804,2600835,0.5186,16921,1712860,0.0001,7,211
2021-10-27,Brazil,203070494,Rio Grande do Norte,3302729,0.7886,3709,2604544,0.5235,16024,1728884,0.0001,1,212
2021-10-28,Brazil,203070494,Rio Grande do Norte,3302729,0.7897,3618,2608162,0.5285,16469,1745353,0.0001,10,222
2021-10-29,Brazil,203070494,Rio Grande do Norte,3302729,0.7905,2551,2610713,0.5326,13560,1758913,0.0001,3,225
2021-10-30,Brazil,203070494,Rio Grande do Norte,3302729,0.7907,670,2611383,0.5339,4351,1763264,0.0001,1,226
2021-10-31,Brazil,203070494,Rio Grande do Norte,3302729,0.7907,85,2611468,0.5342,993,1764257,0.0001,0,226
2021-11-01,Brazil,203070494,Rio Grande do Norte,3302729,0.7908,451,2611919,0.5350,2569,1766826,0.0001,0,226
2021-11-02,Brazil,203070494,Rio Grande do Norte,3302729,0.7909,298,2612217,0.5353,1219,1768045,0.0001,1,227
2021-11-03,Brazil,203070494,Rio Grande do Norte,3302729,0.7918,2820,2615037,0.5410,18631,1786676,0.0001,1,228
2021-11-04,Brazil,203070494,Rio Grande do Norte,3302729,0.7929,3539,2618576,0.5473,20772,1807448,0.0001,6,234
2021-11-05,Brazil,203070494,Rio Grande do Norte,3302729,0.7940,3664,2622240,0.5525,17209,1824657,0.0001,2,236
2021-11-06,Brazil,203070494,Rio Grande do Norte,3302729,0.7941,352,2622592,0.5532,2337,1826994,0.0001,0,236
2021-11-07,Brazil,203070494,Rio Grande do Norte,3302729,0.7941,158,2622750,0.5535,1085,1828079,0.0001,0,236
2021-11-08,Brazil,203070494,Rio Grande do Norte,3302729,0.7949,2685,2625435,0.5579,14603,1842682,0.0001,4,240
2021-11-09,Brazil,203070494,Rio Grande do Norte,3302729,0.7961,3714,2629149,0.5636,18770,1861452,0.0001,2,242
2021-11-10,Brazil,203070494,Rio Grande do Norte,3302729,0.7969,2885,2632034,0.5694,19003,1880455,0.0001,8,250
2021-11-11,Brazil,203070494,Rio Grande do Norte,3302729,0.7979,3303,2635337,0.5764,23261,1903716,0.0001,5,255
2021-11-12,Brazil,203070494,Rio Grande do Norte,3302729,0.7987,2646,2637983,0.5813,16045,1919761,0.0001,5,260
2021-11-13,Brazil,203070494,Rio Grande do Norte,3302729,0.7989,691,2638674,0.5826,4288,1924049,0.0001,4,264
2021-11-14,Brazil,203070494,Rio Grande do Norte,3302729,0.7990,108,2638782,0.5828,873,1924922,0.0001,0,264
2021-11-15,Brazil,203070494,Rio Grande do Norte,3302729,0.7990,262,2639044,0.5831,926,1925848,0.0001,4,268
2021-11-16,Brazil,203070494,Rio Grande do Norte,3302729,0.7997,2305,2641349,0.5889,19018,1944866,0.0001,13,281
2021-11-17,Brazil,203070494,Rio Grande do Norte,3302729,0.8005,2580,2643929,0.5952,20790,1965656,0.0001,7,288
2021-11-18,Brazil,203070494,Rio Grande do Norte,3302729,0.8014,2722,2646651,0.6013,20394,1986050,0.0001,9,297
2021-11-19,Brazil,203070494,Rio Grande do Norte,3302729,0.8020,2222,2648873,0.6059,15161,2001211,0.0001,12,309
2021-11-20,Brazil,203070494,Rio Grande do Norte,3302729,0.8022,613,2649486,0.6071,3850,2005061,0.0001,6,315
2021-11-21,Brazil,203070494,Rio Grande do Norte,3302729,0.8023,167,2649653,0.6076,1538,2006599,0.0001,1,316
2021-11-22,Brazil,203070494,Rio Grande do Norte,3302729,0.8029,2199,2651852,0.6118,13974,2020573,0.0001,5,321
2021-11-23,Brazil,203070494,Rio Grande do Norte,3302729,0.8036,2348,2654200,0.6151,10936,2031509,0.0001,4,325
2021-11-24,Brazil,203070494,Rio Grande do Norte,3302729,0.8045,2788,2656988,0.6200,16156,2047665,0.0001,1,326
2021-11-25,Brazil,203070494,Rio Grande do Norte,3302729,0.8053,2681,2659669,0.6244,14483,2062148,0.0001,4,330
2021-11-26,Brazil,203070494,Rio Grande do Norte,3302729,0.8057,1301,2660970,0.6263,6284,2068432,0.0001,1,331
2021-11-27,Brazil,203070494,Rio Grande do Norte,3302729,0.8067,3486,2664456,0.6308,14807,2083239,0.0001,2,333
2021-11-28,Brazil,203070494,Rio Grande do Norte,3302729,0.8068,105,2664561,0.6311,1120,2084359,0.0001,0,333
2021-11-29,Brazil,203070494,Rio Grande do Norte,3302729,0.8073,1752,2666313,0.6342,10308,2094667,0.0001,4,337
2021-11-30,Brazil,203070494,Rio Grande do Norte,3302729,0.8079,1968,2668281,0.6375,10925,2105592,0.0001,3,340
2021-12-01,Brazil,203070494,Rio Grande do Norte,3302729,0.8084,1480,2669761,0.6401,8393,2113985,0.0001,0,340
2021-12-02,Brazil,203070494,Rio Grande do Norte,3302729,0.8086,963,2670724,0.6416,4948,2118933,0.0001,1,341
2021-12-03,Brazil,203070494,Rio Grande do Norte,3302729,0.8092,1781,2672505,0.6440,7880,2126813,0.0001,2,343
2021-12-04,Brazil,203070494,Rio Grande do Norte,3302729,0.8094,701,2673206,0.6453,4415,2131228,0.0001,0,343
2021-12-05,Brazil,203070494,Rio Grande do Norte,3302729,0.8094,88,2673294,0.6455,693,2131921,0.0001,0,343
2021-12-06,Brazil,203070494,Rio Grande do Norte,3302729,0.8099,1714,2675008,0.6479,7840,2139761,0.0001,1,344
2021-12-07,Brazil,203070494,Rio Grande do Norte,3302729,0.8106,2022,2677030,0.6513,11400,2151161,0.0001,1,345
2021-12-08,Brazil,203070494,Rio Grande do Norte,3302729,0.8110,1553,2678583,0.6539,8567,2159728,0.0001,1,346
2021-12-09,Brazil,203070494,Rio Grande do Norte,3302729,0.8115,1542,2680125,0.6565,8661,2168389,0.0001,5,351
2021-12-10,Brazil,203070494,Rio Grande do Norte,3302729,0.8120,1610,2681735,0.6592,8831,2177220,0.0001,10,361
2021-12-11,Brazil,203070494,Rio Grande do Norte,3302729,0.8121,540,2682275,0.6600,2455,2179675,0.0001,7,368
2021-12-12,Brazil,203070494,Rio Grande do Norte,3302729,0.8122,137,2682412,0.6602,692,2180367,0.0001,0,368
2021-12-13,Brazil,203070494,Rio Grande do Norte,3302729,0.8126,1432,2683844,0.6622,6715,2187082,0.0001,8,376
2021-12-14,Brazil,203070494,Rio Grande do Norte,3302729,0.8131,1694,2685538,0.6648,8423,2195505,0.0001,8,384
2021-12-15,Brazil,203070494,Rio Grande do Norte,3302729,0.8137,1991,2687529,0.6677,9680,2205185,0.0001,18,402
2021-12-16,Brazil,203070494,Rio Grande do Norte,3302729,0.8143,1783,2689312,0.6707,9809,2214994,0.0001,3,405
2021-12-17,Brazil,203070494,Rio Grande do Norte,3302729,0.8147,1418,2690730,0.6725,6054,2221048,0.0001,11,416
2021-12-18,Brazil,203070494,Rio Grande do Norte,3302729,0.8148,336,2691066,0.6730,1539,2222587,0.0001,5,421
2021-12-19,Brazil,203070494,Rio Grande do Norte,3302729,0.8149,165,2691231,0.6732,696,2223283,0.0001,0,421
2021-12-20,Brazil,203070494,Rio Grande do Norte,3302729,0.8153,1555,2692786,0.6754,7417,2230700,0.0001,8,429
2021-12-21,Brazil,203070494,Rio Grande do Norte,3302729,0.8158,1649,2694435,0.6778,7745,2238445,0.0001,7,436
2021-12-22,Brazil,203070494,Rio Grande do Norte,3302729,0.8163,1567,2696002,0.6802,8020,2246465,0.0001,3,439
2021-12-23,Brazil,203070494,Rio Grande do Norte,3302729,0.8167,1215,2697217,0.6820,6045,2252510,0.0001,1,440
2021-12-24,Brazil,203070494,Rio Grande do Norte,3302729,0.8167,102,2697319,0.6822,477,2252987,0.0001,0,440
2021-12-25,Brazil,203070494,Rio Grande do Norte,3302729,0.8167,21,2697340,0.6822,96,2253083,0.0001,0,440
2021-12-26,Brazil,203070494,Rio Grande do Norte,3302729,0.8167,29,2697369,0.6822,121,2253204,0.0001,0,440
2021-12-27,Brazil,203070494,Rio Grande do Norte,3302729,0.8169,702,2698071,0.6833,3413,2256617,0.0001,3,443
2021-12-28,Brazil,203070494,Rio Grande do Norte,3302729,0.8172,873,2698944,0.6847,4745,2261362,0.0001,4,447
2021-12-29,Brazil,203070494,Rio Grande do Norte,3302729,0.8175,955,2699899,0.6861,4502,2265864,0.0001,3,450
2021-12-30,Brazil,203070494,Rio Grande do Norte,3302729,0.8177,725,2700624,0.6871,3279,2269143,0.0001,2,452
2021-12-31,Brazil,203070494,Rio Grande do Norte,3302729,0.8177,69,2700693,0.6871,267,2269410,0.0001,0,452
2021-01-03,Brazil,203070494,Rio Grande do Sul,10882965,0.0000,0,0,0.0000,0,0,0.0000,0,0
2021-01-04,Brazil,203070494,Rio Grande do Sul,10882965,0.0000,1,1,0.0000,29,29,0.0000,0,0
2021-01-05,Brazil,203070494,Rio Grande do Sul,10882965,0.0000,0,1,0.0000,34,63,0.0000,0,0
2021-01-06,Brazil,203070494,Rio Grande do Sul,10882965,0.0000,0,1,0.0000,34,97,0.0000,0,0
2021-01-07,Brazil,203070494,Rio Grande do Sul,10882965,0.0000,2,3,0.0000,14,111,0.0000,0,0
2021-01-08,Brazil,203070494,Rio Grande do Sul,10882965,0.0000,2,5,0.0000,22,133,0.0000,0,0
2021-01-09,Brazil,203070494,Rio Grande do Sul,10882965,0.0000,0,5,0.0000,1,134,0.0000,0,0
2021-01-11,Brazil,203070494,Rio Grande do Sul,10882965,0.0000,2,7,0.0000,4,138,0.0000,0,0
2021-01-12,Brazil,203070494,Rio Grande do Sul,10882965,0.0000,3,10,0.0000,2,140,0.0000,0,0
2021-01-13,Brazil,203070494,Rio Grande do Sul,10882965,0.0000,1,11,0.0000,1,141,0.0000,0,0
2021-01-14,Brazil,203070494,Rio Grande do Sul,10882965,0.0000,11,22,0.0000,6,147,0.0000,0,0
2021-01-15,Brazil,203070494,Rio Grande do Sul,10882965,0.0000,3,25,0.0000,0,147,0.0000,0,0
2021-01-17,Brazil,203070494,Rio Grande do Sul,10882965,0.0000,39,64,0.0000,6,153,0.0000,0,0
2021-01-18,Brazil,203070494,Rio Grande do Sul,10882965,0.0000,233,297,0.0000,12,165,0.0000,0,0
2021-01-19,Brazil,203070494,Rio Grande do Sul,10882965,0.0002,1817,2114,0.0000,2,167,0.0000,0,0
2021-01-20,Brazil,203070494,Rio Grande do Sul,10882965,0.0030,30815,32929,0.0000,23,190,0.0000,0,0
2021-01-21,Brazil,203070494,Rio Grande do Sul,10882965,0.0058,30479,63408,0.0000,24,214,0.0000,0,0
2021-01-22,Brazil,203070494,Rio Grande do Sul,10882965,0.0079,22401,85809,0.0000,82,296,0.0000,0,0
2021-01-23,Brazil,203070494,Rio Grande do Sul,10882965,0.0081,2866,88675,0.0000,13,309,0.0000,0,0
2021-01-24,Brazil,203070494,Rio Grande do Sul,10882965,0.0082,543,89218,0.0000,0,309,0.0000,0,0
2021-01-25,Brazil,203070494,Rio Grande do Sul,10882965,0.0095,14270,103488,0.0000,23,332,0.0000,0,0
2021-01-26,Brazil,203070494,Rio Grande do Sul,10882965,0.0114,20183,123671,0.0000,18,350,0.0000,0,0
2021-01-27,Brazil,203070494,Rio Grande do Sul,10882965,0.0132,19946,143617,0.0000,20,370,0.0000,0,0
2021-01-28,Brazil,203070494,Rio Grande do Sul,10882965,0.0150,19773,163390,0.0000,21,391,0.0000,0,0
2021-01-29,Brazil,203070494,Rio Grande do Sul,10882965,0.0170,21227,184617,0.0000,16,407,0.0000,0,0
2021-01-30,Brazil,203070494,Rio Grande do Sul,10882965,0.0173,3981,188598,0.0000,4,411,0.0000,0,0
2021-01-31,Brazil,203070494,Rio Grande do Sul,10882965,0.0173,110,188708,0.0000,0,411,0.0000,0,0
2021-02-01,Brazil,203070494,Rio Grande do Sul,10882965,0.0185,12562,201270,0.0000,10,421,0.0000,0,0
2021-02-02,Brazil,203070494,Rio Grande do Sul,10882965,0.0192,7495,208765,0.0000,23,444,0.0000,0,0
2021-02-03,Brazil,203070494,Rio Grande do Sul,10882965,0.0205,13880,222645,0.0000,53,497,0.0000,0,0
2021-02-04,Brazil,203070494,Rio Grande do Sul,10882965,0.0219,15603,238248,0.0001,123,620,0.0000,0,0
2021-02-05,Brazil,203070494,Rio Grande do Sul,10882965,0.0230,12555,250803,0.0001,612,1232,0.0000,0,0
2021-02-06,Brazil,203070494,Rio Grande do Sul,10882965,0.0237,7242,258045,0.0001,66,1298,0.0000,0,0
2021-02-07,Brazil,203070494,Rio Grande do Sul,10882965,0.0237,389,258434,0.0001,16,1314,0.0000,0,0
2021-02-08,Brazil,203070494,Rio Grande do Sul,10882965,0.0246,9590,268024,0.0002,755,2069,0.0000,0,0
2021-02-09,Brazil,203070494,Rio Grande do Sul,10882965,0.0262,17068,285092,0.0003,1015,3084,0.0000,0,0
2021-02-10,Brazil,203070494,Rio Grande do Sul,10882965,0.0298,39535,324627,0.0005,2882,5966,0.0000,0,0
2021-02-11,Brazil,203070494,Rio Grande do Sul,10882965,0.0335,39457,364084,0.0010,5284,11250,0.0000,0,0
2021-02-12,Brazil,203070494,Rio Grande do Sul,10882965,0.0365,32650,396734,0.0016,6062,17312,0.0000,0,0
2021-02-13,Brazil,203070494,Rio Grande do Sul,10882965,0.0372,8521,405255,0.0016,524,17836,0.0000,0,0
2021-02-14,Brazil,203070494,Rio Grande do Sul,10882965,0.0373,546,405801,0.0016,20,17856,0.0000,0,0
2021-02-15,Brazil,203070494,Rio Grande do Sul,10882965,0.0377,4888,410689,0.0019,2860,20716,0.0000,0,0
2021-02-16,Brazil,203070494,Rio Grande do Sul,10882965,0.0385,7831,418520,0.0024,5295,26011,0.0000,0,0
2021-02-17,Brazil,203070494,Rio Grande do Sul,10882965,0.0398,14458,432978,0.0042,19657,45668,0.0000,0,0
2021-02-18,Brazil,203070494,Rio Grande do Sul,10882965,0.0413,16156,449134,0.0064,23739,69407,0.0000,1,1
2021-02-19,Brazil,203070494,Rio Grande do Sul,10882965,0.0424,12524,461658,0.0080,17571,86978,0.0000,0,1
2021-02-20,Brazil,203070494,Rio Grande do Sul,10882965,0.0427,2975,464633,0.0083,2979,89957,0.0000,0,1
2021-02-21,Brazil,203070494,Rio Grande do Sul,10882965,0.0428,740,465373,0.0083,101,90058,0.0000,0,1
2021-02-22,Brazil,203070494,Rio Grande do Sul,10882965,0.0433,5531,470904,0.0094,11880,101938,0.0000,0,1
2021-02-23,Brazil,203070494,Rio Grande do Sul,10882965,0.0439,6849,477753,0.0102,8954,110892,0.0000,0,1
2021-02-24,Brazil,203070494,Rio Grande do Sul,10882965,0.0443,4051,481804,0.0108,7018,117910,0.0000,0,1
2021-02-25,Brazil,203070494,Rio Grande do Sul,10882965,0.0447,4313,486117,0.0114,6150,124060,0.0000,0,1
2021-02-26,Brazil,203070494,Rio Grande do Sul,10882965,0.0463,17482,503599,0.0119,5271,129331,0.0000,0,1
2021-02-27,Brazil,203070494,Rio Grande do Sul,10882965,0.0478,16404,520003,0.0119,359,129690,0.0000,0,1
2021-02-28,Brazil,203070494,Rio Grande do Sul,10882965,0.0481,3169,523172,0.0119,35,129725,0.0000,0,1
2021-03-01,Brazil,203070494,Rio Grande do Sul,10882965,0.0501,22444,545616,0.0124,5596,135321,0.0000,0,1
2021-03-02,Brazil,203070494,Rio Grande do Sul,10882965,0.0528,29056,574672,0.0129,5289,140610,0.0000,0,1
2021-03-03,Brazil,203070494,Rio Grande do Sul,10882965,0.0545,18981,593653,0.0136,7863,148473,0.0000,0,1
2021-03-04,Brazil,203070494,Rio Grande do Sul,10882965,0.0557,12568,606221,0.0143,7687,156160,0.0000,0,1
2021-03-05,Brazil,203070494,Rio Grande do Sul,10882965,0.0568,12472,618693,0.0154,11392,167552,0.0000,0,1
2021-03-06,Brazil,203070494,Rio Grande do Sul,10882965,0.0571,2586,621279,0.0157,3034,170586,0.0000,0,1
2021-03-07,Brazil,203070494,Rio Grande do Sul,10882965,0.0571,84,621363,0.0157,749,171335,0.0000,0,1
2021-03-08,Brazil,203070494,Rio Grande do Sul,10882965,0.0577,6193,627556,0.0169,12528,183863,0.0000,0,1
2021-03-09,Brazil,203070494,Rio Grande do Sul,10882965,0.0581,4818,632374,0.0185,17551,201414,0.0000,0,1
2021-03-10,Brazil,203070494,Rio Grande do Sul,10882965,0.0588,7840,640214,0.0212,29720,231134,0.0000,0,1
2021-03-11,Brazil,203070494,Rio Grande do Sul,10882965,0.0593,5467,645681,0.0240,29881,261015,0.0000,0,1
2021-03-12,Brazil,203070494,Rio Grande do Sul,10882965,0.0624,33367,679048,0.0262,24073,285088,0.0000,0,1
2021-03-13,Brazil,203070494,Rio Grande do Sul,10882965,0.0654,32991,712039,0.0267,5534,290622,0.0000,0,1
2021-03-14,Brazil,203070494,Rio Grande do Sul,10882965,0.0658,4482,716521,0.0267,463,291085,0.0000,0,1
2021-03-15,Brazil,203070494,Rio Grande do Sul,10882965,0.0689,33856,750377,0.0276,9241,300326,0.0000,0,1
2021-03-16,Brazil,203070494,Rio Grande do Sul,10882965,0.0715,27469,777846,0.0284,8653,308979,0.0000,0,1
2021-03-17,Brazil,203070494,Rio Grande do Sul,10882965,0.0737,23965,801811,0.0296,12855,321834,0.0000,0,1
2021-03-18,Brazil,203070494,Rio Grande do Sul,10882965,0.0752,16770,818581,0.0305,10073,331907,0.0000,0,1
2021-03-19,Brazil,203070494,Rio Grande do Sul,10882965,0.0799,51073,869654,0.0312,7900,339807,0.0000,0,1
2021-03-20,Brazil,203070494,Rio Grande do Sul,10882965,0.0846,50850,920504,0.0313,1169,340976,0.0000,0,1
2021-03-21,Brazil,203070494,Rio Grande do Sul,10882965,0.0848,2335,922839,0.0313,43,341019,0.0000,0,1
2021-03-22,Brazil,203070494,Rio Grande do Sul,10882965,0.0890,46245,969084,0.0318,5555,346574,0.0000,0,1
2021-03-23,Brazil,203070494,Rio Grande do Sul,10882965,0.0929,42333,1011417,0.0324,5971,352545,0.0000,0,1
2021-03-24,Brazil,203070494,Rio Grande do Sul,10882965,0.1003,80236,1091653,0.0328,3885,356430,0.0000,0,1
2021-03-25,Brazil,203070494,Rio Grande do Sul,10882965,0.1073,75975,1167628,0.0331,4208,360638,0.0000,0,1
2021-03-26,Brazil,203070494,Rio Grande do Sul,10882965,0.1136,68734,1236362,0.0335,3884,364522,0.0000,0,1
2021-03-27,Brazil,203070494,Rio Grande do Sul,10882965,0.1205,75225,1311587,0.0335,469,364991,0.0000,0,1
2021-03-28,Brazil,203070494,Rio Grande do Sul,10882965,0.1212,7024,1318611,0.0335,93,365084,0.0000,0,1
2021-03-29,Brazil,203070494,Rio Grande do Sul,10882965,0.1287,81925,1400536,0.0338,2836,367920,0.0000,0,1
2021-03-30,Brazil,203070494,Rio Grande do Sul,10882965,0.1372,92211,1492747,0.0340,2474,370394,0.0000,0,1
2021-03-31,Brazil,203070494,Rio Grande do Sul,10882965,0.1443,77239,1569986,0.0343,3269,373663,0.0000,0,1
2021-04-01,Brazil,203070494,Rio Grande do Sul,10882965,0.1505,68197,1638183,0.0346,2603,376266,0.0000,0,1
2021-04-02,Brazil,203070494,Rio Grande do Sul,10882965,0.1514,9780,1647963,0.0346,237,376503,0.0000,0,1
2021-04-03,Brazil,203070494,Rio Grande do Sul,10882965,0.1572,63268,1711231,0.0349,3200,379703,0.0000,0,1
2021-04-04,Brazil,203070494,Rio Grande do Sul,10882965,0.1573,849,1712080,0.0350,1743,381446,0.0000,0,1
2021-04-05,Brazil,203070494,Rio Grande do Sul,10882965,0.1635,67159,1779239,0.0358,7935,389381,0.0000,0,1
2021-04-06,Brazil,203070494,Rio Grande do Sul,10882965,0.1688,57809,1837048,0.0367,9549,398930,0.0000,0,1
2021-04-07,Brazil,203070494,Rio Grande do Sul,10882965,0.1717,31353,1868401,0.0378,12256,411186,0.0000,0,1
2021-04-08,Brazil,203070494,Rio Grande do Sul,10882965,0.1748,33850,1902251,0.0390,13654,424840,0.0000,0,1
2021-04-09,Brazil,203070494,Rio Grande do Sul,10882965,0.1770,24544,1926795,0.0419,31297,456137,0.0000,0,1
2021-04-10,Brazil,203070494,Rio Grande do Sul,10882965,0.1821,54942,1981737,0.0435,17205,473342,0.0000,0,1
2021-04-11,Brazil,203070494,Rio Grande do Sul,10882965,0.1825,3940,1985677,0.0435,205,473547,0.0000,0,1
2021-04-12,Brazil,203070494,Rio Grande do Sul,10882965,0.1867,46442,2032119,0.0464,31091,504638,0.0000,0,1
2021-04-13,Brazil,203070494,Rio Grande do Sul,10882965,0.1895,29914,2062033,0.0489,27927,532565,0.0000,0,1
2021-04-14,Brazil,203070494,Rio Grande do Sul,10882965,0.1914,20839,2082872,0.0516,28941,561506,0.0000,0,1
2021-04-15,Brazil,203070494,Rio Grande do Sul,10882965,0.1927,13920,2096792,0.0544,30949,592455,0.0000,0,1
2021-04-16,Brazil,203070494,Rio Grande do Sul,10882965,0.1942,17204,2113996,0.0589,48950,641405,0.0000,0,1
2021-04-17,Brazil,203070494,Rio Grande do Sul,10882965,0.1998,60289,2174285,0.0615,28197,669602,0.0000,0,1
2021-04-18,Brazil,203070494,Rio Grande do Sul,10882965,0.2002,4613,2178898,0.0616,605,670207,0.0000,0,1
2021-04-19,Brazil,203070494,Rio Grande do Sul,10882965,0.2050,52466,2231364,0.0664,52782,722989,0.0000,0,1
2021-04-20,Brazil,203070494,Rio Grande do Sul,10882965,0.2088,40524,2271888,0.0729,69871,792860,0.0000,0,1
2021-04-21,Brazil,203070494,Rio Grande do Sul,10882965,0.2099,11945,2283833,0.0735,7492,800352,0.0000,0,1
2021-04-22,Brazil,203070494,Rio Grande do Sul,10882965,0.2117,20544,2304377,0.0812,83685,884037,0.0000,0,1
2021-04-23,Brazil,203070494,Rio Grande do Sul,10882965,0.2139,23692,2328069,0.0870,63125,947162,0.0000,0,1
2021-04-24,Brazil,203070494,Rio Grande do Sul,10882965,0.2172,36196,2364265,0.0900,32013,979175,0.0000,0,1
2021-04-25,Brazil,203070494,Rio Grande do Sul,10882965,0.2173,845,2365110,0.0900,403,979578,0.0000,0,1
2021-04-26,Brazil,203070494,Rio Grande do Sul,10882965,0.2200,28920,2394030,0.0952,56977,1036555,0.0000,0,1
2021-04-27,Brazil,203070494,Rio Grande do Sul,10882965,0.2223,25602,2419632,0.0987,38012,1074567,0.0000,0,1
2021-04-28,Brazil,203070494,Rio Grande do Sul,10882965,0.2234,11792,2431424,0.1008,22836,1097403,0.0000,0,1
2021-04-29,Brazil,203070494,Rio Grande do Sul,10882965,0.2243,9254,2440678,0.1023,16107,1113510,0.0000,0,1
2021-04-30,Brazil,203070494,Rio Grande do Sul,10882965,0.2252,10474,2451152,0.1032,9992,1123502,0.0000,0,1
2021-05-01,Brazil,203070494,Rio Grande do Sul,10882965,0.2268,17368,2468520,0.1035,2991,1126493,0.0000,0,1
2021-05-02,Brazil,203070494,Rio Grande do Sul,10882965,0.2269,423,2468943,0.1035,43,1126536,0.0000,0,1
2021-05-03,Brazil,203070494,Rio Grande do Sul,10882965,0.2300,34162,2503105,0.1043,8803,1135339,0.0000,0,1
2021-05-04,Brazil,203070494,Rio Grande do Sul,10882965,0.2332,35009,2538114,0.1049,6746,1142085,0.0000,0,1
2021-05-05,Brazil,203070494,Rio Grande do Sul,10882965,0.2373,44402,2582516,0.1068,20635,1162720,0.0000,0,1
2021-05-06,Brazil,203070494,Rio Grande do Sul,10882965,0.2426,57539,2640055,0.1077,9905,1172625,0.0000,0,1
2021-05-07,Brazil,203070494,Rio Grande do Sul,10882965,0.2488,67549,2707604,0.1085,8468,1181093,0.0000,0,1
2021-05-08,Brazil,203070494,Rio Grande do Sul,10882965,0.2517,31633,2739237,0.1089,4116,1185209,0.0000,0,1
2021-05-09,Brazil,203070494,Rio Grande do Sul,10882965,0.2518,670,2739907,0.1089,42,1185251,0.0000,0,1
2021-05-10,Brazil,203070494,Rio Grande do Sul,10882965,0.2567,54050,2793957,0.1094,5345,1190596,0.0000,0,1
2021-05-11,Brazil,203070494,Rio Grande do Sul,10882965,0.2608,44726,2838683,0.1121,29176,1219772,0.0000,0,1
2021-05-12,Brazil,203070494,Rio Grande do Sul,10882965,0.2649,43872,2882555,0.1135,15315,1235087,0.0000,0,1
2021-05-13,Brazil,203070494,Rio Grande do Sul,10882965,0.2687,41525,2924080,0.1145,11335,1246422,0.0000,0,1
2021-05-14,Brazil,203070494,Rio Grande do Sul,10882965,0.2727,43783,2967863,0.1161,16712,1263134,0.0000,0,1
2021-05-15,Brazil,203070494,Rio Grande do Sul,10882965,0.2742,15968,2983831,0.1204,47041,1310175,0.0000,0,1
2021-05-16,Brazil,203070494,Rio Grande do Sul,10882965,0.2742,811,2984642,0.1205,1590,1311765,0.0000,0,1
2021-05-17,Brazil,203070494,Rio Grande do Sul,10882965,0.2772,31811,3016453,0.1240,37971,1349736,0.0000,0,1
2021-05-18,Brazil,203070494,Rio Grande do Sul,10882965,0.2805,35770,3052223,0.1258,19638,1369374,0.0000,0,1
2021-05-19,Brazil,203070494,Rio Grande do Sul,10882965,0.2839,37711,3089934,0.1273,15961,1385335,0.0000,0,1
2021-05-20,Brazil,203070494,Rio Grande do Sul,10882965,0.2863,25496,3115430,0.1361,96070,1481405,0.0000,0,1
2021-05-21,Brazil,203070494,Rio Grande do Sul,10882965,0.2885,24048,3139478,0.1416,60157,1541562,0.0000,0,1
2021-05-22,Brazil,203070494,Rio Grande do Sul,10882965,0.2893,8961,3148439,0.1436,20885,1562447,0.0000,0,1
2021-05-23,Brazil,203070494,Rio Grande do Sul,10882965,0.2893,357,3148796,0.1436,385,1562832,0.0000,0,1
2021-05-24,Brazil,203070494,Rio Grande do Sul,10882965,0.2911,19708,3168504,0.1470,37175,1600007,0.0000,0,1
2021-05-25,Brazil,203070494,Rio Grande do Sul,10882965,0.2944,35680,3204184,0.1492,23362,1623369,0.0000,0,1
2021-05-26,Brazil,203070494,Rio Grande do Sul,10882965,0.2978,36391,3240575,0.1507,17145,1640514,0.0000,0,1
2021-05-27,Brazil,203070494,Rio Grande do Sul,10882965,0.3009,34338,3274913,0.1527,21795,1662309,0.0000,0,1
2021-05-28,Brazil,203070494,Rio Grande do Sul,10882965,0.3050,44867,3319780,0.1542,16005,1678314,0.0000,0,1
2021-05-29,Brazil,203070494,Rio Grande do Sul,10882965,0.3073,24612,3344392,0.1545,3616,1681930,0.0000,0,1
2021-05-30,Brazil,203070494,Rio Grande do Sul,10882965,0.3073,200,3344592,0.1546,53,1681983,0.0000,0,1
2021-05-31,Brazil,203070494,Rio Grande do Sul,10882965,0.3111,40755,3385347,0.1552,7299,1689282,0.0000,0,1
2021-06-01,Brazil,203070494,Rio Grande do Sul,10882965,0.3165,59226,3444573,0.1565,14426,1703708,0.0000,0,1
2021-06-02,Brazil,203070494,Rio Grande do Sul,10882965,0.3220,59289,3503862,0.1581,16877,1720585,0.0000,0,1
2021-06-03,Brazil,203070494,Rio Grande do Sul,10882965,0.3236,18120,3521982,0.1581,332,1720917,0.0000,0,1
2021-06-04,Brazil,203070494,Rio Grande do Sul,10882965,0.3275,41651,3563633,0.1588,7085,1728002,0.0000,0,1
2021-06-05,Brazil,203070494,Rio Grande do Sul,10882965,0.3304,32205,3595838,0.1590,2237,1730239,0.0000,0,1
2021-06-06,Brazil,203070494,Rio Grande do Sul,10882965,0.3305,1278,3597116,0.1590,144,1730383,0.0000,0,1
2021-06-07,Brazil,203070494,Rio Grande do Sul,10882965,0.3376,76624,3673740,0.1596,6807,1737190,0.0000,0,1
2021-06-08,Brazil,203070494,Rio Grande do Sul,10882965,0.3458,89628,3763368,0.1601,5032,1742222,0.0000,0,1
2021-06-09,Brazil,203070494,Rio Grande do Sul,10882965,0.3526,74138,3837506,0.1603,2822,1745044,0.0000,0,1
2021-06-10,Brazil,203070494,Rio Grande do Sul,10882965,0.3596,76239,3913745,0.1606,3278,1748322,0.0000,0,1
2021-06-11,Brazil,203070494,Rio Grande do Sul,10882965,0.3662,71430,3985175,0.1609,2670,1750992,0.0000,0,1
2021-06-12,Brazil,203070494,Rio Grande do Sul,10882965,0.3719,61849,4047024,0.1609,563,1751555,0.0000,0,1
2021-06-13,Brazil,203070494,Rio Grande do Sul,10882965,0.3721,2834,4049858,0.1609,17,1751572,0.0000,0,1
2021-06-14,Brazil,203070494,Rio Grande do Sul,10882965,0.3805,90711,4140569,0.1612,2407,1753979,0.0000,0,1
2021-06-15,Brazil,203070494,Rio Grande do Sul,10882965,0.3893,95652,4236221,0.1614,2754,1756733,0.0000,0,1
2021-06-16,Brazil,203070494,Rio Grande do Sul,10882965,0.3961,74880,4311101,0.1619,5366,1762099,0.0000,0,1
2021-06-17,Brazil,203070494,Rio Grande do Sul,10882965,0.4030,74918,4386019,0.1623,4207,1766306,0.0000,0,1
2021-06-18,Brazil,203070494,Rio Grande do Sul,10882965,0.4094,69689,4455708,0.1627,4391,1770697,0.0000,0,1
2021-06-19,Brazil,203070494,Rio Grande do Sul,10882965,0.4129,37594,4493302,0.1671,47486,1818183,0.0000,0,1
2021-06-20,Brazil,203070494,Rio Grande do Sul,10882965,0.4130,1263,4494565,0.1674,3386,1821569,0.0000,0,1
2021-06-21,Brazil,203070494,Rio Grande do Sul,10882965,0.4187,62631,4557196,0.1695,23428,1844997,0.0000,0,1
2021-06-22,Brazil,203070494,Rio Grande do Sul,10882965,0.4245,62757,4619953,0.1715,21199,1866196,0.0000,0,1
2021-06-23,Brazil,203070494,Rio Grande do Sul,10882965,0.4279,36638,4656591,0.1730,16947,1883143,0.0000,0,1
2021-06-24,Brazil,203070494,Rio Grande do Sul,10882965,0.4306,29385,4685976,0.1740,10736,1893879,0.0000,0,1
2021-06-25,Brazil,203070494,Rio Grande do Sul,10882965,0.4334,30343,4716319,0.1751,11223,1905102,0.0000,0,1
2021-06-26,Brazil,203070494,Rio Grande do Sul,10882965,0.4406,78767,4795086,0.1756,6321,1911423,0.0000,0,1
2021-06-27,Brazil,203070494,Rio Grande do Sul,10882965,0.4411,4955,4800041,0.1756,114,1911537,0.0000,0,1
2021-06-28,Brazil,203070494,Rio Grande do Sul,10882965,0.4488,83877,4883918,0.1769,13768,1925305,0.0000,0,1
2021-06-29,Brazil,203070494,Rio Grande do Sul,10882965,0.4548,65864,4949782,0.1783,15370,1940675,0.0000,0,1
2021-06-30,Brazil,203070494,Rio Grande do Sul,10882965,0.4595,50839,5000621,0.1794,11930,1952605,0.0000,0,1
2021-07-01,Brazil,203070494,Rio Grande do Sul,10882965,0.4637,46176,5046797,0.1803,9639,1962244,0.0000,0,1
2021-07-02,Brazil,203070494,Rio Grande do Sul,10882965,0.4718,88304,5135101,0.1818,15954,1978198,0.0000,0,1
2021-07-03,Brazil,203070494,Rio Grande do Sul,10882965,0.4792,79681,5214782,0.1828,11079,1989277,0.0000,0,1
2021-07-04,Brazil,203070494,Rio Grande do Sul,10882965,0.4796,4860,5219642,0.1828,291,1989568,0.0000,0,1
2021-07-05,Brazil,203070494,Rio Grande do Sul,10882965,0.4874,85241,5304883,0.1856,30705,2020273,0.0000,0,1
2021-07-06,Brazil,203070494,Rio Grande do Sul,10882965,0.4973,107611,5412494,0.1876,20908,2041181,0.0000,0,1
2021-07-07,Brazil,203070494,Rio Grande do Sul,10882965,0.5098,135591,5548085,0.1891,16350,2057531,0.0000,0,1
2021-07-08,Brazil,203070494,Rio Grande do Sul,10882965,0.5203,113941,5662026,0.1902,12685,2070216,0.0000,0,1
2021-07-09,Brazil,203070494,Rio Grande do Sul,10882965,0.5277,80691,5742717,0.1926,25705,2095921,0.0000,0,1
2021-07-10,Brazil,203070494,Rio Grande do Sul,10882965,0.5333,60787,5803504,0.1941,16700,2112621,0.0000,0,1
2021-07-11,Brazil,203070494,Rio Grande do Sul,10882965,0.5334,1406,5804910,0.1941,192,2112813,0.0000,0,1
2021-07-12,Brazil,203070494,Rio Grande do Sul,10882965,0.5403,75322,5880232,0.1987,49878,2162691,0.0000,0,1
2021-07-13,Brazil,203070494,Rio Grande do Sul,10882965,0.5459,60943,5941175,0.2022,37493,2200184,0.0000,0,1
2021-07-14,Brazil,203070494,Rio Grande do Sul,10882965,0.5493,36430,5977605,0.2061,43227,2243411,0.0000,0,1
2021-07-15,Brazil,203070494,Rio Grande do Sul,10882965,0.5511,20407,5998012,0.2108,50340,2293751,0.0000,0,1
2021-07-16,Brazil,203070494,Rio Grande do Sul,10882965,0.5537,28352,6026364,0.2169,66796,2360547,0.0000,0,1
2021-07-17,Brazil,203070494,Rio Grande do Sul,10882965,0.5618,87723,6114087,0.2216,50740,2411287,0.0000,0,1
2021-07-18,Brazil,203070494,Rio Grande do Sul,10882965,0.5630,12803,6126890,0.2217,1196,2412483,0.0000,0,1
2021-07-19,Brazil,203070494,Rio Grande do Sul,10882965,0.5695,70893,6197783,0.2270,58179,2470662,0.0000,0,1
2021-07-20,Brazil,203070494,Rio Grande do Sul,10882965,0.5743,52421,6250204,0.2321,55285,2525947,0.0000,0,1
2021-07-21,Brazil,203070494,Rio Grande do Sul,10882965,0.5786,46605,6296809,0.2359,40889,2566836,0.0000,0,1
2021-07-22,Brazil,203070494,Rio Grande do Sul,10882965,0.5864,84953,6381762,0.2395,39959,2606795,0.0000,0,1
2021-07-23,Brazil,203070494,Rio Grande do Sul,10882965,0.5946,89243,6471005,0.2435,43184,2649979,0.0000,0,1
2021-07-24,Brazil,203070494,Rio Grande do Sul,10882965,0.5975,31063,6502068,0.2459,25842,2675821,0.0000,0,1
2021-07-25,Brazil,203070494,Rio Grande do Sul,10882965,0.5976,2100,6504168,0.2461,2495,2678316,0.0000,0,1
2021-07-26,Brazil,203070494,Rio Grande do Sul,10882965,0.6017,43815,6547983,0.2502,44610,2722926,0.0000,0,1
2021-07-27,Brazil,203070494,Rio Grande do Sul,10882965,0.6043,28652,6576635,0.2545,46676,2769602,0.0000,0,1
2021-07-28,Brazil,203070494,Rio Grande do Sul,10882965,0.6063,22221,6598856,0.2580,38084,2807686,0.0000,0,1
2021-07-29,Brazil,203070494,Rio Grande do Sul,10882965,0.6082,20070,6618926,0.2612,35485,2843171,0.0000,0,1
2021-07-30,Brazil,203070494,Rio Grande do Sul,10882965,0.6138,60622,6679548,0.2648,38378,2881549,0.0000,0,1
2021-07-31,Brazil,203070494,Rio Grande do Sul,10882965,0.6161,25968,6705516,0.2656,9252,2890801,0.0000,0,1
2021-08-01,Brazil,203070494,Rio Grande do Sul,10882965,0.6162,544,6706060,0.2656,232,2891033,0.0000,0,1
2021-08-02,Brazil,203070494,Rio Grande do Sul,10882965,0.6189,29603,6735663,0.2687,33047,2924080,0.0000,0,1
2021-08-03,Brazil,203070494,Rio Grande do Sul,10882965,0.6210,22673,6758336,0.2718,33789,2957869,0.0000,0,1
2021-08-04,Brazil,203070494,Rio Grande do Sul,10882965,0.6275,71229,6829565,0.2747,31737,2989606,0.0000,0,1
2021-08-05,Brazil,203070494,Rio Grande do Sul,10882965,0.6335,64482,6894047,0.2775,30811,3020417,0.0000,0,1
2021-08-06,Brazil,203070494,Rio Grande do Sul,10882965,0.6384,53702,6947749,0.2816,44147,3064564,0.0000,0,1
2021-08-07,Brazil,203070494,Rio Grande do Sul,10882965,0.6421,40273,6988022,0.2830,15647,3080211,0.0000,0,1
2021-08-08,Brazil,203070494,Rio Grande do Sul,10882965,0.6422,770,6988792,0.2831,294,3080505,0.0000,0,1
2021-08-09,Brazil,203070494,Rio Grande do Sul,10882965,0.6476,59230,7048022,0.2865,37467,3117972,0.0000,0,1
2021-08-10,Brazil,203070494,Rio Grande do Sul,10882965,0.6540,69575,7117597,0.2901,38686,3156658,0.0000,0,1
2021-08-11,Brazil,203070494,Rio Grande do Sul,10882965,0.6620,86697,7204294,0.2936,39109,3195767,0.0000,0,1
2021-08-12,Brazil,203070494,Rio Grande do Sul,10882965,0.6701,88040,7292334,0.2971,37995,3233762,0.0000,0,1
2021-08-13,Brazil,203070494,Rio Grande do Sul,10882965,0.6769,74529,7366863,0.3010,42504,3276266,0.0000,0,1
2021-08-14,Brazil,203070494,Rio Grande do Sul,10882965,0.6808,42231,7409094,0.3028,18696,3294962,0.0000,0,1
2021-08-15,Brazil,203070494,Rio Grande do Sul,10882965,0.6811,3123,7412217,0.3028,349,3295311,0.0000,0,1
2021-08-16,Brazil,203070494,Rio Grande do Sul,10882965,0.6855,48137,7460354,0.3064,39522,3334833,0.0000,0,1
2021-08-17,Brazil,203070494,Rio Grande do Sul,10882965,0.6921,71383,7531737,0.3103,41997,3376830,0.0000,0,1
2021-08-18,Brazil,203070494,Rio Grande do Sul,10882965,0.6970,54160,7585897,0.3136,35525,3412355,0.0000,0,1
2021-08-19,Brazil,203070494,Rio Grande do Sul,10882965,0.7051,87890,7673787,0.3181,49641,3461996,0.0000,0,1
2021-08-20,Brazil,203070494,Rio Grande do Sul,10882965,0.7119,73960,7747747,0.3241,64901,3526897,0.0000,0,1
2021-08-21,Brazil,203070494,Rio Grande do Sul,10882965,0.7151,35157,7782904,0.3257,17355,3544252,0.0000,0,1
2021-08-22,Brazil,203070494,Rio Grande do Sul,10882965,0.7159,7721,7790625,0.3258,1408,3545660,0.0000,0,1
2021-08-23,Brazil,203070494,Rio Grande do Sul,10882965,0.7209,54930,7845555,0.3308,54841,3600501,0.0000,0,1
2021-08-24,Brazil,203070494,Rio Grande do Sul,10882965,0.7263,58584,7904139,0.3359,54688,3655189,0.0000,0,1
2021-08-25,Brazil,203070494,Rio Grande do Sul,10882965,0.7317,58857,7962996,0.3403,48244,3703433,0.0000,0,1
2021-08-26,Brazil,203070494,Rio Grande do Sul,10882965,0.7360,47342,8010338,0.3454,55294,3758727,0.0000,0,1
2021-08-27,Brazil,203070494,Rio Grande do Sul,10882965,0.7387,29297,8039635,0.3527,79387,3838114,0.0000,0,1
2021-08-28,Brazil,203070494,Rio Grande do Sul,10882965,0.7407,20890,8060525,0.3555,30308,3868422,0.0000,0,1
2021-08-29,Brazil,203070494,Rio Grande do Sul,10882965,0.7408,1915,8062440,0.3557,2145,3870567,0.0000,0,1
2021-08-30,Brazil,203070494,Rio Grande do Sul,10882965,0.7429,22433,8084873,0.3629,78896,3949463,0.0000,0,1
2021-08-31,Brazil,203070494,Rio Grande do Sul,10882965,0.7452,24945,8109818,0.3698,74618,4024081,0.0000,0,1
2021-09-01,Brazil,203070494,Rio Grande do Sul,10882965,0.7471,20354,8130172,0.3760,67699,4091780,0.0000,0,1
2021-09-02,Brazil,203070494,Rio Grande do Sul,10882965,0.7487,17807,8147979,0.3828,74136,4165916,0.0000,0,1
2021-09-03,Brazil,203070494,Rio Grande do Sul,10882965,0.7499,12782,8160761,0.3901,79244,4245160,0.0000,0,1
2021-09-04,Brazil,203070494,Rio Grande do Sul,10882965,0.7505,6411,8167172,0.3925,26718,4271878,0.0000,0,1
2021-09-05,Brazil,203070494,Rio Grande do Sul,10882965,0.7505,519,8167691,0.3926,553,4272431,0.0000,0,1
2021-09-06,Brazil,203070494,Rio Grande do Sul,10882965,0.7511,6568,8174259,0.3959,36180,4308611,0.0000,0,1
2021-09-07,Brazil,203070494,Rio Grande do Sul,10882965,0.7511,320,8174579,0.3961,2154,4310765,0.0000,0,1
2021-09-08,Brazil,203070494,Rio Grande do Sul,10882965,0.7519,8635,8183214,0.4040,85984,4396749,0.0000,0,1
2021-09-09,Brazil,203070494,Rio Grande do Sul,10882965,0.7534,15902,8199116,0.4119,86364,4483113,0.0000,0,1
2021-09-10,Brazil,203070494,Rio Grande do Sul,10882965,0.7547,14069,8213185,0.4198,85181,4568294,0.0000,0,1
2021-09-11,Brazil,203070494,Rio Grande do Sul,10882965,0.7552,5710,8218895,0.4231,36424,4604718,0.0000,0,1
2021-09-12,Brazil,203070494,Rio Grande do Sul,10882965,0.7552,323,8219218,0.4232,1303,4606021,0.0000,0,1
2021-09-13,Brazil,203070494,Rio Grande do Sul,10882965,0.7560,8549,8227767,0.4282,53724,4659745,0.0000,0,1
2021-09-14,Brazil,203070494,Rio Grande do Sul,10882965,0.7572,13218,8240985,0.4349,73496,4733241,0.0000,26,27
2021-09-15,Brazil,203070494,Rio Grande do Sul,10882965,0.7600,29769,8270754,0.4407,62348,4795589,0.0000,9,36
2021-09-16,Brazil,203070494,Rio Grande do Sul,10882965,0.7636,39309,8310063,0.4466,65016,4860605,0.0000,8,44
2021-09-17,Brazil,203070494,Rio Grande do Sul,10882965,0.7662,27940,8338003,0.4519,57788,4918393,0.0000,22,66
2021-09-18,Brazil,203070494,Rio Grande do Sul,10882965,0.7672,11901,8349904,0.4540,22370,4940763,0.0000,0,66
2021-09-19,Brazil,203070494,Rio Grande do Sul,10882965,0.7673,364,8350268,0.4540,488,4941251,0.0000,0,66
2021-09-20,Brazil,203070494,Rio Grande do Sul,10882965,0.7675,2911,8353179,0.4544,3731,4944982,0.0000,0,66
2021-09-21,Brazil,203070494,Rio Grande do Sul,10882965,0.7691,16811,8369990,0.4614,76222,5021204,0.0000,9,75
2021-09-22,Brazil,203070494,Rio Grande do Sul,10882965,0.7713,23893,8393883,0.4673,64315,5085519,0.0000,25,100
2021-09-23,Brazil,203070494,Rio Grande do Sul,10882965,0.7750,40202,8434085,0.4738,71363,5156882,0.0000,9,109
2021-09-24,Brazil,203070494,Rio Grande do Sul,10882965,0.7798,52312,8486397,0.4811,79235,5236117,0.0000,11,120
2021-09-25,Brazil,203070494,Rio Grande do Sul,10882965,0.7823,27498,8513895,0.4846,38132,5274249,0.0000,0,120
2021-09-26,Brazil,203070494,Rio Grande do Sul,10882965,0.7825,1643,8515538,0.4849,2628,5276877,0.0000,0,120
2021-09-27,Brazil,203070494,Rio Grande do Sul,10882965,0.7855,33303,8548841,0.4927,85283,5362160,0.0000,29,149
2021-09-28,Brazil,203070494,Rio Grande do Sul,10882965,0.7892,40438,8589279,0.5002,80976,5443136,0.0000,55,204
2021-09-29,Brazil,203070494,Rio Grande do Sul,10882965,0.7925,35674,8624953,0.5074,78872,5522008,0.0000,2,206
2021-09-30,Brazil,203070494,Rio Grande do Sul,10882965,0.7953,30282,8655235,0.5143,74716,5596724,0.0000,9,215
2021-10-01,Brazil,203070494,Rio Grande do Sul,10882965,0.7979,28702,8683937,0.5208,71421,5668145,0.0000,5,220
2021-10-02,Brazil,203070494,Rio Grande do Sul,10882965,0.7994,15396,8699333,0.5234,27947,5696092,0.0000,3,223
2021-10-03,Brazil,203070494,Rio Grande do Sul,10882965,0.7994,542,8699875,0.5236,2304,5698396,0.0000,0,223
2021-10-04,Brazil,203070494,Rio Grande do Sul,10882965,0.8014,21442,8721317,0.5287,55382,5753778,0.0000,14,237
2021-10-05,Brazil,203070494,Rio Grande do Sul,10882965,0.8032,20032,8741349,0.5346,64220,5817998,0.0000,145,382
2021-10-06,Brazil,203070494,Rio Grande do Sul,10882965,0.8052,21750,8763099,0.5392,50541,5868539,0.0001,263,645
2021-10-07,Brazil,203070494,Rio Grande do Sul,10882965,0.8067,16003,8779102,0.5439,50974,5919513,0.0001,142,787
2021-10-08,Brazil,203070494,Rio Grande do Sul,10882965,0.8081,15915,8795017,0.5503,69658,5989171,0.0001,94,881
2021-10-09,Brazil,203070494,Rio Grande do Sul,10882965,0.8087,6334,8801351,0.5528,27201,6016372,0.0001,3,884
2021-10-10,Brazil,203070494,Rio Grande do Sul,10882965,0.8088,386,8801737,0.5529,1195,6017567,0.0001,0,884
2021-10-11,Brazil,203070494,Rio Grande do Sul,10882965,0.8094,6542,8808279,0.5558,30782,6048349,0.0001,41,925
2021-10-12,Brazil,203070494,Rio Grande do Sul,10882965,0.8094,376,8808655,0.5560,2486,6050835,0.0001,0,925
2021-10-13,Brazil,203070494,Rio Grande do Sul,10882965,0.8106,12788,8821443,0.5621,66722,6117557,0.0001,49,974
2021-10-14,Brazil,203070494,Rio Grande do Sul,10882965,0.8122,17596,8839039,0.5689,73921,6191478,0.0001,60,1034
2021-10-15,Brazil,203070494,Rio Grande do Sul,10882965,0.8137,16676,8855715,0.5761,77776,6269254,0.0001,114,1148
2021-10-16,Brazil,203070494,Rio Grande do Sul,10882965,0.8147,10293,8866008,0.5795,37716,6306970,0.0001,1,1149
2021-10-17,Brazil,203070494,Rio Grande do Sul,10882965,0.8147,54,8866062,0.5796,412,6307382,0.0001,0,1149
2021-10-18,Brazil,203070494,Rio Grande do Sul,10882965,0.8158,12501,8878563,0.5850,58830,6366212,0.0001,307,1456
2021-10-19,Brazil,203070494,Rio Grande do Sul,10882965,0.8174,17341,8895904,0.5911,66405,6432617,0.0001,34,1490
2021-10-20,Brazil,203070494,Rio Grande do Sul,10882965,0.8186,13267,8909171,0.5967,61230,6493847,0.0001,54,1544
2021-10-21,Brazil,203070494,Rio Grande do Sul,10882965,0.8203,18595,8927766,0.6028,66613,6560460,0.0001,38,1582
2021-10-22,Brazil,203070494,Rio Grande do Sul,10882965,0.8226,25031,8952797,0.6075,51424,6611884,0.0002,116,1698
2021-10-23,Brazil,203070494,Rio Grande do Sul,10882965,0.8233,7480,8960277,0.6094,20299,6632183,0.0002,13,1711
2021-10-24,Brazil,203070494,Rio Grande do Sul,10882965,0.8234,416,8960693,0.6095,1480,6633663,0.0002,0,1711
2021-10-25,Brazil,203070494,Rio Grande do Sul,10882965,0.8250,18019,8978712,0.6137,44920,6678583,0.0002,70,1781
2021-10-26,Brazil,203070494,Rio Grande do Sul,10882965,0.8265,16171,8994883,0.6177,44132,6722715,0.0002,113,1894
2021-10-27,Brazil,203070494,Rio Grande do Sul,10882965,0.8278,14410,9009293,0.6223,49211,6771926,0.0002,262,2156
2021-10-28,Brazil,203070494,Rio Grande do Sul,10882965,0.8289,11404,9020697,0.6270,52101,6824027,0.0002,223,2379
2021-10-29,Brazil,203070494,Rio Grande do Sul,10882965,0.8299,11043,9031740,0.6319,53306,6877333,0.0002,195,2574
2021-10-30,Brazil,203070494,Rio Grande do Sul,10882965,0.8302,3705,9035445,0.6329,10371,6887704,0.0002,10,2584
2021-10-31,Brazil,203070494,Rio Grande do Sul,10882965,0.8303,225,9035670,0.6330,692,6888396,0.0002,0,2584
2021-11-01,Brazil,203070494,Rio Grande do Sul,10882965,0.8304,1959,9037629,0.6338,8985,6897381,0.0002,0,2584
2021-11-02,Brazil,203070494,Rio Grande do Sul,10882965,0.8305,242,9037871,0.6339,1283,6898664,0.0002,0,2584
2021-11-03,Brazil,203070494,Rio Grande do Sul,10882965,0.8314,10279,9048150,0.6383,47783,6946447,0.0003,141,2725
2021-11-04,Brazil,203070494,Rio Grande do Sul,10882965,0.8323,9318,9057468,0.6429,50227,6996674,0.0003,100,2825
2021-11-05,Brazil,203070494,Rio Grande do Sul,10882965,0.8334,12047,9069515,0.6471,45626,7042300,0.0003,69,2894
2021-11-06,Brazil,203070494,Rio Grande do Sul,10882965,0.8337,3764,9073279,0.6482,12249,7054549,0.0003,30,2924
2021-11-07,Brazil,203070494,Rio Grande do Sul,10882965,0.8337,165,9073444,0.6483,1218,7055767,0.0003,0,2924
2021-11-08,Brazil,203070494,Rio Grande do Sul,10882965,0.8346,9896,9083340,0.6520,39512,7095279,0.0003,52,2976
2021-11-09,Brazil,203070494,Rio Grande do Sul,10882965,0.8356,10367,9093707,0.6557,41196,7136475,0.0003,0,2976
2021-11-10,Brazil,203070494,Rio Grande do Sul,10882965,0.8365,10015,9103722,0.6589,34410,7170885,0.0003,0,2976
2021-11-11,Brazil,203070494,Rio Grande do Sul,10882965,0.8374,9148,9112870,0.6630,44377,7215262,0.0003,13,2989
2021-11-12,Brazil,203070494,Rio Grande do Sul,10882965,0.8382,9619,9122489,0.6664,36991,7252253,0.0003,3,2992
2021-11-13,Brazil,203070494,Rio Grande do Sul,10882965,0.8383,1051,9123540,0.6671,7888,7260141,0.0003,0,2992
2021-11-14,Brazil,203070494,Rio Grande do Sul,10882965,0.8383,62,9123602,0.6671,392,7260533,0.0003,0,2992
2021-11-15,Brazil,203070494,Rio Grande do Sul,10882965,0.8384,395,9123997,0.6672,675,7261208,0.0003,0,2992
2021-11-16,Brazil,203070494,Rio Grande do Sul,10882965,0.8389,5881,9129878,0.6705,35490,7296698,0.0003,0,2992
2021-11-17,Brazil,203070494,Rio Grande do Sul,10882965,0.8396,7071,9136949,0.6739,36950,7333648,0.0003,0,2992
2021-11-18,Brazil,203070494,Rio Grande do Sul,10882965,0.8402,6746,9143695,0.6776,40744,7374392,0.0003,0,2992
2021-11-19,Brazil,203070494,Rio Grande do Sul,10882965,0.8408,7063,9150758,0.6819,47100,7421492,0.0003,0,2992
2021-11-20,Brazil,203070494,Rio Grande do Sul,10882965,0.8410,2106,9152864,0.6833,15309,7436801,0.0003,0,2992
2021-11-21,Brazil,203070494,Rio Grande do Sul,10882965,0.8411,318,9153182,0.6835,2079,7438880,0.0003,0,2992
2021-11-22,Brazil,203070494,Rio Grande do Sul,10882965,0.8417,6496,9159678,0.6869,36951,7475831,0.0003,1,2993
2021-11-23,Brazil,203070494,Rio Grande do Sul,10882965,0.8424,8371,9168049,0.6905,39307,7515138,0.0003,0,2993
2021-11-24,Brazil,203070494,Rio Grande do Sul,10882965,0.8430,6165,9174214,0.6940,37933,7553071,0.0003,0,2993
2021-11-25,Brazil,203070494,Rio Grande do Sul,10882965,0.8435,5452,9179666,0.6973,36043,7589114,0.0003,1,2994
2021-11-26,Brazil,203070494,Rio Grande do Sul,10882965,0.8440,6085,9185751,0.7007,36123,7625237,0.0003,45,3039
2021-11-27,Brazil,203070494,Rio Grande do Sul,10882965,0.8442,1559,9187310,0.7018,12462,7637699,0.0003,1,3040
2021-11-28,Brazil,203070494,Rio Grande do Sul,10882965,0.8442,124,9187434,0.7019,691,7638390,0.0003,0,3040
2021-11-29,Brazil,203070494,Rio Grande do Sul,10882965,0.8446,4734,9192168,0.7047,30825,7669215,0.0003,6,3046
2021-11-30,Brazil,203070494,Rio Grande do Sul,10882965,0.8452,5774,9197942,0.7076,31866,7701081,0.0003,2,3048
2021-12-01,Brazil,203070494,Rio Grande do Sul,10882965,0.8456,5028,9202970,0.7102,28400,7729481,0.0003,1,3049
2021-12-02,Brazil,203070494,Rio Grande do Sul,10882965,0.8461,4779,9207749,0.7128,27875,7757356,0.0003,0,3049
2021-12-03,Brazil,203070494,Rio Grande do Sul,10882965,0.8465,5006,9212755,0.7153,26802,7784158,0.0003,0,3049
2021-12-04,Brazil,203070494,Rio Grande do Sul,10882965,0.8466,957,9213712,0.7160,7884,7792042,0.0003,1,3050
2021-12-05,Brazil,203070494,Rio Grande do Sul,10882965,0.8466,187,9213899,0.7161,875,7792917,0.0003,0,3050
2021-12-06,Brazil,203070494,Rio Grande do Sul,10882965,0.8470,3821,9217720,0.7180,21326,7814243,0.0003,18,3068
2021-12-07,Brazil,203070494,Rio Grande do Sul,10882965,0.8474,4211,9221931,0.7199,20830,7835073,0.0003,4,3072
2021-12-08,Brazil,203070494,Rio Grande do Sul,10882965,0.8476,2752,9224683,0.7216,17638,7852711,0.0003,0,3072
2021-12-09,Brazil,203070494,Rio Grande do Sul,10882965,0.8480,3894,9228577,0.7237,22965,7875676,0.0003,0,3072
2021-12-10,Brazil,203070494,Rio Grande do Sul,10882965,0.8483,3825,9232402,0.7256,21014,7896690,0.0003,0,3072
2021-12-11,Brazil,203070494,Rio Grande do Sul,10882965,0.8484,952,9233354,0.7261,5262,7901952,0.0003,0,3072
2021-12-12,Brazil,203070494,Rio Grande do Sul,10882965,0.8484,152,9233506,0.7261,583,7902535,0.0003,0,3072
2021-12-13,Brazil,203070494,Rio Grande do Sul,10882965,0.8487,2968,9236474,0.7275,15268,7917803,0.0003,0,3072
2021-12-14,Brazil,203070494,Rio Grande do Sul,10882965,0.8490,3043,9239517,0.7290,15599,7933402,0.0003,0,3072
2021-12-15,Brazil,203070494,Rio Grande do Sul,10882965,0.8493,3218,9242735,0.7306,17435,7950837,0.0003,0,3072
2021-12-16,Brazil,203070494,Rio Grande do Sul,10882965,0.8496,3092,9245827,0.7323,19035,7969872,0.0003,1,3073
2021-12-17,Brazil,203070494,Rio Grande do Sul,10882965,0.8498,2744,9248571,0.7341,19827,7989699,0.0003,1,3074
2021-12-18,Brazil,203070494,Rio Grande do Sul,10882965,0.8499,632,9249203,0.7346,4406,7994105,0.0003,1,3075
2021-12-19,Brazil,203070494,Rio Grande do Sul,10882965,0.8499,142,9249345,0.7346,574,7994679,0.0003,0,3075
2021-12-20,Brazil,203070494,Rio Grande do Sul,10882965,0.8501,2356,9251701,0.7362,16873,8011552,0.0003,0,3075
2021-12-21,Brazil,203070494,Rio Grande do Sul,10882965,0.8503,2283,9253984,0.7376,16222,8027774,0.0003,0,3075
2021-12-22,Brazil,203070494,Rio Grande do Sul,10882965,0.8505,2327,9256311,0.7392,17241,8045015,0.0003,0,3075
2021-12-23,Brazil,203070494,Rio Grande do Sul,10882965,0.8507,1841,9258152,0.7405,14348,8059363,0.0003,1,3076
2021-12-24,Brazil,203070494,Rio Grande do Sul,10882965,0.8507,274,9258426,0.7407,1652,8061015,0.0003,0,3076
2021-12-25,Brazil,203070494,Rio Grande do Sul,10882965,0.8507,2,9258428,0.7407,9,8061024,0.0003,0,3076
2021-12-26,Brazil,203070494,Rio Grande do Sul,10882965,0.8507,2,9258430,0.7407,14,8061038,0.0003,0,3076
2021-12-27,Brazil,203070494,Rio Grande do Sul,10882965,0.8509,1559,9259989,0.7416,9463,8070501,0.0003,0,3076
2021-12-28,Brazil,203070494,Rio Grande do Sul,10882965,0.8510,1920,9261909,0.7427,12729,8083230,0.0003,0,3076
2021-12-29,Brazil,203070494,Rio Grande do Sul,10882965,0.8512,2124,9264033,0.7440,13471,8096701,0.0003,0,3076
2021-12-30,Brazil,203070494,Rio Grande do Sul,10882965,0.8514,1539,9265572,0.7449,10315,8107016,0.0003,0,3076
2021-12-31,Brazil,203070494,Rio Grande do Sul,10882965,0.8514,83,9265655,0.7450,431,8107447,0.0003,0,3076
2021-01-02,Brazil,203070494,Rio de Janeiro,16055174,0.0000,1,1,0.0000,0,0,0.0000,0,0
2021-01-03,Brazil,203070494,Rio de Janeiro,16055174,0.0000,1,2,0.0000,0,0,0.0000,0,0
2021-01-04,Brazil,203070494,Rio de Janeiro,16055174,0.0000,5,7,0.0000,2,2,0.0000,0,0
2021-01-05,Brazil,203070494,Rio de Janeiro,16055174,0.0000,0,7,0.0000,2,4,0.0000,0,0
2021-01-06,Brazil,203070494,Rio de Janeiro,16055174,0.0000,2,9,0.0000,1,5,0.0000,0,0
2021-01-07,Brazil,203070494,Rio de Janeiro,16055174,0.0000,0,9,0.0000,1,6,0.0000,0,0
2021-01-08,Brazil,203070494,Rio de Janeiro,16055174,0.0000,0,9,0.0000,0,6,0.0000,1,1
2021-01-09,Brazil,203070494,Rio de Janeiro,16055174,0.0000,0,9,0.0000,3,9,0.0000,0,1
2021-01-10,Brazil,203070494,Rio de Janeiro,16055174,0.0000,0,9,0.0000,1,10,0.0000,0,1
2021-01-12,Brazil,203070494,Rio de Janeiro,16055174,0.0000,0,9,0.0000,1,11,0.0000,0,1
2021-01-14,Brazil,203070494,Rio de Janeiro,16055174,0.0000,2,11,0.0000,0,11,0.0000,0,1
2021-01-15,Brazil,203070494,Rio de Janeiro,16055174,0.0000,1,12,0.0000,0,11,0.0000,0,1
2021-01-17,Brazil,203070494,Rio de Janeiro,16055174,0.0000,116,128,0.0000,29,40,0.0000,0,1
2021-01-18,Brazil,203070494,Rio de Janeiro,16055174,0.0000,197,325,0.0000,6,46,0.0000,0,1
2021-01-19,Brazil,203070494,Rio de Janeiro,16055174,0.0002,3606,3931,0.0000,43,89,0.0000,0,1
2021-01-20,Brazil,203070494,Rio de Janeiro,16055174,0.0036,53661,57592,0.0000,150,239,0.0000,0,1
2021-01-21,Brazil,203070494,Rio de Janeiro,16055174,0.0056,31725,89317,0.0000,103,342,0.0000,0,1
2021-01-22,Brazil,203070494,Rio de Janeiro,16055174,0.0072,27072,116389,0.0000,117,459,0.0000,0,1
2021-01-23,Brazil,203070494,Rio de Janeiro,16055174,0.0076,6064,122453,0.0000,19,478,0.0000,0,1
2021-01-24,Brazil,203070494,Rio de Janeiro,16055174,0.0078,1986,124439,0.0000,45,523,0.0000,0,1
2021-01-25,Brazil,203070494,Rio de Janeiro,16055174,0.0089,18052,142491,0.0000,40,563,0.0000,0,1
2021-01-26,Brazil,203070494,Rio de Janeiro,16055174,0.0103,23538,166029,0.0000,75,638,0.0000,0,1
2021-01-27,Brazil,203070494,Rio de Janeiro,16055174,0.0125,34177,200206,0.0000,76,714,0.0000,0,1
2021-01-28,Brazil,203070494,Rio de Janeiro,16055174,0.0143,29726,229932,0.0000,65,779,0.0000,0,1
2021-01-29,Brazil,203070494,Rio de Janeiro,16055174,0.0157,21912,251844,0.0001,58,837,0.0000,0,1
2021-01-30,Brazil,203070494,Rio de Janeiro,16055174,0.0158,2580,254424,0.0001,12,849,0.0000,0,1
2021-01-31,Brazil,203070494,Rio de Janeiro,16055174,0.0159,299,254723,0.0001,9,858,0.0000,0,1
2021-02-01,Brazil,203070494,Rio de Janeiro,16055174,0.0168,15773,270496,0.0001,72,930,0.0000,0,1
2021-02-02,Brazil,203070494,Rio de Janeiro,16055174,0.0180,17914,288410,0.0001,196,1126,0.0000,0,1
2021-02-03,Brazil,203070494,Rio de Janeiro,16055174,0.0193,20671,309081,0.0001,158,1284,0.0000,0,1
2021-02-04,Brazil,203070494,Rio de Janeiro,16055174,0.0206,21165,330246,0.0001,178,1462,0.0000,0,1
2021-02-05,Brazil,203070494,Rio de Janeiro,16055174,0.0221,25298,355544,0.0001,208,1670,0.0000,0,1
2021-02-06,Brazil,203070494,Rio de Janeiro,16055174,0.0224,4556,360100,0.0001,30,1700,0.0000,0,1
2021-02-07,Brazil,203070494,Rio de Janeiro,16055174,0.0224,131,360231,0.0001,15,1715,0.0000,1,2
2021-02-08,Brazil,203070494,Rio de Janeiro,16055174,0.0236,18504,378735,0.0003,2875,4590,0.0000,0,2
2021-02-09,Brazil,203070494,Rio de Janeiro,16055174,0.0248,18835,397570,0.0006,4607,9197,0.0000,0,2
2021-02-10,Brazil,203070494,Rio de Janeiro,16055174,0.0260,19738,417308,0.0014,12551,21748,0.0000,0,2
2021-02-11,Brazil,203070494,Rio de Janeiro,16055174,0.0275,23994,441302,0.0021,12676,34424,0.0000,0,2
2021-02-12,Brazil,203070494,Rio de Janeiro,16055174,0.0290,24398,465700,0.0028,11123,45547,0.0000,0,2
2021-02-13,Brazil,203070494,Rio de Janeiro,16055174,0.0294,5592,471292,0.0030,1872,47419,0.0000,0,2
2021-02-14,Brazil,203070494,Rio de Janeiro,16055174,0.0294,137,471429,0.0030,606,48025,0.0000,0,2
2021-02-15,Brazil,203070494,Rio de Janeiro,16055174,0.0306,20107,491536,0.0032,2859,50884,0.0000,0,2
2021-02-16,Brazil,203070494,Rio de Janeiro,16055174,0.0318,18995,510531,0.0048,25504,76388,0.0000,0,2
2021-02-17,Brazil,203070494,Rio de Janeiro,16055174,0.0323,7580,518111,0.0058,17493,93881,0.0000,0,2
2021-02-18,Brazil,203070494,Rio de Janeiro,16055174,0.0331,12557,530668,0.0075,26654,120535,0.0000,0,2
2021-02-19,Brazil,203070494,Rio de Janeiro,16055174,0.0335,6990,537658,0.0088,19969,140504,0.0000,0,2
2021-02-20,Brazil,203070494,Rio de Janeiro,16055174,0.0335,708,538366,0.0089,2612,143116,0.0000,0,2
2021-02-21,Brazil,203070494,Rio de Janeiro,16055174,0.0335,275,538641,0.0090,865,143981,0.0000,0,2
2021-02-22,Brazil,203070494,Rio de Janeiro,16055174,0.0340,6783,545424,0.0099,14240,158221,0.0000,0,2
2021-02-23,Brazil,203070494,Rio de Janeiro,16055174,0.0346,10547,555971,0.0106,12645,170866,0.0000,0,2
2021-02-24,Brazil,203070494,Rio de Janeiro,16055174,0.0353,10985,566956,0.0112,9659,180525,0.0000,0,2
2021-02-25,Brazil,203070494,Rio de Janeiro,16055174,0.0370,26768,593724,0.0117,7318,187843,0.0000,0,2
2021-02-26,Brazil,203070494,Rio de Janeiro,16055174,0.0390,31999,625723,0.0121,6283,194126,0.0000,0,2
2021-02-27,Brazil,203070494,Rio de Janeiro,16055174,0.0409,30134,655857,0.0121,832,194958,0.0000,0,2
2021-02-28,Brazil,203070494,Rio de Janeiro,16055174,0.0409,271,656128,0.0122,137,195095,0.0000,0,2
2021-03-01,Brazil,203070494,Rio de Janeiro,16055174,0.0429,32085,688213,0.0125,6058,201153,0.0000,0,2
2021-03-02,Brazil,203070494,Rio de Janeiro,16055174,0.0444,24115,712328,0.0130,6932,208085,0.0000,0,2
2021-03-03,Brazil,203070494,Rio de Janeiro,16055174,0.0458,22892,735220,0.0134,7577,215662,0.0000,0,2
2021-03-04,Brazil,203070494,Rio de Janeiro,16055174,0.0479,34530,769750,0.0142,12304,227966,0.0000,0,2
2021-03-05,Brazil,203070494,Rio de Janeiro,16055174,0.0500,32224,801974,0.0150,13556,241522,0.0000,0,2
2021-03-06,Brazil,203070494,Rio de Janeiro,16055174,0.0504,7503,809477,0.0152,3217,244739,0.0000,0,2
2021-03-07,Brazil,203070494,Rio de Janeiro,16055174,0.0504,243,809720,0.0152,49,244788,0.0000,0,2
2021-03-08,Brazil,203070494,Rio de Janeiro,16055174,0.0529,39292,849012,0.0158,9328,254116,0.0000,0,2
2021-03-09,Brazil,203070494,Rio de Janeiro,16055174,0.0541,20301,869313,0.0165,11061,265177,0.0000,0,2
2021-03-10,Brazil,203070494,Rio de Janeiro,16055174,0.0564,36908,906221,0.0173,12898,278075,0.0000,0,2
2021-03-11,Brazil,203070494,Rio de Janeiro,16055174,0.0579,22803,929024,0.0185,19245,297320,0.0000,0,2
2021-03-12,Brazil,203070494,Rio de Janeiro,16055174,0.0593,22626,951650,0.0195,16080,313400,0.0000,0,2
2021-03-13,Brazil,203070494,Rio de Janeiro,16055174,0.0596,5529,957179,0.0198,4984,318384,0.0000,0,2
2021-03-14,Brazil,203070494,Rio de Janeiro,16055174,0.0596,205,957384,0.0198,68,318452,0.0000,0,2
2021-03-15,Brazil,203070494,Rio de Janeiro,16055174,0.0607,17452,974836,0.0211,20636,339088,0.0000,0,2
2021-03-16,Brazil,203070494,Rio de Janeiro,16055174,0.0620,20097,994933,0.0223,19461,358549,0.0000,1,3
2021-03-17,Brazil,203070494,Rio de Janeiro,16055174,0.0630,15849,1010782,0.0228,7309,365858,0.0000,0,3
2021-03-18,Brazil,203070494,Rio de Janeiro,16055174,0.0652,35357,1046139,0.0233,7969,373827,0.0000,0,3
2021-03-19,Brazil,203070494,Rio de Janeiro,16055174,0.0672,32924,1079063,0.0237,6059,379886,0.0000,0,3
2021-03-20,Brazil,203070494,Rio de Janeiro,16055174,0.0679,11788,1090851,0.0237,1036,380922,0.0000,0,3
2021-03-21,Brazil,203070494,Rio de Janeiro,16055174,0.0680,1338,1092189,0.0237,165,381087,0.0000,0,3
2021-03-22,Brazil,203070494,Rio de Janeiro,16055174,0.0709,46717,1138906,0.0240,4376,385463,0.0000,0,3
2021-03-23,Brazil,203070494,Rio de Janeiro,16055174,0.0739,46825,1185731,0.0245,7178,392641,0.0000,0,3
2021-03-24,Brazil,203070494,Rio de Janeiro,16055174,0.0779,65692,1251423,0.0248,6327,398968,0.0000,0,3
2021-03-25,Brazil,203070494,Rio de Janeiro,16055174,0.0810,49236,1300659,0.0264,24763,423731,0.0000,0,3
2021-03-26,Brazil,203070494,Rio de Janeiro,16055174,0.0847,59586,1360245,0.0270,9882,433613,0.0000,1,4
2021-03-27,Brazil,203070494,Rio de Janeiro,16055174,0.0877,47610,1407855,0.0273,5006,438619,0.0000,0,4
2021-03-28,Brazil,203070494,Rio de Janeiro,16055174,0.0882,7822,1415677,0.0273,102,438721,0.0000,0,4
2021-03-29,Brazil,203070494,Rio de Janeiro,16055174,0.0934,84400,1500077,0.0281,11676,450397,0.0000,0,4
2021-03-30,Brazil,203070494,Rio de Janeiro,16055174,0.0988,86173,1586250,0.0287,10521,460918,0.0000,0,4
2021-03-31,Brazil,203070494,Rio de Janeiro,16055174,0.1050,99079,1685329,0.0295,12390,473308,0.0000,0,4
2021-04-01,Brazil,203070494,Rio de Janeiro,16055174,0.1101,82076,1767405,0.0306,17595,490903,0.0000,0,4
2021-04-02,Brazil,203070494,Rio de Janeiro,16055174,0.1139,61905,1829310,0.0309,4598,495501,0.0000,0,4
2021-04-03,Brazil,203070494,Rio de Janeiro,16055174,0.1164,39179,1868489,0.0311,3828,499329,0.0000,0,4
2021-04-04,Brazil,203070494,Rio de Janeiro,16055174,0.1167,5071,1873560,0.0311,137,499466,0.0000,0,4
2021-04-05,Brazil,203070494,Rio de Janeiro,16055174,0.1217,80536,1954096,0.0336,39333,538799,0.0000,0,4
2021-04-06,Brazil,203070494,Rio de Janeiro,16055174,0.1257,64703,2018799,0.0351,25389,564188,0.0000,0,4
2021-04-07,Brazil,203070494,Rio de Janeiro,16055174,0.1310,84022,2102821,0.0372,33632,597820,0.0000,0,4
2021-04-08,Brazil,203070494,Rio de Janeiro,16055174,0.1348,60767,2163588,0.0389,26532,624352,0.0000,0,4
2021-04-09,Brazil,203070494,Rio de Janeiro,16055174,0.1395,75613,2239201,0.0402,21602,645954,0.0000,0,4
2021-04-10,Brazil,203070494,Rio de Janeiro,16055174,0.1430,57489,2296690,0.0408,8371,654325,0.0000,0,4
2021-04-11,Brazil,203070494,Rio de Janeiro,16055174,0.1435,7232,2303922,0.0410,3941,658266,0.0000,0,4
2021-04-12,Brazil,203070494,Rio de Janeiro,16055174,0.1484,78873,2382795,0.0424,22534,680800,0.0000,0,4
2021-04-13,Brazil,203070494,Rio de Janeiro,16055174,0.1526,67844,2450639,0.0441,26730,707530,0.0000,0,4
2021-04-14,Brazil,203070494,Rio de Janeiro,16055174,0.1559,52764,2503403,0.0462,33792,741322,0.0000,0,4
2021-04-15,Brazil,203070494,Rio de Janeiro,16055174,0.1607,76484,2579887,0.0489,43559,784881,0.0000,0,4
2021-04-16,Brazil,203070494,Rio de Janeiro,16055174,0.1652,73035,2652922,0.0515,41630,826511,0.0000,0,4
2021-04-17,Brazil,203070494,Rio de Janeiro,16055174,0.1676,37378,2690300,0.0524,15107,841618,0.0000,1,5
2021-04-18,Brazil,203070494,Rio de Janeiro,16055174,0.1678,3359,2693659,0.0525,989,842607,0.0000,0,5
2021-04-19,Brazil,203070494,Rio de Janeiro,16055174,0.1730,84633,2778292,0.0566,65963,908570,0.0000,0,5
2021-04-20,Brazil,203070494,Rio de Janeiro,16055174,0.1780,80046,2858338,0.0604,61100,969670,0.0000,0,5
2021-04-21,Brazil,203070494,Rio de Janeiro,16055174,0.1811,49166,2907504,0.0634,47691,1017361,0.0000,0,5
2021-04-22,Brazil,203070494,Rio de Janeiro,16055174,0.1855,71090,2978594,0.0667,53620,1070981,0.0000,0,5
2021-04-23,Brazil,203070494,Rio de Janeiro,16055174,0.1887,51371,3029965,0.0694,43371,1114352,0.0000,0,5
2021-04-24,Brazil,203070494,Rio de Janeiro,16055174,0.1908,32675,3062640,0.0709,24513,1138865,0.0000,0,5
2021-04-25,Brazil,203070494,Rio de Janeiro,16055174,0.1908,639,3063279,0.0710,311,1139176,0.0000,0,5
2021-04-26,Brazil,203070494,Rio de Janeiro,16055174,0.1945,59382,3122661,0.0763,86458,1225634,0.0000,0,5
2021-04-27,Brazil,203070494,Rio de Janeiro,16055174,0.1984,62268,3184929,0.0816,84777,1310411,0.0000,0,5
2021-04-28,Brazil,203070494,Rio de Janeiro,16055174,0.2022,61336,3246265,0.0869,85358,1395769,0.0000,0,5
2021-04-29,Brazil,203070494,Rio de Janeiro,16055174,0.2053,49697,3295962,0.0922,84688,1480457,0.0000,0,5
2021-04-30,Brazil,203070494,Rio de Janeiro,16055174,0.2083,48818,3344780,0.0964,67461,1547918,0.0000,0,5
2021-05-01,Brazil,203070494,Rio de Janeiro,16055174,0.2096,19583,3364363,0.0975,17608,1565526,0.0000,0,5
2021-05-02,Brazil,203070494,Rio de Janeiro,16055174,0.2096,518,3364881,0.0975,551,1566077,0.0000,0,5
2021-05-03,Brazil,203070494,Rio de Janeiro,16055174,0.2133,60039,3424920,0.0996,32258,1598335,0.0000,0,5
2021-05-04,Brazil,203070494,Rio de Janeiro,16055174,0.2173,64111,3489031,0.1017,34943,1633278,0.0000,0,5
2021-05-05,Brazil,203070494,Rio de Janeiro,16055174,0.2214,65774,3554805,0.1030,21046,1654324,0.0000,0,5
2021-05-06,Brazil,203070494,Rio de Janeiro,16055174,0.2257,68483,3623288,0.1040,15402,1669726,0.0000,0,5
2021-05-07,Brazil,203070494,Rio de Janeiro,16055174,0.2295,61169,3684457,0.1048,12919,1682645,0.0000,0,5
2021-05-08,Brazil,203070494,Rio de Janeiro,16055174,0.2315,32763,3717220,0.1074,41906,1724551,0.0000,0,5
2021-05-09,Brazil,203070494,Rio de Janeiro,16055174,0.2315,204,3717424,0.1074,226,1724777,0.0000,0,5
2021-05-10,Brazil,203070494,Rio de Janeiro,16055174,0.2343,44639,3762063,0.1091,26139,1750916,0.0000,0,5
2021-05-11,Brazil,203070494,Rio de Janeiro,16055174,0.2383,63641,3825704,0.1102,18910,1769826,0.0000,0,5
2021-05-12,Brazil,203070494,Rio de Janeiro,16055174,0.2418,55836,3881540,0.1112,15799,1785625,0.0000,0,5
2021-05-13,Brazil,203070494,Rio de Janeiro,16055174,0.2453,56850,3938390,0.1120,12608,1798233,0.0000,0,5
2021-05-14,Brazil,203070494,Rio de Janeiro,16055174,0.2482,47219,3985609,0.1158,60805,1859038,0.0000,0,5
2021-05-15,Brazil,203070494,Rio de Janeiro,16055174,0.2496,21861,4007470,0.1173,23751,1882789,0.0000,0,5
2021-05-16,Brazil,203070494,Rio de Janeiro,16055174,0.2497,1016,4008486,0.1180,11676,1894465,0.0000,0,5
2021-05-17,Brazil,203070494,Rio de Janeiro,16055174,0.2525,45919,4054405,0.1203,36585,1931050,0.0000,0,5
2021-05-18,Brazil,203070494,Rio de Janeiro,16055174,0.2564,61702,4116107,0.1218,24623,1955673,0.0000,0,5
2021-05-19,Brazil,203070494,Rio de Janeiro,16055174,0.2602,60838,4176945,0.1236,28444,1984117,0.0000,0,5
2021-05-20,Brazil,203070494,Rio de Janeiro,16055174,0.2638,58341,4235286,0.1248,18898,2003015,0.0000,0,5
2021-05-21,Brazil,203070494,Rio de Janeiro,16055174,0.2676,60420,4295706,0.1271,37385,2040400,0.0000,0,5
2021-05-22,Brazil,203070494,Rio de Janeiro,16055174,0.2696,32102,4327808,0.1283,19998,2060398,0.0000,0,5
2021-05-23,Brazil,203070494,Rio de Janeiro,16055174,0.2696,183,4327991,0.1283,84,2060482,0.0000,0,5
2021-05-24,Brazil,203070494,Rio de Janeiro,16055174,0.2735,62747,4390738,0.1304,33195,2093677,0.0000,0,5
2021-05-25,Brazil,203070494,Rio de Janeiro,16055174,0.2782,76559,4467297,0.1315,18372,2112049,0.0000,0,5
2021-05-26,Brazil,203070494,Rio de Janeiro,16055174,0.2825,68764,4536061,0.1333,28267,2140316,0.0000,0,5
2021-05-27,Brazil,203070494,Rio de Janeiro,16055174,0.2868,68384,4604445,0.1346,20520,2160836,0.0000,0,5
2021-05-28,Brazil,203070494,Rio de Janeiro,16055174,0.2913,72126,4676571,0.1352,10236,2171072,0.0000,0,5
2021-05-29,Brazil,203070494,Rio de Janeiro,16055174,0.2946,52535,4729106,0.1355,4137,2175209,0.0000,0,5
2021-05-30,Brazil,203070494,Rio de Janeiro,16055174,0.2946,411,4729517,0.1355,240,2175449,0.0000,0,5
2021-05-31,Brazil,203070494,Rio de Janeiro,16055174,0.2976,47984,4777501,0.1361,9933,2185382,0.0000,0,5
2021-06-01,Brazil,203070494,Rio de Janeiro,16055174,0.3016,64461,4841962,0.1371,15111,2200493,0.0000,0,5
2021-06-02,Brazil,203070494,Rio de Janeiro,16055174,0.3060,70383,4912345,0.1380,14951,2215444,0.0000,0,5
2021-06-03,Brazil,203070494,Rio de Janeiro,16055174,0.3077,27192,4939537,0.1382,3810,2219254,0.0000,0,5
2021-06-04,Brazil,203070494,Rio de Janeiro,16055174,0.3104,44333,4983870,0.1386,6110,2225364,0.0000,0,5
2021-06-05,Brazil,203070494,Rio de Janeiro,16055174,0.3129,40547,5024417,0.1390,6400,2231764,0.0000,0,5
2021-06-06,Brazil,203070494,Rio de Janeiro,16055174,0.3130,577,5024994,0.1390,132,2231896,0.0000,0,5
2021-06-07,Brazil,203070494,Rio de Janeiro,16055174,0.3178,76847,5101841,0.1397,10606,2242502,0.0000,0,5
2021-06-08,Brazil,203070494,Rio de Janeiro,16055174,0.3229,83102,5184943,0.1402,8671,2251173,0.0000,0,5
2021-06-09,Brazil,203070494,Rio de Janeiro,16055174,0.3297,108102,5293045,0.1405,4922,2256095,0.0000,0,5
2021-06-10,Brazil,203070494,Rio de Janeiro,16055174,0.3344,76457,5369502,0.1409,5781,2261876,0.0000,0,5
2021-06-11,Brazil,203070494,Rio de Janeiro,16055174,0.3389,72110,5441612,0.1411,4075,2265951,0.0000,0,5
2021-06-12,Brazil,203070494,Rio de Janeiro,16055174,0.3428,61339,5502951,0.1412,1250,2267201,0.0000,0,5
2021-06-13,Brazil,203070494,Rio de Janeiro,16055174,0.3428,315,5503266,0.1412,37,2267238,0.0000,0,5
2021-06-14,Brazil,203070494,Rio de Janeiro,16055174,0.3483,89346,5592612,0.1415,4580,2271818,0.0000,1,6
2021-06-15,Brazil,203070494,Rio de Janeiro,16055174,0.3550,106953,5699565,0.1418,5455,2277273,0.0000,0,6
2021-06-16,Brazil,203070494,Rio de Janeiro,16055174,0.3610,96592,5796157,0.1422,5242,2282515,0.0000,0,6
2021-06-17,Brazil,203070494,Rio de Janeiro,16055174,0.3670,95995,5892152,0.1424,4319,2286834,0.0000,0,6
2021-06-18,Brazil,203070494,Rio de Janeiro,16055174,0.3726,89418,5981570,0.1427,3833,2290667,0.0000,0,6
2021-06-19,Brazil,203070494,Rio de Janeiro,16055174,0.3758,52297,6033867,0.1428,1965,2292632,0.0000,0,6
2021-06-20,Brazil,203070494,Rio de Janeiro,16055174,0.3764,9400,6043267,0.1428,121,2292753,0.0000,0,6
2021-06-21,Brazil,203070494,Rio de Janeiro,16055174,0.3819,87973,6131240,0.1432,6707,2299460,0.0000,0,6
2021-06-22,Brazil,203070494,Rio de Janeiro,16055174,0.3873,87660,6218900,0.1437,7020,2306480,0.0000,0,6
2021-06-23,Brazil,203070494,Rio de Janeiro,16055174,0.3938,103120,6322020,0.1441,7566,2314046,0.0000,0,6
2021-06-24,Brazil,203070494,Rio de Janeiro,16055174,0.3984,74965,6396985,0.1445,6675,2320721,0.0000,0,6
2021-06-25,Brazil,203070494,Rio de Janeiro,16055174,0.4028,70676,6467661,0.1449,4948,2325669,0.0000,0,6
2021-06-26,Brazil,203070494,Rio de Janeiro,16055174,0.4061,52332,6519993,0.1451,3567,2329236,0.0000,0,6
2021-06-27,Brazil,203070494,Rio de Janeiro,16055174,0.4066,7775,6527768,0.1451,74,2329310,0.0000,0,6
2021-06-28,Brazil,203070494,Rio de Janeiro,16055174,0.4143,123736,6651504,0.1456,8075,2337385,0.0000,0,6
2021-06-29,Brazil,203070494,Rio de Janeiro,16055174,0.4221,125403,6776907,0.1459,5140,2342525,0.0000,0,6
2021-06-30,Brazil,203070494,Rio de Janeiro,16055174,0.4296,119866,6896773,0.1466,10577,2353102,0.0000,0,6
2021-07-01,Brazil,203070494,Rio de Janeiro,16055174,0.4367,113935,7010708,0.1472,9987,2363089,0.0000,0,6
2021-07-02,Brazil,203070494,Rio de Janeiro,16055174,0.4434,107411,7118119,0.1492,33039,2396128,0.0000,0,6
2021-07-03,Brazil,203070494,Rio de Janeiro,16055174,0.4500,106076,7224195,0.1506,21801,2417929,0.0000,0,6
2021-07-04,Brazil,203070494,Rio de Janeiro,16055174,0.4501,2259,7226454,0.1507,1157,2419086,0.0000,0,6
2021-07-05,Brazil,203070494,Rio de Janeiro,16055174,0.4564,101202,7327656,0.1536,46214,2465300,0.0000,0,6
2021-07-06,Brazil,203070494,Rio de Janeiro,16055174,0.4641,123282,7450938,0.1559,37844,2503144,0.0000,0,6
2021-07-07,Brazil,203070494,Rio de Janeiro,16055174,0.4756,185563,7636501,0.1577,28663,2531807,0.0000,0,6
2021-07-08,Brazil,203070494,Rio de Janeiro,16055174,0.4832,122136,7758637,0.1606,46547,2578354,0.0000,0,6
2021-07-09,Brazil,203070494,Rio de Janeiro,16055174,0.4908,120759,7879396,0.1634,44335,2622689,0.0000,0,6
2021-07-10,Brazil,203070494,Rio de Janeiro,16055174,0.4955,75189,7954585,0.1647,21154,2643843,0.0000,0,6
2021-07-11,Brazil,203070494,Rio de Janeiro,16055174,0.4959,6599,7961184,0.1647,60,2643903,0.0000,0,6
2021-07-12,Brazil,203070494,Rio de Janeiro,16055174,0.5019,96505,8057689,0.1688,66039,2709942,0.0000,0,6
2021-07-13,Brazil,203070494,Rio de Janeiro,16055174,0.5079,97029,8154718,0.1725,59289,2769231,0.0000,0,6
2021-07-14,Brazil,203070494,Rio de Janeiro,16055174,0.5139,95401,8250119,0.1757,51498,2820729,0.0000,0,6
2021-07-15,Brazil,203070494,Rio de Janeiro,16055174,0.5194,88742,8338861,0.1797,64338,2885067,0.0000,0,6
2021-07-16,Brazil,203070494,Rio de Janeiro,16055174,0.5240,74285,8413146,0.1831,54651,2939718,0.0000,0,6
2021-07-17,Brazil,203070494,Rio de Janeiro,16055174,0.5272,51023,8464169,0.1851,32226,2971944,0.0000,0,6
2021-07-18,Brazil,203070494,Rio de Janeiro,16055174,0.5273,2009,8466178,0.1851,369,2972313,0.0000,1,7
2021-07-19,Brazil,203070494,Rio de Janeiro,16055174,0.5320,75362,8541540,0.1894,68786,3041099,0.0000,0,7
2021-07-20,Brazil,203070494,Rio de Janeiro,16055174,0.5373,85528,8627068,0.1931,58566,3099665,0.0000,0,7
2021-07-21,Brazil,203070494,Rio de Janeiro,16055174,0.5437,101437,8728505,0.1971,65252,3164917,0.0000,0,7
2021-07-22,Brazil,203070494,Rio de Janeiro,16055174,0.5488,82788,8811293,0.2009,60509,3225426,0.0000,1,8
2021-07-23,Brazil,203070494,Rio de Janeiro,16055174,0.5539,81999,8893292,0.2042,52680,3278106,0.0000,0,8
2021-07-24,Brazil,203070494,Rio de Janeiro,16055174,0.5554,24115,8917407,0.2055,21837,3299943,0.0000,0,8
2021-07-25,Brazil,203070494,Rio de Janeiro,16055174,0.5555,711,8918118,0.2056,241,3300184,0.0000,0,8
2021-07-26,Brazil,203070494,Rio de Janeiro,16055174,0.5583,44871,8962989,0.2097,65997,3366181,0.0000,0,8
2021-07-27,Brazil,203070494,Rio de Janeiro,16055174,0.5611,45783,9008772,0.2150,85836,3452017,0.0000,0,8
2021-07-28,Brazil,203070494,Rio de Janeiro,16055174,0.5661,79694,9088466,0.2203,85401,3537418,0.0000,0,8
2021-07-29,Brazil,203070494,Rio de Janeiro,16055174,0.5727,106587,9195053,0.2253,80182,3617600,0.0000,0,8
2021-07-30,Brazil,203070494,Rio de Janeiro,16055174,0.5779,82838,9277891,0.2305,83482,3701082,0.0000,0,8
2021-07-31,Brazil,203070494,Rio de Janeiro,16055174,0.5810,50171,9328062,0.2326,34016,3735098,0.0000,0,8
2021-08-01,Brazil,203070494,Rio de Janeiro,16055174,0.5819,13658,9341720,0.2327,170,3735268,0.0000,0,8
2021-08-02,Brazil,203070494,Rio de Janeiro,16055174,0.5890,115526,9457246,0.2361,55797,3791065,0.0000,0,8
2021-08-03,Brazil,203070494,Rio de Janeiro,16055174,0.5958,109093,9566339,0.2399,61228,3852293,0.0000,4,12
2021-08-04,Brazil,203070494,Rio de Janeiro,16055174,0.6022,102169,9668508,0.2437,60414,3912707,0.0000,2,14
2021-08-05,Brazil,203070494,Rio de Janeiro,16055174,0.6088,105763,9774271,0.2472,56169,3968876,0.0000,0,14
2021-08-06,Brazil,203070494,Rio de Janeiro,16055174,0.6156,109074,9883345,0.2500,45147,4014023,0.0000,2,16
2021-08-07,Brazil,203070494,Rio de Janeiro,16055174,0.6202,73963,9957308,0.2517,27346,4041369,0.0000,0,16
2021-08-08,Brazil,203070494,Rio de Janeiro,16055174,0.6203,918,9958226,0.2517,316,4041685,0.0000,0,16
2021-08-09,Brazil,203070494,Rio de Janeiro,16055174,0.6286,134313,10092539,0.2556,62218,4103903,0.0000,6,22
2021-08-10,Brazil,203070494,Rio de Janeiro,16055174,0.6371,135896,10228435,0.2597,65153,4169056,0.0000,8,30
2021-08-11,Brazil,203070494,Rio de Janeiro,16055174,0.6420,79631,10308066,0.2642,72077,4241133,0.0000,9,39
2021-08-12,Brazil,203070494,Rio de Janeiro,16055174,0.6457,59529,10367595,0.2687,72143,4313276,0.0000,1,40
2021-08-13,Brazil,203070494,Rio de Janeiro,16055174,0.6535,125129,10492724,0.2730,69795,4383071,0.0000,7,47
2021-08-14,Brazil,203070494,Rio de Janeiro,16055174,0.6603,108321,10601045,0.2752,35462,4418533,0.0000,2,49
2021-08-15,Brazil,203070494,Rio de Janeiro,16055174,0.6608,7932,10608977,0.2753,1977,4420510,0.0000,0,49
2021-08-16,Brazil,203070494,Rio de Janeiro,16055174,0.6696,141257,10750234,0.2800,75735,4496245,0.0000,3,52
2021-08-17,Brazil,203070494,Rio de Janeiro,16055174,0.6784,141197,10891431,0.2850,79417,4575662,0.0000,6,58
2021-08-18,Brazil,203070494,Rio de Janeiro,16055174,0.6873,143325,11034756,0.2907,91428,4667090,0.0000,2,60
2021-08-19,Brazil,203070494,Rio de Janeiro,16055174,0.6955,132050,11166806,0.2956,79359,4746449,0.0000,7,67
2021-08-20,Brazil,203070494,Rio de Janeiro,16055174,0.7050,151544,11318350,0.3003,75485,4821934,0.0000,6,73
2021-08-21,Brazil,203070494,Rio de Janeiro,16055174,0.7080,48438,11366788,0.3028,40050,4861984,0.0000,0,73
2021-08-22,Brazil,203070494,Rio de Janeiro,16055174,0.7080,606,11367394,0.3029,361,4862345,0.0000,0,73
2021-08-23,Brazil,203070494,Rio de Janeiro,16055174,0.7140,95326,11462720,0.3073,70841,4933186,0.0000,3,76
2021-08-24,Brazil,203070494,Rio de Janeiro,16055174,0.7199,95745,11558465,0.3114,67154,5000340,0.0000,4,80
2021-08-25,Brazil,203070494,Rio de Janeiro,16055174,0.7242,68136,11626601,0.3168,85210,5085550,0.0000,7,87
2021-08-26,Brazil,203070494,Rio de Janeiro,16055174,0.7295,85192,11711793,0.3207,63079,5148629,0.0000,7,94
2021-08-27,Brazil,203070494,Rio de Janeiro,16055174,0.7359,102512,11814305,0.3250,69403,5218032,0.0000,2,96
2021-08-28,Brazil,203070494,Rio de Janeiro,16055174,0.7411,83917,11898222,0.3278,44117,5262149,0.0000,0,96
2021-08-29,Brazil,203070494,Rio de Janeiro,16055174,0.7412,1203,11899425,0.3278,531,5262680,0.0000,0,96
2021-08-30,Brazil,203070494,Rio de Janeiro,16055174,0.7474,100282,11999707,0.3334,90636,5353316,0.0000,7,103
2021-08-31,Brazil,203070494,Rio de Janeiro,16055174,0.7526,84090,12083797,0.3396,99140,5452456,0.0000,5,108
2021-09-01,Brazil,203070494,Rio de Janeiro,16055174,0.7564,60902,12144699,0.3478,130961,5583417,0.0000,4,112
2021-09-02,Brazil,203070494,Rio de Janeiro,16055174,0.7593,46775,12191474,0.3531,85593,5669010,0.0000,6,118
2021-09-03,Brazil,203070494,Rio de Janeiro,16055174,0.7616,36101,12227575,0.3579,77603,5746613,0.0000,10,128
2021-09-04,Brazil,203070494,Rio de Janeiro,16055174,0.7627,16912,12244487,0.3613,53735,5800348,0.0000,0,128
2021-09-05,Brazil,203070494,Rio de Janeiro,16055174,0.7627,522,12245009,0.3613,318,5800666,0.0000,0,128
2021-09-06,Brazil,203070494,Rio de Janeiro,16055174,0.7638,18569,12263578,0.3649,57531,5858197,0.0000,4,132
2021-09-07,Brazil,203070494,Rio de Janeiro,16055174,0.7639,1385,12264963,0.3650,2743,5860940,0.0000,0,132
2021-09-08,Brazil,203070494,Rio de Janeiro,16055174,0.7678,62653,12327616,0.3748,157282,6018222,0.0000,6,138
2021-09-09,Brazil,203070494,Rio de Janeiro,16055174,0.7715,58227,12385843,0.3826,124545,6142767,0.0000,9,147
2021-09-10,Brazil,203070494,Rio de Janeiro,16055174,0.7759,71456,12457299,0.3891,104740,6247507,0.0000,5,152
2021-09-11,Brazil,203070494,Rio de Janeiro,16055174,0.7777,28126,12485425,0.3918,42825,6290332,0.0000,0,152
2021-09-12,Brazil,203070494,Rio de Janeiro,16055174,0.7777,568,12485993,0.3918,170,6290502,0.0000,0,152
2021-09-13,Brazil,203070494,Rio de Janeiro,16055174,0.7808,49583,12535576,0.3975,91673,6382175,0.0000,4,156
2021-09-14,Brazil,203070494,Rio de Janeiro,16055174,0.7841,52740,12588316,0.4063,141482,6523657,0.0000,11,167
2021-09-15,Brazil,203070494,Rio de Janeiro,16055174,0.7883,68387,12656703,0.4143,127427,6651084,0.0000,4,171
2021-09-16,Brazil,203070494,Rio de Janeiro,16055174,0.7922,62747,12719450,0.4205,100098,6751182,0.0000,11,182
2021-09-17,Brazil,203070494,Rio de Janeiro,16055174,0.7962,63373,12782823,0.4259,86339,6837521,0.0000,4,186
2021-09-18,Brazil,203070494,Rio de Janeiro,16055174,0.7972,16814,12799637,0.4282,37362,6874883,0.0000,0,186
2021-09-19,Brazil,203070494,Rio de Janeiro,16055174,0.7973,577,12800214,0.4283,1453,6876336,0.0000,0,186
2021-09-20,Brazil,203070494,Rio de Janeiro,16055174,0.7996,37522,12837736,0.4354,113999,6990335,0.0000,5,191
2021-09-21,Brazil,203070494,Rio de Janeiro,16055174,0.8021,39602,12877338,0.4425,114206,7104541,0.0000,6,197
2021-09-22,Brazil,203070494,Rio de Janeiro,16055174,0.8061,64435,12941773,0.4498,117863,7222404,0.0000,8,205
2021-09-23,Brazil,203070494,Rio de Janeiro,16055174,0.8092,50089,12991862,0.4568,111933,7334337,0.0000,9,214
2021-09-24,Brazil,203070494,Rio de Janeiro,16055174,0.8150,93886,13085748,0.4626,92864,7427201,0.0000,8,222
2021-09-25,Brazil,203070494,Rio de Janeiro,16055174,0.8190,64024,13149772,0.4675,78943,7506144,0.0000,1,223
2021-09-26,Brazil,203070494,Rio de Janeiro,16055174,0.8191,450,13150222,0.4676,513,7506657,0.0000,0,223
2021-09-27,Brazil,203070494,Rio de Janeiro,16055174,0.8211,33216,13183438,0.4743,108791,7615448,0.0000,10,233
2021-09-28,Brazil,203070494,Rio de Janeiro,16055174,0.8228,27491,13210929,0.4814,112958,7728406,0.0000,8,241
2021-09-29,Brazil,203070494,Rio de Janeiro,16055174,0.8245,26949,13237878,0.4876,100155,7828561,0.0000,14,255
2021-09-30,Brazil,203070494,Rio de Janeiro,16055174,0.8260,23393,13261271,0.4936,95830,7924391,0.0000,9,264
2021-10-01,Brazil,203070494,Rio de Janeiro,16055174,0.8275,23922,13285193,0.4988,83634,8008025,0.0000,2,266
2021-10-02,Brazil,203070494,Rio de Janeiro,16055174,0.8285,15817,13301010,0.5011,37183,8045208,0.0000,1,267
2021-10-03,Brazil,203070494,Rio de Janeiro,16055174,0.8285,315,13301325,0.5011,714,8045922,0.0000,0,267
2021-10-04,Brazil,203070494,Rio de Janeiro,16055174,0.8295,17207,13318532,0.5066,86962,8132884,0.0000,2,269
2021-10-05,Brazil,203070494,Rio de Janeiro,16055174,0.8305,14643,13333175,0.5120,87729,8220613,0.0000,5,274
2021-10-06,Brazil,203070494,Rio de Janeiro,16055174,0.8314,15424,13348599,0.5173,84649,8305262,0.0000,5,279
2021-10-07,Brazil,203070494,Rio de Janeiro,16055174,0.8323,14672,13363271,0.5217,71213,8376475,0.0000,5,284
2021-10-08,Brazil,203070494,Rio de Janeiro,16055174,0.8331,11959,13375230,0.5256,62210,8438685,0.0000,4,288
2021-10-09,Brazil,203070494,Rio de Janeiro,16055174,0.8334,5227,13380457,0.5275,30158,8468843,0.0000,3,291
2021-10-10,Brazil,203070494,Rio de Janeiro,16055174,0.8334,277,13380734,0.5275,868,8469711,0.0000,0,291
2021-10-11,Brazil,203070494,Rio de Janeiro,16055174,0.8336,3276,13384010,0.5292,26880,8496591,0.0000,0,291
2021-10-12,Brazil,203070494,Rio de Janeiro,16055174,0.8336,184,13384194,0.5293,1411,8498002,0.0000,0,291
2021-10-13,Brazil,203070494,Rio de Janeiro,16055174,0.8343,10304,13394498,0.5353,96232,8594234,0.0000,10,301
2021-10-14,Brazil,203070494,Rio de Janeiro,16055174,0.8350,11072,13405570,0.5410,91753,8685987,0.0000,5,306
2021-10-15,Brazil,203070494,Rio de Janeiro,16055174,0.8357,11069,13416639,0.5458,76449,8762436,0.0000,19,325
2021-10-16,Brazil,203070494,Rio de Janeiro,16055174,0.8360,5389,13422028,0.5476,28860,8791296,0.0000,2,327
2021-10-17,Brazil,203070494,Rio de Janeiro,16055174,0.8360,157,13422185,0.5476,660,8791956,0.0000,0,327
2021-10-18,Brazil,203070494,Rio de Janeiro,16055174,0.8366,8869,13431054,0.5512,57326,8849282,0.0000,3,330
2021-10-19,Brazil,203070494,Rio de Janeiro,16055174,0.8371,8066,13439120,0.5549,59747,8909029,0.0000,2,332
2021-10-20,Brazil,203070494,Rio de Janeiro,16055174,0.8376,7973,13447093,0.5586,59527,8968556,0.0000,0,332
2021-10-21,Brazil,203070494,Rio de Janeiro,16055174,0.8382,10485,13457578,0.5635,78804,9047360,0.0000,5,337
2021-10-22,Brazil,203070494,Rio de Janeiro,16055174,0.8388,9421,13466999,0.5680,71997,9119357,0.0000,47,384
2021-10-23,Brazil,203070494,Rio de Janeiro,16055174,0.8391,4290,13471289,0.5702,35218,9154575,0.0000,2,386
2021-10-24,Brazil,203070494,Rio de Janeiro,16055174,0.8391,271,13471560,0.5702,728,9155303,0.0000,0,386
2021-10-25,Brazil,203070494,Rio de Janeiro,16055174,0.8396,8640,13480200,0.5765,100767,9256070,0.0000,7,393
2021-10-26,Brazil,203070494,Rio de Janeiro,16055174,0.8402,9680,13489880,0.5829,103242,9359312,0.0000,4,397
2021-10-27,Brazil,203070494,Rio de Janeiro,16055174,0.8409,10875,13500755,0.5883,85189,9444501,0.0000,7,404
2021-10-28,Brazil,203070494,Rio de Janeiro,16055174,0.8414,7571,13508326,0.5934,82409,9526910,0.0000,5,409
2021-10-29,Brazil,203070494,Rio de Janeiro,16055174,0.8417,6055,13514381,0.5977,68693,9595603,0.0000,47,456
2021-10-30,Brazil,203070494,Rio de Janeiro,16055174,0.8420,3454,13517835,0.6007,48664,9644267,0.0000,0,456
2021-10-31,Brazil,203070494,Rio de Janeiro,16055174,0.8420,81,13517916,0.6007,243,9644510,0.0000,0,456
2021-11-01,Brazil,203070494,Rio de Janeiro,16055174,0.8420,637,13518553,0.6010,4356,9648866,0.0000,0,456
2021-11-02,Brazil,203070494,Rio de Janeiro,16055174,0.8420,167,13518720,0.6010,954,9649820,0.0000,0,456
2021-11-03,Brazil,203070494,Rio de Janeiro,16055174,0.8425,7583,13526303,0.6084,118690,9768510,0.0000,4,460
2021-11-04,Brazil,203070494,Rio de Janeiro,16055174,0.8430,8198,13534501,0.6134,79342,9847852,0.0000,4,464
2021-11-05,Brazil,203070494,Rio de Janeiro,16055174,0.8435,7319,13541820,0.6201,107833,9955685,0.0000,2,466
2021-11-06,Brazil,203070494,Rio de Janeiro,16055174,0.8436,2417,13544237,0.6231,47871,10003556,0.0000,1,467
2021-11-07,Brazil,203070494,Rio de Janeiro,16055174,0.8436,72,13544309,0.6231,503,10004059,0.0000,0,467
2021-11-08,Brazil,203070494,Rio de Janeiro,16055174,0.8440,6301,13550610,0.6298,107706,10111765,0.0000,6,473
2021-11-09,Brazil,203070494,Rio de Janeiro,16055174,0.8444,6544,13557154,0.6358,96836,10208601,0.0000,3,476
2021-11-10,Brazil,203070494,Rio de Janeiro,16055174,0.8448,6298,13563452,0.6416,91715,10300316,0.0000,2,478
2021-11-11,Brazil,203070494,Rio de Janeiro,16055174,0.8451,5434,13568886,0.6477,97996,10398312,0.0000,12,490
2021-11-12,Brazil,203070494,Rio de Janeiro,16055174,0.8454,4955,13573841,0.6536,96057,10494369,0.0000,2,492
2021-11-13,Brazil,203070494,Rio de Janeiro,16055174,0.8456,1624,13575465,0.6556,31646,10526015,0.0000,2,494
2021-11-14,Brazil,203070494,Rio de Janeiro,16055174,0.8456,92,13575557,0.6556,511,10526526,0.0000,0,494
2021-11-15,Brazil,203070494,Rio de Janeiro,16055174,0.8456,506,13576063,0.6557,1197,10527723,0.0000,0,494
2021-11-16,Brazil,203070494,Rio de Janeiro,16055174,0.8460,5961,13582024,0.6612,87456,10615179,0.0000,6,500
2021-11-17,Brazil,203070494,Rio de Janeiro,16055174,0.8463,6152,13588176,0.6661,78851,10694030,0.0000,1,501
2021-11-18,Brazil,203070494,Rio de Janeiro,16055174,0.8467,5719,13593895,0.6711,80298,10774328,0.0000,1,502
2021-11-19,Brazil,203070494,Rio de Janeiro,16055174,0.8470,5098,13598993,0.6754,69265,10843593,0.0000,3,505
2021-11-20,Brazil,203070494,Rio de Janeiro,16055174,0.8472,2683,13601676,0.6778,38925,10882518,0.0000,4,509
2021-11-21,Brazil,203070494,Rio de Janeiro,16055174,0.8472,69,13601745,0.6779,639,10883157,0.0000,0,509
2021-11-22,Brazil,203070494,Rio de Janeiro,16055174,0.8475,5340,13607085,0.6822,70313,10953470,0.0000,0,509
2021-11-23,Brazil,203070494,Rio de Janeiro,16055174,0.8479,5635,13612720,0.6867,71205,11024675,0.0000,2,511
2021-11-24,Brazil,203070494,Rio de Janeiro,16055174,0.8482,5323,13618043,0.6903,58256,11082931,0.0000,2,513
2021-11-25,Brazil,203070494,Rio de Janeiro,16055174,0.8485,5154,13623197,0.6937,54135,11137066,0.0000,1,514
2021-11-26,Brazil,203070494,Rio de Janeiro,16055174,0.8488,4138,13627335,0.6966,47401,11184467,0.0000,0,514
2021-11-27,Brazil,203070494,Rio de Janeiro,16055174,0.8489,1562,13628897,0.6977,17742,11202209,0.0000,0,514
2021-11-28,Brazil,203070494,Rio de Janeiro,16055174,0.8489,94,13628991,0.6978,664,11202873,0.0000,0,514
2021-11-29,Brazil,203070494,Rio de Janeiro,16055174,0.8492,4488,13633479,0.7005,43167,11246040,0.0000,0,514
2021-11-30,Brazil,203070494,Rio de Janeiro,16055174,0.8495,5014,13638493,0.7035,48585,11294625,0.0000,0,514
2021-12-01,Brazil,203070494,Rio de Janeiro,16055174,0.8498,4826,13643319,0.7064,47059,11341684,0.0000,2,516
2021-12-02,Brazil,203070494,Rio de Janeiro,16055174,0.8502,6521,13649840,0.7097,52618,11394302,0.0000,1,517
2021-12-03,Brazil,203070494,Rio de Janeiro,16055174,0.8506,6118,13655958,0.7127,48896,11443198,0.0000,0,517
2021-12-04,Brazil,203070494,Rio de Janeiro,16055174,0.8507,2244,13658202,0.7138,16198,11459396,0.0000,1,518
2021-12-05,Brazil,203070494,Rio de Janeiro,16055174,0.8507,80,13658282,0.7138,418,11459814,0.0000,0,518
2021-12-06,Brazil,203070494,Rio de Janeiro,16055174,0.8510,5075,13663357,0.7161,36958,11496772,0.0000,3,521
2021-12-07,Brazil,203070494,Rio de Janeiro,16055174,0.8513,5023,13668380,0.7182,34559,11531331,0.0000,0,521
2021-12-08,Brazil,203070494,Rio de Janeiro,16055174,0.8516,3491,13671871,0.7200,28588,11559919,0.0000,1,522
2021-12-09,Brazil,203070494,Rio de Janeiro,16055174,0.8518,4585,13676456,0.7222,35133,11595052,0.0000,1,523
2021-12-10,Brazil,203070494,Rio de Janeiro,16055174,0.8521,3410,13679866,0.7239,27377,11622429,0.0000,3,526
2021-12-11,Brazil,203070494,Rio de Janeiro,16055174,0.8521,1075,13680941,0.7244,8266,11630695,0.0000,1,527
2021-12-12,Brazil,203070494,Rio de Janeiro,16055174,0.8521,70,13681011,0.7245,642,11631337,0.0000,0,527
2021-12-13,Brazil,203070494,Rio de Janeiro,16055174,0.8523,2890,13683901,0.7259,22483,11653820,0.0000,1,528
2021-12-14,Brazil,203070494,Rio de Janeiro,16055174,0.8525,3745,13687646,0.7275,26921,11680741,0.0000,3,531
2021-12-15,Brazil,203070494,Rio de Janeiro,16055174,0.8527,3040,13690686,0.7292,26305,11707046,0.0000,1,532
2021-12-16,Brazil,203070494,Rio de Janeiro,16055174,0.8529,3212,13693898,0.7307,24114,11731160,0.0000,1,533
2021-12-17,Brazil,203070494,Rio de Janeiro,16055174,0.8531,2313,13696211,0.7322,23673,11754833,0.0000,2,535
2021-12-18,Brazil,203070494,Rio de Janeiro,16055174,0.8531,790,13697001,0.7327,8888,11763721,0.0000,1,536
2021-12-19,Brazil,203070494,Rio de Janeiro,16055174,0.8531,43,13697044,0.7327,308,11764029,0.0000,0,536
2021-12-20,Brazil,203070494,Rio de Janeiro,16055174,0.8533,2973,13700017,0.7343,25246,11789275,0.0000,3,539
2021-12-21,Brazil,203070494,Rio de Janeiro,16055174,0.8535,2680,13702697,0.7357,22776,11812051,0.0000,1,540
2021-12-22,Brazil,203070494,Rio de Janeiro,16055174,0.8536,2131,13704828,0.7369,19312,11831363,0.0000,4,544
2021-12-23,Brazil,203070494,Rio de Janeiro,16055174,0.8537,1523,13706351,0.7376,11237,11842600,0.0000,1,545
2021-12-24,Brazil,203070494,Rio de Janeiro,16055174,0.8537,127,13706478,0.7377,845,11843445,0.0000,1,546
2021-12-25,Brazil,203070494,Rio de Janeiro,16055174,0.8537,19,13706497,0.7377,99,11843544,0.0000,0,546
2021-12-26,Brazil,203070494,Rio de Janeiro,16055174,0.8537,15,13706512,0.7377,151,11843695,0.0000,0,546
2021-12-27,Brazil,203070494,Rio de Janeiro,16055174,0.8538,1652,13708164,0.7385,12825,11856520,0.0000,4,550
2021-12-28,Brazil,203070494,Rio de Janeiro,16055174,0.8540,2184,13710348,0.7396,18006,11874526,0.0000,4,554
2021-12-29,Brazil,203070494,Rio de Janeiro,16055174,0.8541,2061,13712409,0.7406,15704,11890230,0.0000,1,555
2021-12-30,Brazil,203070494,Rio de Janeiro,16055174,0.8542,1388,13713797,0.7412,9777,11900007,0.0000,5,560
2021-12-31,Brazil,203070494,Rio de Janeiro,16055174,0.8542,167,13713964,0.7412,861,11900868,0.0000,1,561
2021-01-01,Brazil,203070494,Rondônia,1581196,0.0000,1,1,0.0000,0,0,0.0000,0,0
2021-01-04,Brazil,203070494,Rondônia,1581196,0.0000,1,2,0.0000,1,1,0.0000,0,0
2021-01-05,Brazil,203070494,Rondônia,1581196,0.0000,0,2,0.0000,0,1,0.0000,0,0
2021-01-07,Brazil,203070494,Rondônia,1581196,0.0000,1,3,0.0000,0,1,0.0000,0,0
2021-01-11,Brazil,203070494,Rondônia,1581196,0.0000,0,3,0.0000,1,2,0.0000,0,0
2021-01-12,Brazil,203070494,Rondônia,1581196,0.0000,3,6,0.0000,5,7,0.0000,31,31
2021-01-13,Brazil,203070494,Rondônia,1581196,0.0000,0,6,0.0000,2,9,0.0000,5,36
2021-01-14,Brazil,203070494,Rondônia,1581196,0.0000,0,6,0.0000,2,11,0.0000,0,36
2021-01-17,Brazil,203070494,Rondônia,1581196,0.0000,2,8,0.0000,0,11,0.0000,0,36
2021-01-18,Brazil,203070494,Rondônia,1581196,0.0000,3,11,0.0000,1,12,0.0000,0,36
2021-01-19,Brazil,203070494,Rondônia,1581196,0.0002,233,244,0.0000,2,14,0.0000,11,47
2021-01-20,Brazil,203070494,Rondônia,1581196,0.0010,1360,1604,0.0000,2,16,0.0000,0,47
2021-01-21,Brazil,203070494,Rondônia,1581196,0.0031,3248,4852,0.0000,10,26,0.0000,0,47
2021-01-22,Brazil,203070494,Rondônia,1581196,0.0043,2026,6878,0.0000,7,33,0.0000,0,47
2021-01-23,Brazil,203070494,Rondônia,1581196,0.0049,872,7750,0.0000,4,37,0.0000,0,47
2021-01-24,Brazil,203070494,Rondônia,1581196,0.0052,440,8190,0.0000,4,41,0.0000,0,47
2021-01-25,Brazil,203070494,Rondônia,1581196,0.0059,1192,9382,0.0000,2,43,0.0000,0,47
2021-01-26,Brazil,203070494,Rondônia,1581196,0.0070,1653,11035,0.0000,5,48,0.0000,0,47
2021-01-27,Brazil,203070494,Rondônia,1581196,0.0082,1876,12911,0.0000,4,52,0.0000,0,47
2021-01-28,Brazil,203070494,Rondônia,1581196,0.0093,1819,14730,0.0000,1,53,0.0000,0,47
2021-01-29,Brazil,203070494,Rondônia,1581196,0.0105,1817,16547,0.0000,3,56,0.0000,1,48
2021-01-30,Brazil,203070494,Rondônia,1581196,0.0113,1296,17843,0.0000,0,56,0.0000,0,48
2021-01-31,Brazil,203070494,Rondônia,1581196,0.0115,365,18208,0.0000,1,57,0.0000,0,48
2021-02-01,Brazil,203070494,Rondônia,1581196,0.0124,1430,19638,0.0000,1,58,0.0000,0,48
2021-02-02,Brazil,203070494,Rondônia,1581196,0.0138,2236,21874,0.0000,7,65,0.0000,0,48
2021-02-03,Brazil,203070494,Rondônia,1581196,0.0154,2495,24369,0.0001,20,85,0.0000,0,48
2021-02-04,Brazil,203070494,Rondônia,1581196,0.0177,3620,27989,0.0001,33,118,0.0000,0,48
2021-02-05,Brazil,203070494,Rondônia,1581196,0.0194,2620,30609,0.0001,21,139,0.0000,0,48
2021-02-06,Brazil,203070494,Rondônia,1581196,0.0195,291,30900,0.0001,1,140,0.0000,0,48
2021-02-07,Brazil,203070494,Rondônia,1581196,0.0196,36,30936,0.0001,2,142,0.0000,0,48
2021-02-08,Brazil,203070494,Rondônia,1581196,0.0201,852,31788,0.0001,21,163,0.0000,0,48
2021-02-09,Brazil,203070494,Rondônia,1581196,0.0212,1736,33524,0.0001,16,179,0.0000,0,48
2021-02-10,Brazil,203070494,Rondônia,1581196,0.0223,1801,35325,0.0001,32,211,0.0000,0,48
2021-02-11,Brazil,203070494,Rondônia,1581196,0.0237,2166,37491,0.0001,26,237,0.0000,0,48
2021-02-12,Brazil,203070494,Rondônia,1581196,0.0254,2656,40147,0.0002,48,285,0.0000,0,48
2021-02-13,Brazil,203070494,Rondônia,1581196,0.0258,685,40832,0.0002,3,288,0.0000,0,48
2021-02-14,Brazil,203070494,Rondônia,1581196,0.0259,54,40886,0.0002,2,290,0.0000,0,48
2021-02-15,Brazil,203070494,Rondônia,1581196,0.0267,1269,42155,0.0005,485,775,0.0000,0,48
2021-02-16,Brazil,203070494,Rondônia,1581196,0.0271,630,42785,0.0006,201,976,0.0000,0,48
2021-02-17,Brazil,203070494,Rondônia,1581196,0.0281,1643,44428,0.0016,1493,2469,0.0000,0,48
2021-02-18,Brazil,203070494,Rondônia,1581196,0.0290,1477,45905,0.0031,2425,4894,0.0000,0,48
2021-02-19,Brazil,203070494,Rondônia,1581196,0.0298,1202,47107,0.0041,1629,6523,0.0000,0,48
2021-02-20,Brazil,203070494,Rondônia,1581196,0.0300,381,47488,0.0045,514,7037,0.0000,0,48
2021-02-21,Brazil,203070494,Rondônia,1581196,0.0301,86,47574,0.0047,388,7425,0.0000,0,48
2021-02-22,Brazil,203070494,Rondônia,1581196,0.0308,1115,48689,0.0059,1879,9304,0.0000,0,48
2021-02-23,Brazil,203070494,Rondônia,1581196,0.0315,1121,49810,0.0070,1760,11064,0.0000,0,48
2021-02-24,Brazil,203070494,Rondônia,1581196,0.0322,1156,50966,0.0083,2003,13067,0.0000,0,48
2021-02-25,Brazil,203070494,Rondônia,1581196,0.0326,580,51546,0.0090,1208,14275,0.0000,0,48
2021-02-26,Brazil,203070494,Rondônia,1581196,0.0328,257,51803,0.0095,821,15096,0.0000,0,48
2021-02-27,Brazil,203070494,Rondônia,1581196,0.0328,138,51941,0.0097,254,15350,0.0000,0,48
2021-02-28,Brazil,203070494,Rondônia,1581196,0.0329,61,52002,0.0098,187,15537,0.0000,0,48
2021-03-01,Brazil,203070494,Rondônia,1581196,0.0331,352,52354,0.0102,652,16189,0.0000,0,48
2021-03-02,Brazil,203070494,Rondônia,1581196,0.0335,695,53049,0.0110,1217,17406,0.0000,0,48
2021-03-03,Brazil,203070494,Rondônia,1581196,0.0342,1004,54053,0.0118,1273,18679,0.0000,0,48
2021-03-04,Brazil,203070494,Rondônia,1581196,0.0347,756,54809,0.0126,1200,19879,0.0000,0,48
2021-03-05,Brazil,203070494,Rondônia,1581196,0.0355,1246,56055,0.0131,757,20636,0.0000,0,48
2021-03-06,Brazil,203070494,Rondônia,1581196,0.0355,147,56202,0.0132,291,20927,0.0000,0,48
2021-03-07,Brazil,203070494,Rondônia,1581196,0.0356,34,56236,0.0133,123,21050,0.0000,0,48
2021-03-08,Brazil,203070494,Rondônia,1581196,0.0361,841,57077,0.0135,335,21385,0.0000,0,48
2021-03-09,Brazil,203070494,Rondônia,1581196,0.0366,870,57947,0.0143,1221,22606,0.0000,0,48
2021-03-10,Brazil,203070494,Rondônia,1581196,0.0375,1356,59303,0.0149,1002,23608,0.0000,0,48
2021-03-11,Brazil,203070494,Rondônia,1581196,0.0387,1836,61139,0.0160,1659,25267,0.0000,0,48
2021-03-12,Brazil,203070494,Rondônia,1581196,0.0395,1371,62510,0.0173,2121,27388,0.0000,0,48
2021-03-13,Brazil,203070494,Rondônia,1581196,0.0398,437,62947,0.0177,661,28049,0.0000,0,48
2021-03-14,Brazil,203070494,Rondônia,1581196,0.0399,100,63047,0.0178,64,28113,0.0000,0,48
2021-03-15,Brazil,203070494,Rondônia,1581196,0.0405,951,63998,0.0188,1540,29653,0.0000,0,48
2021-03-16,Brazil,203070494,Rondônia,1581196,0.0411,1023,65021,0.0191,594,30247,0.0000,0,48
2021-03-17,Brazil,203070494,Rondônia,1581196,0.0425,2171,67192,0.0199,1192,31439,0.0000,0,48
2021-03-18,Brazil,203070494,Rondônia,1581196,0.0434,1406,68598,0.0206,1119,32558,0.0000,0,48
2021-03-19,Brazil,203070494,Rondônia,1581196,0.0444,1565,70163,0.0211,851,33409,0.0000,0,48
2021-03-20,Brazil,203070494,Rondônia,1581196,0.0451,1103,71266,0.0214,407,33816,0.0000,0,48
2021-03-21,Brazil,203070494,Rondônia,1581196,0.0452,178,71444,0.0214,64,33880,0.0000,0,48
2021-03-22,Brazil,203070494,Rondônia,1581196,0.0459,1127,72571,0.0219,780,34660,0.0000,0,48
2021-03-23,Brazil,203070494,Rondônia,1581196,0.0483,3828,76399,0.0223,556,35216,0.0000,0,48
2021-03-24,Brazil,203070494,Rondônia,1581196,0.0511,4392,80791,0.0227,652,35868,0.0000,0,48
2021-03-25,Brazil,203070494,Rondônia,1581196,0.0542,4965,85756,0.0230,493,36361,0.0000,0,48
2021-03-26,Brazil,203070494,Rondônia,1581196,0.0565,3591,89347,0.0232,366,36727,0.0000,0,48
2021-03-27,Brazil,203070494,Rondônia,1581196,0.0586,3322,92669,0.0233,90,36817,0.0000,0,48
2021-03-28,Brazil,203070494,Rondônia,1581196,0.0603,2609,95278,0.0233,58,36875,0.0000,0,48
2021-03-29,Brazil,203070494,Rondônia,1581196,0.0621,2987,98265,0.0235,269,37144,0.0000,5,53
2021-03-30,Brazil,203070494,Rondônia,1581196,0.0677,8719,106984,0.0239,587,37731,0.0000,0,53
2021-03-31,Brazil,203070494,Rondônia,1581196,0.0744,10603,117587,0.0241,381,38112,0.0000,0,53
2021-04-01,Brazil,203070494,Rondônia,1581196,0.0803,9392,126979,0.0244,473,38585,0.0000,0,53
2021-04-02,Brazil,203070494,Rondônia,1581196,0.0809,867,127846,0.0245,125,38710,0.0000,0,53
2021-04-03,Brazil,203070494,Rondônia,1581196,0.0823,2277,130123,0.0246,112,38822,0.0000,0,53
2021-04-04,Brazil,203070494,Rondônia,1581196,0.0824,182,130305,0.0246,76,38898,0.0000,0,53
2021-04-05,Brazil,203070494,Rondônia,1581196,0.0853,4563,134868,0.0250,554,39452,0.0000,0,53
2021-04-06,Brazil,203070494,Rondônia,1581196,0.0881,4493,139361,0.0253,616,40068,0.0000,0,53
2021-04-07,Brazil,203070494,Rondônia,1581196,0.0919,6013,145374,0.0264,1668,41736,0.0000,0,53
2021-04-08,Brazil,203070494,Rondônia,1581196,0.0943,3677,149051,0.0277,2045,43781,0.0000,1,54
2021-04-09,Brazil,203070494,Rondônia,1581196,0.0983,6339,155390,0.0284,1144,44925,0.0000,4,58
2021-04-10,Brazil,203070494,Rondônia,1581196,0.0999,2606,157996,0.0286,354,45279,0.0000,0,58
2021-04-11,Brazil,203070494,Rondônia,1581196,0.1000,84,158080,0.0287,42,45321,0.0000,0,58
2021-04-12,Brazil,203070494,Rondônia,1581196,0.1009,1491,159571,0.0293,1063,46384,0.0000,0,58
2021-04-13,Brazil,203070494,Rondônia,1581196,0.1042,5134,164705,0.0298,724,47108,0.0000,0,58
2021-04-14,Brazil,203070494,Rondônia,1581196,0.1059,2770,167475,0.0311,2087,49195,0.0000,3,61
2021-04-15,Brazil,203070494,Rondônia,1581196,0.1075,2431,169906,0.0321,1525,50720,0.0000,0,61
2021-04-16,Brazil,203070494,Rondônia,1581196,0.1092,2773,172679,0.0332,1702,52422,0.0000,0,61
2021-04-17,Brazil,203070494,Rondônia,1581196,0.1099,1122,173801,0.0335,514,52936,0.0000,0,61
2021-04-18,Brazil,203070494,Rondônia,1581196,0.1099,13,173814,0.0336,124,53060,0.0000,0,61
2021-04-19,Brazil,203070494,Rondônia,1581196,0.1109,1491,175305,0.0344,1343,54403,0.0000,1,62
2021-04-20,Brazil,203070494,Rondônia,1581196,0.1151,6714,182019,0.0368,3835,58238,0.0000,2,64
2021-04-21,Brazil,203070494,Rondônia,1581196,0.1162,1692,183711,0.0375,1040,59278,0.0000,0,64
2021-04-22,Brazil,203070494,Rondônia,1581196,0.1192,4812,188523,0.0413,6040,65318,0.0000,0,64
2021-04-23,Brazil,203070494,Rondônia,1581196,0.1216,3821,192344,0.0436,3547,68865,0.0000,1,65
2021-04-24,Brazil,203070494,Rondônia,1581196,0.1232,2431,194775,0.0460,3811,72676,0.0000,0,65
2021-04-25,Brazil,203070494,Rondônia,1581196,0.1232,22,194797,0.0461,145,72821,0.0000,0,65
2021-04-26,Brazil,203070494,Rondônia,1581196,0.1244,1896,196693,0.0491,4763,77584,0.0000,1,66
2021-04-27,Brazil,203070494,Rondônia,1581196,0.1257,2113,198806,0.0532,6581,84165,0.0000,0,66
2021-04-28,Brazil,203070494,Rondônia,1581196,0.1272,2276,201082,0.0570,6025,90190,0.0000,0,66
2021-04-29,Brazil,203070494,Rondônia,1581196,0.1303,5000,206082,0.0591,3255,93445,0.0000,0,66
2021-04-30,Brazil,203070494,Rondônia,1581196,0.1342,6038,212120,0.0605,2170,95615,0.0000,0,66
2021-05-01,Brazil,203070494,Rondônia,1581196,0.1353,1824,213944,0.0608,545,96160,0.0000,0,66
2021-05-02,Brazil,203070494,Rondônia,1581196,0.1354,80,214024,0.0609,88,96248,0.0000,0,66
2021-05-03,Brazil,203070494,Rondônia,1581196,0.1367,2074,216098,0.0639,4786,101034,0.0000,0,66
2021-05-04,Brazil,203070494,Rondônia,1581196,0.1384,2716,218814,0.0660,3281,104315,0.0000,0,66
2021-05-05,Brazil,203070494,Rondônia,1581196,0.1401,2681,221495,0.0683,3665,107980,0.0000,0,66
2021-05-06,Brazil,203070494,Rondônia,1581196,0.1433,5052,226547,0.0696,2111,110091,0.0000,0,66
2021-05-07,Brazil,203070494,Rondônia,1581196,0.1461,4411,230958,0.0705,1457,111548,0.0000,0,66
2021-05-08,Brazil,203070494,Rondônia,1581196,0.1473,1969,232927,0.0709,491,112039,0.0000,0,66
2021-05-09,Brazil,203070494,Rondônia,1581196,0.1473,11,232938,0.0709,34,112073,0.0000,0,66
2021-05-10,Brazil,203070494,Rondônia,1581196,0.1489,2528,235466,0.0732,3672,115745,0.0000,0,66
2021-05-11,Brazil,203070494,Rondônia,1581196,0.1523,5362,240828,0.0740,1339,117084,0.0000,3,69
2021-05-12,Brazil,203070494,Rondônia,1581196,0.1550,4260,245088,0.0753,1988,119072,0.0000,1,70
2021-05-13,Brazil,203070494,Rondônia,1581196,0.1594,6965,252053,0.0759,939,120011,0.0000,0,70
2021-05-14,Brazil,203070494,Rondônia,1581196,0.1629,5596,257649,0.0785,4061,124072,0.0000,0,70
2021-05-15,Brazil,203070494,Rondônia,1581196,0.1639,1532,259181,0.0789,744,124816,0.0000,0,70
2021-05-16,Brazil,203070494,Rondônia,1581196,0.1639,13,259194,0.0789,9,124825,0.0000,0,70
2021-05-17,Brazil,203070494,Rondônia,1581196,0.1655,2459,261653,0.0799,1436,126261,0.0000,0,70
2021-05-18,Brazil,203070494,Rondônia,1581196,0.1679,3765,265418,0.0828,4662,130923,0.0000,5,75
2021-05-19,Brazil,203070494,Rondônia,1581196,0.1702,3660,269078,0.0856,4406,135329,0.0000,0,75
2021-05-20,Brazil,203070494,Rondônia,1581196,0.1751,7837,276915,0.0876,3142,138471,0.0000,0,75
2021-05-21,Brazil,203070494,Rondônia,1581196,0.1792,6407,283322,0.0900,3915,142386,0.0000,0,75
2021-05-22,Brazil,203070494,Rondônia,1581196,0.1800,1305,284627,0.0908,1248,143634,0.0000,0,75
2021-05-23,Brazil,203070494,Rondônia,1581196,0.1802,234,284861,0.0909,81,143715,0.0000,0,75
2021-05-24,Brazil,203070494,Rondônia,1581196,0.1817,2400,287261,0.0920,1804,145519,0.0000,0,75
2021-05-25,Brazil,203070494,Rondônia,1581196,0.1836,3093,290354,0.0934,2179,147698,0.0000,0,75
2021-05-26,Brazil,203070494,Rondônia,1581196,0.1865,4465,294819,0.0940,973,148671,0.0000,0,75
2021-05-27,Brazil,203070494,Rondônia,1581196,0.1884,3102,297921,0.0949,1333,150004,0.0000,0,75
2021-05-28,Brazil,203070494,Rondônia,1581196,0.1919,5482,303403,0.0955,948,150952,0.0000,0,75
2021-05-29,Brazil,203070494,Rondônia,1581196,0.1923,592,303995,0.0957,315,151267,0.0000,0,75
2021-05-30,Brazil,203070494,Rondônia,1581196,0.1923,49,304044,0.0957,36,151303,0.0000,0,75
2021-05-31,Brazil,203070494,Rondônia,1581196,0.1953,4735,308779,0.0959,383,151686,0.0000,0,75
2021-06-01,Brazil,203070494,Rondônia,1581196,0.1994,6525,315304,0.0962,432,152118,0.0000,0,75
2021-06-02,Brazil,203070494,Rondônia,1581196,0.2074,12710,328014,0.0968,954,153072,0.0000,0,75
2021-06-03,Brazil,203070494,Rondônia,1581196,0.2077,337,328351,0.0968,38,153110,0.0000,0,75
2021-06-04,Brazil,203070494,Rondônia,1581196,0.2124,7499,335850,0.0974,953,154063,0.0000,0,75
2021-06-05,Brazil,203070494,Rondônia,1581196,0.2150,4032,339882,0.0976,287,154350,0.0000,0,75
2021-06-06,Brazil,203070494,Rondônia,1581196,0.2154,685,340567,0.0977,63,154413,0.0000,0,75
2021-06-07,Brazil,203070494,Rondônia,1581196,0.2210,8868,349435,0.0979,442,154855,0.0000,0,75
2021-06-08,Brazil,203070494,Rondônia,1581196,0.2273,9926,359361,0.0983,650,155505,0.0000,0,75
2021-06-09,Brazil,203070494,Rondônia,1581196,0.2333,9600,368961,0.0986,431,155936,0.0000,0,75
2021-06-10,Brazil,203070494,Rondônia,1581196,0.2432,15514,384475,0.0990,560,156496,0.0000,0,75
2021-06-11,Brazil,203070494,Rondônia,1581196,0.2522,14285,398760,0.0993,535,157031,0.0000,0,75
2021-06-12,Brazil,203070494,Rondônia,1581196,0.2537,2403,401163,0.0994,86,157117,0.0000,0,75
2021-06-13,Brazil,203070494,Rondônia,1581196,0.2539,313,401476,0.0994,7,157124,0.0000,0,75
2021-06-14,Brazil,203070494,Rondônia,1581196,0.2582,6770,408246,0.0995,238,157362,0.0000,1,76
2021-06-15,Brazil,203070494,Rondônia,1581196,0.2658,12072,420318,0.0997,293,157655,0.0000,0,76
2021-06-16,Brazil,203070494,Rondônia,1581196,0.2729,11170,431488,0.0999,278,157933,0.0000,0,76
2021-06-17,Brazil,203070494,Rondônia,1581196,0.2790,9731,441219,0.1000,240,158173,0.0000,0,76
2021-06-18,Brazil,203070494,Rondônia,1581196,0.2875,13417,454636,0.1002,326,158499,0.0000,0,76
2021-06-19,Brazil,203070494,Rondônia,1581196,0.2927,8165,462801,0.1003,68,158567,0.0000,0,76
2021-06-20,Brazil,203070494,Rondônia,1581196,0.2944,2680,465481,0.1003,81,158648,0.0000,0,76
2021-06-21,Brazil,203070494,Rondônia,1581196,0.2994,7947,473428,0.1005,235,158883,0.0000,0,76
2021-06-22,Brazil,203070494,Rondônia,1581196,0.3062,10784,484212,0.1010,791,159674,0.0000,0,76
2021-06-23,Brazil,203070494,Rondônia,1581196,0.3111,7754,491966,0.1014,583,160257,0.0000,0,76
2021-06-24,Brazil,203070494,Rondônia,1581196,0.3182,11186,503152,0.1018,639,160896,0.0000,0,76
2021-06-25,Brazil,203070494,Rondônia,1581196,0.3240,9134,512286,0.1020,311,161207,0.0000,0,76
2021-06-26,Brazil,203070494,Rondônia,1581196,0.3257,2728,515014,0.1020,49,161256,0.0000,0,76
2021-06-27,Brazil,203070494,Rondônia,1581196,0.3259,271,515285,0.1020,15,161271,0.0000,0,76
2021-06-28,Brazil,203070494,Rondônia,1581196,0.3324,10314,525599,0.1023,561,161832,0.0000,0,76
2021-06-29,Brazil,203070494,Rondônia,1581196,0.3401,12203,537802,0.1034,1610,163442,0.0000,0,76
2021-06-30,Brazil,203070494,Rondônia,1581196,0.3459,9130,546932,0.1042,1349,164791,0.0000,0,76
2021-07-01,Brazil,203070494,Rondônia,1581196,0.3487,4445,551377,0.1048,879,165670,0.0000,0,76
2021-07-02,Brazil,203070494,Rondônia,1581196,0.3530,6812,558189,0.1051,569,166239,0.0000,0,76
2021-07-03,Brazil,203070494,Rondônia,1581196,0.3548,2743,560932,0.1052,138,166377,0.0000,0,76
2021-07-04,Brazil,203070494,Rondônia,1581196,0.3568,3168,564100,0.1052,10,166387,0.0000,0,76
2021-07-05,Brazil,203070494,Rondônia,1581196,0.3626,9280,573380,0.1056,540,166927,0.0000,0,76
2021-07-06,Brazil,203070494,Rondônia,1581196,0.3709,13159,586539,0.1061,793,167720,0.0001,7,83
2021-07-07,Brazil,203070494,Rondônia,1581196,0.3817,16932,603471,0.1066,882,168602,0.0001,1,84
2021-07-08,Brazil,203070494,Rondônia,1581196,0.3923,16843,620314,0.1070,538,169140,0.0001,0,84
2021-07-09,Brazil,203070494,Rondônia,1581196,0.3998,11806,632120,0.1073,589,169729,0.0001,0,84
2021-07-10,Brazil,203070494,Rondônia,1581196,0.4020,3538,635658,0.1074,164,169893,0.0001,0,84
2021-07-11,Brazil,203070494,Rondônia,1581196,0.4023,531,636189,0.1075,23,169916,0.0001,0,84
2021-07-12,Brazil,203070494,Rondônia,1581196,0.4081,9170,645359,0.1080,796,170712,0.0001,0,84
2021-07-13,Brazil,203070494,Rondônia,1581196,0.4138,8932,654291,0.1091,1784,172496,0.0001,0,84
2021-07-14,Brazil,203070494,Rondônia,1581196,0.4172,5358,659649,0.1104,2086,174582,0.0001,0,84
2021-07-15,Brazil,203070494,Rondônia,1581196,0.4212,6404,666053,0.1123,3049,177631,0.0001,0,84
2021-07-16,Brazil,203070494,Rondônia,1581196,0.4256,6979,673032,0.1145,3420,181051,0.0001,1,85
2021-07-17,Brazil,203070494,Rondônia,1581196,0.4278,3395,676427,0.1153,1270,182321,0.0001,0,85
2021-07-18,Brazil,203070494,Rondônia,1581196,0.4287,1461,677888,0.1154,221,182542,0.0001,0,85
2021-07-19,Brazil,203070494,Rondônia,1581196,0.4332,7151,685039,0.1188,5292,187834,0.0001,1,86
2021-07-20,Brazil,203070494,Rondônia,1581196,0.4413,12714,697753,0.1210,3502,191336,0.0001,7,93
2021-07-21,Brazil,203070494,Rondônia,1581196,0.4480,10683,708436,0.1239,4572,195908,0.0001,2,95
2021-07-22,Brazil,203070494,Rondônia,1581196,0.4541,9572,718008,0.1277,6055,201963,0.0001,5,100
2021-07-23,Brazil,203070494,Rondônia,1581196,0.4616,11857,729865,0.1315,6006,207969,0.0001,1,101
2021-07-24,Brazil,203070494,Rondônia,1581196,0.4669,8439,738304,0.1322,1018,208987,0.0001,0,101
2021-07-25,Brazil,203070494,Rondônia,1581196,0.4670,74,738378,0.1322,55,209042,0.0001,0,101
2021-07-26,Brazil,203070494,Rondônia,1581196,0.4747,12234,750612,0.1355,5208,214250,0.0001,0,101
2021-07-27,Brazil,203070494,Rondônia,1581196,0.4797,7896,758508,0.1394,6223,220473,0.0001,0,101
2021-07-28,Brazil,203070494,Rondônia,1581196,0.4873,11949,770457,0.1429,5492,225965,0.0001,0,101
2021-07-29,Brazil,203070494,Rondônia,1581196,0.4912,6169,776626,0.1456,4300,230265,0.0001,0,101
2021-07-30,Brazil,203070494,Rondônia,1581196,0.4966,8663,785289,0.1499,6764,237029,0.0001,0,101
2021-07-31,Brazil,203070494,Rondônia,1581196,0.4986,3086,788375,0.1501,322,237351,0.0001,0,101
2021-08-01,Brazil,203070494,Rondônia,1581196,0.4986,82,788457,0.1502,84,237435,0.0001,0,101
2021-08-02,Brazil,203070494,Rondônia,1581196,0.5028,6605,795062,0.1518,2515,239950,0.0001,0,101
2021-08-03,Brazil,203070494,Rondônia,1581196,0.5104,11982,807044,0.1554,5831,245781,0.0001,0,101
2021-08-04,Brazil,203070494,Rondônia,1581196,0.5182,12282,819326,0.1609,8605,254386,0.0001,1,102
2021-08-05,Brazil,203070494,Rondônia,1581196,0.5268,13698,833024,0.1647,5962,260348,0.0001,0,102
2021-08-06,Brazil,203070494,Rondônia,1581196,0.5341,11432,844456,0.1695,7701,268049,0.0001,0,102
2021-08-07,Brazil,203070494,Rondônia,1581196,0.5376,5534,849990,0.1699,575,268624,0.0001,0,102
2021-08-08,Brazil,203070494,Rondônia,1581196,0.5376,77,850067,0.1699,28,268652,0.0001,0,102
2021-08-09,Brazil,203070494,Rondônia,1581196,0.5445,10836,860903,0.1729,4756,273408,0.0001,2,104
2021-08-10,Brazil,203070494,Rondônia,1581196,0.5554,17369,878272,0.1759,4710,278118,0.0001,0,104
2021-08-11,Brazil,203070494,Rondônia,1581196,0.5647,14635,892907,0.1811,8254,286372,0.0001,0,104
2021-08-12,Brazil,203070494,Rondônia,1581196,0.5779,20907,913814,0.1845,5352,291724,0.0001,0,104
2021-08-13,Brazil,203070494,Rondônia,1581196,0.5873,14796,928610,0.1888,6757,298481,0.0001,0,104
2021-08-14,Brazil,203070494,Rondônia,1581196,0.5904,4901,933511,0.1895,1224,299705,0.0001,0,104
2021-08-15,Brazil,203070494,Rondônia,1581196,0.5904,43,933554,0.1896,144,299849,0.0001,0,104
2021-08-16,Brazil,203070494,Rondônia,1581196,0.5951,7445,940999,0.1927,4833,304682,0.0001,0,104
2021-08-17,Brazil,203070494,Rondônia,1581196,0.6020,10872,951871,0.1952,3910,308592,0.0001,0,104
2021-08-18,Brazil,203070494,Rondônia,1581196,0.6092,11316,963187,0.1994,6693,315285,0.0001,0,104
2021-08-19,Brazil,203070494,Rondônia,1581196,0.6186,14953,978140,0.2034,6388,321673,0.0001,0,104
2021-08-20,Brazil,203070494,Rondônia,1581196,0.6254,10807,988947,0.2103,10885,332558,0.0001,0,104
2021-08-21,Brazil,203070494,Rondônia,1581196,0.6271,2658,991605,0.2121,2824,335382,0.0001,1,105
2021-08-22,Brazil,203070494,Rondônia,1581196,0.6271,39,991644,0.2121,45,335427,0.0001,0,105
2021-08-23,Brazil,203070494,Rondônia,1581196,0.6338,10465,1002109,0.2161,6320,341747,0.0001,0,105
2021-08-24,Brazil,203070494,Rondônia,1581196,0.6445,16997,1019106,0.2207,7262,349009,0.0001,0,105
2021-08-25,Brazil,203070494,Rondônia,1581196,0.6532,13675,1032781,0.2275,10720,359729,0.0001,0,105
2021-08-26,Brazil,203070494,Rondônia,1581196,0.6669,21795,1054576,0.2324,7707,367436,0.0001,0,105
2021-08-27,Brazil,203070494,Rondônia,1581196,0.6763,14774,1069350,0.2371,7420,374856,0.0001,0,105
2021-08-28,Brazil,203070494,Rondônia,1581196,0.6789,4132,1073482,0.2380,1514,376370,0.0001,0,105
2021-08-29,Brazil,203070494,Rondônia,1581196,0.6794,806,1074288,0.2381,109,376479,0.0001,0,105
2021-08-30,Brazil,203070494,Rondônia,1581196,0.6838,6894,1081182,0.2424,6785,383264,0.0001,0,105
2021-08-31,Brazil,203070494,Rondônia,1581196,0.6882,6994,1088176,0.2495,11285,394549,0.0001,1,106
2021-09-01,Brazil,203070494,Rondônia,1581196,0.6938,8787,1096963,0.2560,10263,404812,0.0001,0,106
2021-09-02,Brazil,203070494,Rondônia,1581196,0.6997,9390,1106353,0.2614,8530,413342,0.0001,0,106
2021-09-03,Brazil,203070494,Rondônia,1581196,0.7059,9774,1116127,0.2701,13698,427040,0.0001,0,106
2021-09-04,Brazil,203070494,Rondônia,1581196,0.7071,1998,1118125,0.2710,1476,428516,0.0001,0,106
2021-09-05,Brazil,203070494,Rondônia,1581196,0.7089,2803,1120928,0.2719,1394,429910,0.0001,0,106
2021-09-06,Brazil,203070494,Rondônia,1581196,0.7116,4274,1125202,0.2765,7298,437208,0.0001,0,106
2021-09-07,Brazil,203070494,Rondônia,1581196,0.7117,198,1125400,0.2765,30,437238,0.0001,0,106
2021-09-08,Brazil,203070494,Rondônia,1581196,0.7150,5146,1130546,0.2852,13764,451002,0.0001,0,106
2021-09-09,Brazil,203070494,Rondônia,1581196,0.7187,5827,1136373,0.2931,12381,463383,0.0001,0,106
2021-09-10,Brazil,203070494,Rondônia,1581196,0.7213,4147,1140520,0.2997,10536,473919,0.0001,2,108
2021-09-11,Brazil,203070494,Rondônia,1581196,0.7235,3476,1143996,0.3016,2957,476876,0.0001,0,108
2021-09-12,Brazil,203070494,Rondônia,1581196,0.7236,130,1144126,0.3016,49,476925,0.0001,0,108
2021-09-13,Brazil,203070494,Rondônia,1581196,0.7254,2938,1147064,0.3059,6744,483669,0.0001,0,108
2021-09-14,Brazil,203070494,Rondônia,1581196,0.7275,3216,1150280,0.3095,5788,489457,0.0001,0,108
2021-09-15,Brazil,203070494,Rondônia,1581196,0.7293,2857,1153137,0.3130,5470,494927,0.0001,2,110
2021-09-16,Brazil,203070494,Rondônia,1581196,0.7312,3073,1156210,0.3170,6236,501163,0.0001,0,110
2021-09-17,Brazil,203070494,Rondônia,1581196,0.7325,2020,1158230,0.3227,9060,510223,0.0001,1,111
2021-09-18,Brazil,203070494,Rondônia,1581196,0.7329,561,1158791,0.3239,1866,512089,0.0001,0,111
2021-09-19,Brazil,203070494,Rondônia,1581196,0.7329,60,1158851,0.3239,90,512179,0.0001,0,111
2021-09-20,Brazil,203070494,Rondônia,1581196,0.7340,1680,1160531,0.3274,5474,517653,0.0001,0,111
2021-09-21,Brazil,203070494,Rondônia,1581196,0.7352,1930,1162461,0.3312,6035,523688,0.0001,2,113
2021-09-22,Brazil,203070494,Rondônia,1581196,0.7370,2845,1165306,0.3360,7576,531264,0.0001,84,197
2021-09-23,Brazil,203070494,Rondônia,1581196,0.7381,1768,1167074,0.3422,9781,541045,0.0002,61,258
2021-09-24,Brazil,203070494,Rondônia,1581196,0.7396,2418,1169492,0.3460,6083,547128,0.0002,20,278
2021-09-25,Brazil,203070494,Rondônia,1581196,0.7399,488,1169980,0.3469,1444,548572,0.0002,8,286
2021-09-26,Brazil,203070494,Rondônia,1581196,0.7399,16,1169996,0.3469,22,548594,0.0002,0,286
2021-09-27,Brazil,203070494,Rondônia,1581196,0.7409,1591,1171587,0.3501,4924,553518,0.0003,112,398
2021-09-28,Brazil,203070494,Rondônia,1581196,0.7423,2144,1173731,0.3539,6100,559618,0.0003,106,504
2021-09-29,Brazil,203070494,Rondônia,1581196,0.7440,2611,1176342,0.3574,5556,565174,0.0004,75,579
2021-09-30,Brazil,203070494,Rondônia,1581196,0.7448,1321,1177663,0.3620,7171,572345,0.0004,42,621
2021-10-01,Brazil,203070494,Rondônia,1581196,0.7458,1635,1179298,0.3650,4783,577128,0.0004,83,704
2021-10-02,Brazil,203070494,Rondônia,1581196,0.7461,504,1179802,0.3664,2209,579337,0.0005,8,712
2021-10-03,Brazil,203070494,Rondônia,1581196,0.7461,7,1179809,0.3664,24,579361,0.0005,0,712
2021-10-04,Brazil,203070494,Rondônia,1581196,0.7470,1409,1181218,0.3686,3544,582905,0.0005,13,725
2021-10-05,Brazil,203070494,Rondônia,1581196,0.7480,1595,1182813,0.3721,5523,588428,0.0005,52,777
2021-10-06,Brazil,203070494,Rondônia,1581196,0.7491,1688,1184501,0.3760,6137,594565,0.0005,60,837
2021-10-07,Brazil,203070494,Rondônia,1581196,0.7500,1465,1185966,0.3816,8827,603392,0.0006,60,897
2021-10-08,Brazil,203070494,Rondônia,1581196,0.7511,1651,1187617,0.3859,6760,610152,0.0006,64,961
2021-10-09,Brazil,203070494,Rondônia,1581196,0.7514,542,1188159,0.3875,2521,612673,0.0006,29,990
2021-10-10,Brazil,203070494,Rondônia,1581196,0.7515,111,1188270,0.3879,615,613288,0.0006,3,993
2021-10-11,Brazil,203070494,Rondônia,1581196,0.7520,820,1189090,0.3922,6935,620223,0.0007,77,1070
2021-10-12,Brazil,203070494,Rondônia,1581196,0.7521,60,1189150,0.3928,858,621081,0.0007,23,1093
2021-10-13,Brazil,203070494,Rondônia,1581196,0.7528,1211,1190361,0.4024,15257,636338,0.0007,84,1177
2021-10-14,Brazil,203070494,Rondônia,1581196,0.7537,1403,1191764,0.4101,12120,648458,0.0008,84,1261
2021-10-15,Brazil,203070494,Rondônia,1581196,0.7544,1102,1192866,0.4179,12273,660731,0.0008,77,1338
2021-10-16,Brazil,203070494,Rondônia,1581196,0.7562,2863,1195729,0.4243,10107,670838,0.0009,72,1410
2021-10-17,Brazil,203070494,Rondônia,1581196,0.7562,23,1195752,0.4244,235,671073,0.0009,0,1410
2021-10-18,Brazil,203070494,Rondônia,1581196,0.7569,1129,1196881,0.4306,9855,680928,0.0010,122,1532
2021-10-19,Brazil,203070494,Rondônia,1581196,0.7578,1414,1198295,0.4387,12789,693717,0.0010,79,1611
2021-10-20,Brazil,203070494,Rondônia,1581196,0.7589,1602,1199897,0.4466,12468,706185,0.0011,107,1718
2021-10-21,Brazil,203070494,Rondônia,1581196,0.7599,1585,1201482,0.4551,13454,719639,0.0012,113,1831
2021-10-22,Brazil,203070494,Rondônia,1581196,0.7616,2680,1204162,0.4637,13520,733159,0.0012,62,1893
2021-10-23,Brazil,203070494,Rondônia,1581196,0.7621,853,1205015,0.4689,8197,741356,0.0012,77,1970
2021-10-24,Brazil,203070494,Rondônia,1581196,0.7621,59,1205074,0.4689,115,741471,0.0012,2,1972
2021-10-25,Brazil,203070494,Rondônia,1581196,0.7628,1039,1206113,0.4737,7605,749076,0.0013,102,2074
2021-10-26,Brazil,203070494,Rondônia,1581196,0.7637,1410,1207523,0.4823,13461,762537,0.0014,214,2288
2021-10-27,Brazil,203070494,Rondônia,1581196,0.7648,1727,1209250,0.4891,10807,773344,0.0016,214,2502
2021-10-28,Brazil,203070494,Rondônia,1581196,0.7655,1183,1210433,0.4951,9483,782827,0.0017,246,2748
2021-10-29,Brazil,203070494,Rondônia,1581196,0.7666,1674,1212107,0.5012,9591,792418,0.0018,41,2789
2021-10-30,Brazil,203070494,Rondônia,1581196,0.7668,359,1212466,0.5025,2137,794555,0.0019,160,2949
2021-10-31,Brazil,203070494,Rondônia,1581196,0.7668,2,1212468,0.5025,3,794558,0.0019,0,2949
2021-11-01,Brazil,203070494,Rondônia,1581196,0.7670,263,1212731,0.5039,2241,796799,0.0019,108,3057
2021-11-02,Brazil,203070494,Rondônia,1581196,0.7670,2,1212733,0.5039,11,796810,0.0019,0,3057
2021-11-03,Brazil,203070494,Rondônia,1581196,0.7677,1157,1213890,0.5103,10074,806884,0.0021,211,3268
2021-11-04,Brazil,203070494,Rondônia,1581196,0.7684,1144,1215034,0.5170,10606,817490,0.0022,194,3462
2021-11-05,Brazil,203070494,Rondônia,1581196,0.7698,2132,1217166,0.5238,10697,828187,0.0023,190,3652
2021-11-06,Brazil,203070494,Rondônia,1581196,0.7699,231,1217397,0.5257,3031,831218,0.0023,50,3702
2021-11-07,Brazil,203070494,Rondônia,1581196,0.7699,3,1217400,0.5257,9,831227,0.0023,0,3702
2021-11-08,Brazil,203070494,Rondônia,1581196,0.7705,978,1218378,0.5298,6546,837773,0.0025,184,3886
2021-11-09,Brazil,203070494,Rondônia,1581196,0.7713,1121,1219499,0.5340,6654,844427,0.0026,178,4064
2021-11-10,Brazil,203070494,Rondônia,1581196,0.7719,1081,1220580,0.5395,8658,853085,0.0027,195,4259
2021-11-11,Brazil,203070494,Rondônia,1581196,0.7725,843,1221423,0.5445,7827,860912,0.0028,158,4417
2021-11-12,Brazil,203070494,Rondônia,1581196,0.7732,1112,1222535,0.5489,6943,867855,0.0029,182,4599
2021-11-13,Brazil,203070494,Rondônia,1581196,0.7734,296,1222831,0.5499,1662,869517,0.0030,117,4716
2021-11-14,Brazil,203070494,Rondônia,1581196,0.7735,160,1222991,0.5500,164,869681,0.0030,0,4716
2021-11-15,Brazil,203070494,Rondônia,1581196,0.7736,290,1223281,0.5500,36,869717,0.0030,0,4716
2021-11-16,Brazil,203070494,Rondônia,1581196,0.7744,1253,1224534,0.5535,5493,875210,0.0031,185,4901
2021-11-17,Brazil,203070494,Rondônia,1581196,0.7751,1006,1225540,0.5580,7035,882245,0.0032,151,5052
2021-11-18,Brazil,203070494,Rondônia,1581196,0.7758,1118,1226658,0.5635,8708,890953,0.0033,156,5208
2021-11-19,Brazil,203070494,Rondônia,1581196,0.7767,1406,1228064,0.5678,6794,897747,0.0036,491,5699
2021-11-20,Brazil,203070494,Rondônia,1581196,0.7770,475,1228539,0.5690,1939,899686,0.0038,280,5979
2021-11-21,Brazil,203070494,Rondônia,1581196,0.7770,126,1228665,0.5694,598,900284,0.0038,1,5980
2021-11-22,Brazil,203070494,Rondônia,1581196,0.7778,1127,1229792,0.5737,6869,907153,0.0038,77,6057
2021-11-23,Brazil,203070494,Rondônia,1581196,0.7784,1070,1230862,0.5773,5711,912864,0.0039,66,6123
2021-11-24,Brazil,203070494,Rondônia,1581196,0.7791,1100,1231962,0.5818,7120,919984,0.0040,191,6314
2021-11-25,Brazil,203070494,Rondônia,1581196,0.7798,1056,1233018,0.5860,6545,926529,0.0041,182,6496
2021-11-26,Brazil,203070494,Rondônia,1581196,0.7807,1473,1234491,0.5905,7237,933766,0.0042,129,6625
2021-11-27,Brazil,203070494,Rondônia,1581196,0.7809,301,1234792,0.5914,1404,935170,0.0043,122,6747
2021-11-28,Brazil,203070494,Rondônia,1581196,0.7809,25,1234817,0.5914,8,935178,0.0043,0,6747
2021-11-29,Brazil,203070494,Rondônia,1581196,0.7818,1381,1236198,0.5949,5511,940689,0.0043,3,6750
2021-11-30,Brazil,203070494,Rondônia,1581196,0.7825,1027,1237225,0.5985,5591,946280,0.0043,2,6752
2021-12-01,Brazil,203070494,Rondônia,1581196,0.7834,1511,1238736,0.6021,5815,952095,0.0043,0,6752
2021-12-02,Brazil,203070494,Rondônia,1581196,0.7842,1294,1240030,0.6064,6720,958815,0.0043,0,6752
2021-12-03,Brazil,203070494,Rondônia,1581196,0.7851,1445,1241475,0.6103,6117,964932,0.0044,168,6920
2021-12-04,Brazil,203070494,Rondônia,1581196,0.7862,1719,1243194,0.6151,7630,972562,0.0046,428,7348
2021-12-05,Brazil,203070494,Rondônia,1581196,0.7862,10,1243204,0.6151,37,972599,0.0046,0,7348
2021-12-06,Brazil,203070494,Rondônia,1581196,0.7870,1137,1244341,0.6174,3708,976307,0.0047,151,7499
2021-12-07,Brazil,203070494,Rondônia,1581196,0.7876,1088,1245429,0.6200,4022,980329,0.0048,142,7641
2021-12-08,Brazil,203070494,Rondônia,1581196,0.7883,997,1246426,0.6224,3758,984087,0.0049,79,7720
2021-12-09,Brazil,203070494,Rondônia,1581196,0.7889,1022,1247448,0.6246,3572,987659,0.0049,80,7800
2021-12-10,Brazil,203070494,Rondônia,1581196,0.7895,880,1248328,0.6266,3076,990735,0.0050,82,7882
2021-12-11,Brazil,203070494,Rondônia,1581196,0.7896,165,1248493,0.6270,739,991474,0.0050,0,7882
2021-12-12,Brazil,203070494,Rondônia,1581196,0.7897,105,1248598,0.6272,323,991797,0.0050,0,7882
2021-12-13,Brazil,203070494,Rondônia,1581196,0.7902,897,1249495,0.6289,2658,994455,0.0051,148,8030
2021-12-14,Brazil,203070494,Rondônia,1581196,0.7908,908,1250403,0.6309,3169,997624,0.0052,153,8183
2021-12-15,Brazil,203070494,Rondônia,1581196,0.7912,717,1251120,0.6326,2576,1000200,0.0053,172,8355
2021-12-16,Brazil,203070494,Rondônia,1581196,0.7917,789,1251909,0.6344,2974,1003174,0.0054,110,8465
2021-12-17,Brazil,203070494,Rondônia,1581196,0.7921,602,1252511,0.6357,1996,1005170,0.0054,138,8603
2021-12-18,Brazil,203070494,Rondônia,1581196,0.7922,140,1252651,0.6359,360,1005530,0.0055,75,8678
2021-12-19,Brazil,203070494,Rondônia,1581196,0.7923,70,1252721,0.6361,240,1005770,0.0055,97,8775
2021-12-20,Brazil,203070494,Rondônia,1581196,0.7927,649,1253370,0.6374,2041,1007811,0.0057,185,8960
2021-12-21,Brazil,203070494,Rondônia,1581196,0.7930,561,1253931,0.6385,1835,1009646,0.0057,128,9088
2021-12-22,Brazil,203070494,Rondônia,1581196,0.7933,399,1254330,0.6395,1451,1011097,0.0058,94,9182
2021-12-23,Brazil,203070494,Rondônia,1581196,0.7935,292,1254622,0.6402,1133,1012230,0.0058,57,9239
2021-12-24,Brazil,203070494,Rondônia,1581196,0.7935,23,1254645,0.6402,96,1012326,0.0058,0,9239
2021-12-25,Brazil,203070494,Rondônia,1581196,0.7935,1,1254646,0.6402,3,1012329,0.0058,0,9239
2021-12-26,Brazil,203070494,Rondônia,1581196,0.7935,9,1254655,0.6402,19,1012348,0.0058,0,9239
2021-12-27,Brazil,203070494,Rondônia,1581196,0.7937,380,1255035,0.6411,1327,1013675,0.0059,147,9386
2021-12-28,Brazil,203070494,Rondônia,1581196,0.7940,448,1255483,0.6421,1641,1015316,0.0060,136,9522
2021-12-29,Brazil,203070494,Rondônia,1581196,0.7942,363,1255846,0.6430,1421,1016737,0.0061,163,9685
2021-12-30,Brazil,203070494,Rondônia,1581196,0.7944,306,1256152,0.6437,1136,1017873,0.0062,103,9788
2021-12-31,Brazil,203070494,Rondônia,1581196,0.7944,11,1256163,0.6438,42,1017915,0.0062,19,9807
2021-01-17,Brazil,203070494,Roraima,636707,0.0000,7,7,0.0000,2,2,0.0000,0,0
2021-01-18,Brazil,203070494,Roraima,636707,0.0000,15,22,0.0000,0,2,0.0000,0,0
2021-01-19,Brazil,203070494,Roraima,636707,0.0001,11,33,0.0000,0,2,0.0000,0,0
2021-01-20,Brazil,203070494,Roraima,636707,0.0006,373,406,0.0000,1,3,0.0000,0,0
2021-01-21,Brazil,203070494,Roraima,636707,0.0030,1473,1879,0.0000,4,7,0.0000,0,0
2021-01-22,Brazil,203070494,Roraima,636707,0.0057,1768,3647,0.0000,4,11,0.0000,0,0
2021-01-23,Brazil,203070494,Roraima,636707,0.0076,1207,4854,0.0000,4,15,0.0000,0,0
2021-01-24,Brazil,203070494,Roraima,636707,0.0081,335,5189,0.0000,6,21,0.0000,0,0
2021-01-25,Brazil,203070494,Roraima,636707,0.0107,1643,6832,0.0000,4,25,0.0000,0,0
2021-01-26,Brazil,203070494,Roraima,636707,0.0133,1644,8476,0.0000,3,28,0.0000,0,0
2021-01-27,Brazil,203070494,Roraima,636707,0.0153,1285,9761,0.0001,5,33,0.0000,0,0
2021-01-28,Brazil,203070494,Roraima,636707,0.0173,1242,11003,0.0001,4,37,0.0000,0,0
2021-01-29,Brazil,203070494,Roraima,636707,0.0193,1262,12265,0.0001,3,40,0.0000,0,0
2021-01-30,Brazil,203070494,Roraima,636707,0.0200,465,12730,0.0001,0,40,0.0000,0,0
2021-01-31,Brazil,203070494,Roraima,636707,0.0204,242,12972,0.0001,0,40,0.0000,0,0
2021-02-01,Brazil,203070494,Roraima,636707,0.0218,907,13879,0.0001,8,48,0.0000,0,0
2021-02-02,Brazil,203070494,Roraima,636707,0.0232,894,14773,0.0001,17,65,0.0000,0,0
2021-02-03,Brazil,203070494,Roraima,636707,0.0253,1318,16091,0.0001,11,76,0.0000,0,0
2021-02-04,Brazil,203070494,Roraima,636707,0.0272,1229,17320,0.0004,162,238,0.0000,0,0
2021-02-05,Brazil,203070494,Roraima,636707,0.0289,1060,18380,0.0005,75,313,0.0000,0,0
2021-02-06,Brazil,203070494,Roraima,636707,0.0303,897,19277,0.0006,47,360,0.0000,0,0
2021-02-07,Brazil,203070494,Roraima,636707,0.0309,366,19643,0.0007,56,416,0.0000,0,0
2021-02-08,Brazil,203070494,Roraima,636707,0.0335,1658,21301,0.0013,392,808,0.0000,0,0
2021-02-09,Brazil,203070494,Roraima,636707,0.0362,1729,23030,0.0020,468,1276,0.0000,0,0
2021-02-10,Brazil,203070494,Roraima,636707,0.0383,1330,24360,0.0033,846,2122,0.0000,0,0
2021-02-11,Brazil,203070494,Roraima,636707,0.0398,979,25339,0.0054,1329,3451,0.0000,0,0
2021-02-12,Brazil,203070494,Roraima,636707,0.0413,975,26314,0.0075,1324,4775,0.0000,0,0
2021-02-13,Brazil,203070494,Roraima,636707,0.0419,344,26658,0.0082,418,5193,0.0000,0,0
2021-02-14,Brazil,203070494,Roraima,636707,0.0423,303,26961,0.0084,178,5371,0.0000,0,0
2021-02-15,Brazil,203070494,Roraima,636707,0.0436,805,27766,0.0100,1017,6388,0.0000,0,0
2021-02-16,Brazil,203070494,Roraima,636707,0.0447,674,28440,0.0111,696,7084,0.0000,0,0
2021-02-17,Brazil,203070494,Roraima,636707,0.0459,763,29203,0.0129,1099,8183,0.0000,0,0
2021-02-18,Brazil,203070494,Roraima,636707,0.0468,607,29810,0.0151,1452,9635,0.0000,0,0
2021-02-19,Brazil,203070494,Roraima,636707,0.0480,741,30551,0.0167,1003,10638,0.0000,0,0
2021-02-20,Brazil,203070494,Roraima,636707,0.0484,296,30847,0.0172,319,10957,0.0000,0,0
2021-02-21,Brazil,203070494,Roraima,636707,0.0487,148,30995,0.0174,135,11092,0.0000,0,0
2021-02-22,Brazil,203070494,Roraima,636707,0.0495,540,31535,0.0188,862,11954,0.0000,0,0
2021-02-23,Brazil,203070494,Roraima,636707,0.0502,430,31965,0.0199,712,12666,0.0000,0,0
2021-02-24,Brazil,203070494,Roraima,636707,0.0508,350,32315,0.0213,874,13540,0.0000,0,0
2021-02-25,Brazil,203070494,Roraima,636707,0.0514,443,32758,0.0227,896,14436,0.0000,0,0
2021-02-26,Brazil,203070494,Roraima,636707,0.0520,365,33123,0.0240,825,15261,0.0000,0,0
2021-02-27,Brazil,203070494,Roraima,636707,0.0524,260,33383,0.0248,556,15817,0.0000,0,0
2021-02-28,Brazil,203070494,Roraima,636707,0.0525,67,33450,0.0251,138,15955,0.0000,0,0
2021-03-01,Brazil,203070494,Roraima,636707,0.0541,999,34449,0.0265,921,16876,0.0000,0,0
2021-03-02,Brazil,203070494,Roraima,636707,0.0559,1168,35617,0.0286,1349,18225,0.0000,0,0
2021-03-03,Brazil,203070494,Roraima,636707,0.0571,731,36348,0.0300,849,19074,0.0000,0,0
2021-03-04,Brazil,203070494,Roraima,636707,0.0580,582,36930,0.0309,609,19683,0.0000,0,0
2021-03-05,Brazil,203070494,Roraima,636707,0.0591,672,37602,0.0324,938,20621,0.0000,0,0
2021-03-06,Brazil,203070494,Roraima,636707,0.0593,156,37758,0.0329,351,20972,0.0000,0,0
2021-03-07,Brazil,203070494,Roraima,636707,0.0595,106,37864,0.0332,151,21123,0.0000,0,0
2021-03-08,Brazil,203070494,Roraima,636707,0.0603,507,38371,0.0343,733,21856,0.0000,0,0
2021-03-09,Brazil,203070494,Roraima,636707,0.0610,447,38818,0.0354,664,22520,0.0000,0,0
2021-03-10,Brazil,203070494,Roraima,636707,0.0616,421,39239,0.0364,638,23158,0.0000,0,0
2021-03-11,Brazil,203070494,Roraima,636707,0.0622,373,39612,0.0372,508,23666,0.0000,0,0
2021-03-12,Brazil,203070494,Roraima,636707,0.0628,358,39970,0.0381,561,24227,0.0000,0,0
2021-03-13,Brazil,203070494,Roraima,636707,0.0630,121,40091,0.0384,246,24473,0.0000,0,0
2021-03-14,Brazil,203070494,Roraima,636707,0.0631,64,40155,0.0387,179,24652,0.0000,0,0
2021-03-15,Brazil,203070494,Roraima,636707,0.0634,235,40390,0.0397,597,25249,0.0000,0,0
2021-03-16,Brazil,203070494,Roraima,636707,0.0638,241,40631,0.0403,416,25665,0.0000,0,0
2021-03-17,Brazil,203070494,Roraima,636707,0.0642,218,40849,0.0410,416,26081,0.0000,0,0
2021-03-18,Brazil,203070494,Roraima,636707,0.0647,336,41185,0.0416,421,26502,0.0000,0,0
2021-03-19,Brazil,203070494,Roraima,636707,0.0682,2238,43423,0.0421,311,26813,0.0000,0,0
2021-03-20,Brazil,203070494,Roraima,636707,0.0698,993,44416,0.0425,242,27055,0.0000,0,0
2021-03-21,Brazil,203070494,Roraima,636707,0.0705,450,44866,0.0426,97,27152,0.0000,0,0
2021-03-22,Brazil,203070494,Roraima,636707,0.0722,1074,45940,0.0433,406,27558,0.0000,0,0
2021-03-23,Brazil,203070494,Roraima,636707,0.0751,1852,47792,0.0436,226,27784,0.0000,0,0
2021-03-24,Brazil,203070494,Roraima,636707,0.0767,1016,48808,0.0439,197,27981,0.0000,0,0
2021-03-25,Brazil,203070494,Roraima,636707,0.0778,739,49547,0.0443,231,28212,0.0000,0,0
2021-03-26,Brazil,203070494,Roraima,636707,0.0788,598,50145,0.0447,263,28475,0.0000,0,0
2021-03-27,Brazil,203070494,Roraima,636707,0.0817,1881,52026,0.0449,111,28586,0.0000,0,0
2021-03-28,Brazil,203070494,Roraima,636707,0.0817,22,52048,0.0450,53,28639,0.0000,0,0
2021-03-29,Brazil,203070494,Roraima,636707,0.0844,1668,53716,0.0455,318,28957,0.0000,0,0
2021-03-30,Brazil,203070494,Roraima,636707,0.0861,1075,54791,0.0459,281,29238,0.0000,0,0
2021-03-31,Brazil,203070494,Roraima,636707,0.0902,2656,57447,0.0462,198,29436,0.0000,0,0
2021-04-01,Brazil,203070494,Roraima,636707,0.0919,1097,58544,0.0465,165,29601,0.0000,0,0
2021-04-02,Brazil,203070494,Roraima,636707,0.0924,283,58827,0.0466,59,29660,0.0000,0,0
2021-04-03,Brazil,203070494,Roraima,636707,0.0928,256,59083,0.0467,56,29716,0.0000,0,0
2021-04-04,Brazil,203070494,Roraima,636707,0.0928,5,59088,0.0467,9,29725,0.0000,0,0
2021-04-05,Brazil,203070494,Roraima,636707,0.0943,925,60013,0.0475,527,30252,0.0000,0,0
2021-04-06,Brazil,203070494,Roraima,636707,0.0989,2926,62939,0.0481,388,30640,0.0000,0,0
2021-04-07,Brazil,203070494,Roraima,636707,0.1029,2592,65531,0.0487,352,30992,0.0000,0,0
2021-04-08,Brazil,203070494,Roraima,636707,0.1051,1400,66931,0.0496,589,31581,0.0000,0,0
2021-04-09,Brazil,203070494,Roraima,636707,0.1068,1061,67992,0.0523,1721,33302,0.0000,0,0
2021-04-10,Brazil,203070494,Roraima,636707,0.1079,721,68713,0.0537,920,34222,0.0000,0,0
2021-04-11,Brazil,203070494,Roraima,636707,0.1080,20,68733,0.0538,48,34270,0.0000,0,0
2021-04-12,Brazil,203070494,Roraima,636707,0.1097,1122,69855,0.0554,1007,35277,0.0000,0,0
2021-04-13,Brazil,203070494,Roraima,636707,0.1107,657,70512,0.0573,1228,36505,0.0000,0,0
2021-04-14,Brazil,203070494,Roraima,636707,0.1119,737,71249,0.0590,1061,37566,0.0000,0,0
2021-04-15,Brazil,203070494,Roraima,636707,0.1128,561,71810,0.0601,713,38279,0.0000,0,0
2021-04-16,Brazil,203070494,Roraima,636707,0.1134,409,72219,0.0612,669,38948,0.0000,0,0
2021-04-17,Brazil,203070494,Roraima,636707,0.1136,101,72320,0.0630,1190,40138,0.0000,0,0
2021-04-18,Brazil,203070494,Roraima,636707,0.1136,16,72336,0.0631,41,40179,0.0000,0,0
2021-04-19,Brazil,203070494,Roraima,636707,0.1142,390,72726,0.0658,1725,41904,0.0000,0,0
2021-04-20,Brazil,203070494,Roraima,636707,0.1148,352,73078,0.0675,1105,43009,0.0000,0,0
2021-04-21,Brazil,203070494,Roraima,636707,0.1151,192,73270,0.0699,1516,44525,0.0000,0,0
2021-04-22,Brazil,203070494,Roraima,636707,0.1156,335,73605,0.0707,486,45011,0.0000,0,0
2021-04-23,Brazil,203070494,Roraima,636707,0.1160,253,73858,0.0710,173,45184,0.0000,0,0
2021-04-24,Brazil,203070494,Roraima,636707,0.1162,152,74010,0.0724,899,46083,0.0000,0,0
2021-04-25,Brazil,203070494,Roraima,636707,0.1163,59,74069,0.0724,14,46097,0.0000,0,0
2021-04-26,Brazil,203070494,Roraima,636707,0.1169,337,74406,0.0746,1373,47470,0.0000,0,0
2021-04-27,Brazil,203070494,Roraima,636707,0.1174,328,74734,0.0781,2245,49715,0.0000,0,0
2021-04-28,Brazil,203070494,Roraima,636707,0.1178,248,74982,0.0820,2496,52211,0.0000,0,0
2021-04-29,Brazil,203070494,Roraima,636707,0.1180,169,75151,0.0839,1205,53416,0.0000,0,0
2021-04-30,Brazil,203070494,Roraima,636707,0.1183,183,75334,0.0853,865,54281,0.0000,0,0
2021-05-01,Brazil,203070494,Roraima,636707,0.1184,72,75406,0.0857,292,54573,0.0000,0,0
2021-05-02,Brazil,203070494,Roraima,636707,0.1186,104,75510,0.0858,55,54628,0.0000,0,0
2021-05-03,Brazil,203070494,Roraima,636707,0.1191,335,75845,0.0875,1074,55702,0.0000,0,0
2021-05-04,Brazil,203070494,Roraima,636707,0.1195,231,76076,0.0886,724,56426,0.0000,0,0
2021-05-05,Brazil,203070494,Roraima,636707,0.1201,393,76469,0.0895,581,57007,0.0000,0,0
2021-05-06,Brazil,203070494,Roraima,636707,0.1211,664,77133,0.0903,511,57518,0.0000,0,0
2021-05-07,Brazil,203070494,Roraima,636707,0.1227,1007,78140,0.0910,427,57945,0.0000,0,0
2021-05-08,Brazil,203070494,Roraima,636707,0.1238,691,78831,0.0912,109,58054,0.0000,0,0
2021-05-09,Brazil,203070494,Roraima,636707,0.1238,7,78838,0.0912,15,58069,0.0000,0,0
2021-05-10,Brazil,203070494,Roraima,636707,0.1256,1103,79941,0.0919,472,58541,0.0000,0,0
2021-05-11,Brazil,203070494,Roraima,636707,0.1266,683,80624,0.0924,313,58854,0.0000,0,0
2021-05-12,Brazil,203070494,Roraima,636707,0.1275,545,81169,0.0928,248,59102,0.0000,0,0
2021-05-13,Brazil,203070494,Roraima,636707,0.1295,1258,82427,0.0932,215,59317,0.0000,0,0
2021-05-14,Brazil,203070494,Roraima,636707,0.1308,885,83312,0.0935,189,59506,0.0000,0,0
2021-05-15,Brazil,203070494,Roraima,636707,0.1314,335,83647,0.0936,95,59601,0.0000,0,0
2021-05-16,Brazil,203070494,Roraima,636707,0.1314,41,83688,0.0937,43,59644,0.0000,0,0
2021-05-17,Brazil,203070494,Roraima,636707,0.1327,787,84475,0.0940,197,59841,0.0000,0,0
2021-05-18,Brazil,203070494,Roraima,636707,0.1351,1550,86025,0.0942,127,59968,0.0000,0,0
2021-05-19,Brazil,203070494,Roraima,636707,0.1368,1093,87118,0.0945,204,60172,0.0000,0,0
2021-05-20,Brazil,203070494,Roraima,636707,0.1381,817,87935,0.0948,159,60331,0.0000,0,0
2021-05-21,Brazil,203070494,Roraima,636707,0.1393,769,88704,0.0949,103,60434,0.0000,0,0
2021-05-22,Brazil,203070494,Roraima,636707,0.1398,337,89041,0.0950,30,60464,0.0000,0,0
2021-05-23,Brazil,203070494,Roraima,636707,0.1399,9,89050,0.0950,4,60468,0.0000,0,0
2021-05-24,Brazil,203070494,Roraima,636707,0.1419,1322,90372,0.0953,190,60658,0.0000,0,0
2021-05-25,Brazil,203070494,Roraima,636707,0.1437,1099,91471,0.0955,154,60812,0.0000,0,0
2021-05-26,Brazil,203070494,Roraima,636707,0.1454,1075,92546,0.0957,100,60912,0.0000,0,0
2021-05-27,Brazil,203070494,Roraima,636707,0.1478,1565,94111,0.0959,136,61048,0.0000,0,0
2021-05-28,Brazil,203070494,Roraima,636707,0.1495,1066,95177,0.0961,115,61163,0.0000,0,0
2021-05-29,Brazil,203070494,Roraima,636707,0.1501,399,95576,0.0961,37,61200,0.0000,0,0
2021-05-30,Brazil,203070494,Roraima,636707,0.1501,6,95582,0.0961,5,61205,0.0000,0,0
2021-05-31,Brazil,203070494,Roraima,636707,0.1523,1398,96980,0.0963,121,61326,0.0000,0,0
2021-06-01,Brazil,203070494,Roraima,636707,0.1542,1181,98161,0.0976,830,62156,0.0000,0,0
2021-06-02,Brazil,203070494,Roraima,636707,0.1560,1138,99299,0.0984,471,62627,0.0000,0,0
2021-06-03,Brazil,203070494,Roraima,636707,0.1574,888,100187,0.0988,278,62905,0.0000,0,0
2021-06-04,Brazil,203070494,Roraima,636707,0.1585,748,100935,0.0992,267,63172,0.0000,0,0
2021-06-05,Brazil,203070494,Roraima,636707,0.1601,1022,101957,0.0994,119,63291,0.0000,0,0
2021-06-06,Brazil,203070494,Roraima,636707,0.1602,18,101975,0.0994,25,63316,0.0000,0,0
2021-06-07,Brazil,203070494,Roraima,636707,0.1625,1493,103468,0.0999,275,63591,0.0000,0,0
2021-06-08,Brazil,203070494,Roraima,636707,0.1660,2226,105694,0.1002,235,63826,0.0000,0,0
2021-06-09,Brazil,203070494,Roraima,636707,0.1688,1794,107488,0.1005,166,63992,0.0000,0,0
2021-06-10,Brazil,203070494,Roraima,636707,0.1728,2550,110038,0.1007,154,64146,0.0000,0,0
2021-06-11,Brazil,203070494,Roraima,636707,0.1771,2693,112731,0.1010,159,64305,0.0000,0,0
2021-06-12,Brazil,203070494,Roraima,636707,0.1789,1150,113881,0.1011,54,64359,0.0000,0,0
2021-06-13,Brazil,203070494,Roraima,636707,0.1789,43,113924,0.1012,53,64412,0.0000,0,0
2021-06-14,Brazil,203070494,Roraima,636707,0.1840,3261,117185,0.1014,177,64589,0.0000,0,0
2021-06-15,Brazil,203070494,Roraima,636707,0.1886,2895,120080,0.1016,131,64720,0.0000,0,0
2021-06-16,Brazil,203070494,Roraima,636707,0.1940,3433,123513,0.1019,132,64852,0.0000,0,0
2021-06-17,Brazil,203070494,Roraima,636707,0.1986,2953,126466,0.1021,127,64979,0.0000,0,0
2021-06-18,Brazil,203070494,Roraima,636707,0.2035,3106,129572,0.1024,189,65168,0.0000,0,0
2021-06-19,Brazil,203070494,Roraima,636707,0.2058,1467,131039,0.1025,95,65263,0.0000,0,0
2021-06-20,Brazil,203070494,Roraima,636707,0.2059,53,131092,0.1025,12,65275,0.0000,0,0
2021-06-21,Brazil,203070494,Roraima,636707,0.2146,5570,136662,0.1028,179,65454,0.0000,0,0
2021-06-22,Brazil,203070494,Roraima,636707,0.2238,5837,142499,0.1031,203,65657,0.0000,0,0
2021-06-23,Brazil,203070494,Roraima,636707,0.2307,4386,146885,0.1034,203,65860,0.0000,0,0
2021-06-24,Brazil,203070494,Roraima,636707,0.2360,3348,150233,0.1037,141,66001,0.0000,0,0
2021-06-25,Brazil,203070494,Roraima,636707,0.2411,3247,153480,0.1039,152,66153,0.0000,0,0
2021-06-26,Brazil,203070494,Roraima,636707,0.2459,3084,156564,0.1040,38,66191,0.0000,0,0
2021-06-27,Brazil,203070494,Roraima,636707,0.2485,1689,158253,0.1040,22,66213,0.0000,0,0
2021-06-28,Brazil,203070494,Roraima,636707,0.2513,1752,160005,0.1041,61,66274,0.0000,0,0
2021-06-29,Brazil,203070494,Roraima,636707,0.2601,5577,165582,0.1043,160,66434,0.0000,0,0
2021-06-30,Brazil,203070494,Roraima,636707,0.2678,4920,170502,0.1047,200,66634,0.0000,0,0
2021-07-01,Brazil,203070494,Roraima,636707,0.2723,2891,173393,0.1050,202,66836,0.0000,0,0
2021-07-02,Brazil,203070494,Roraima,636707,0.2770,2949,176342,0.1052,114,66950,0.0000,0,0
2021-07-03,Brazil,203070494,Roraima,636707,0.2792,1433,177775,0.1052,9,66959,0.0000,0,0
2021-07-04,Brazil,203070494,Roraima,636707,0.2793,52,177827,0.1052,3,66962,0.0000,0,0
2021-07-05,Brazil,203070494,Roraima,636707,0.2845,3298,181125,0.1055,237,67199,0.0000,0,0
2021-07-06,Brazil,203070494,Roraima,636707,0.2910,4152,185277,0.1060,274,67473,0.0000,0,0
2021-07-07,Brazil,203070494,Roraima,636707,0.2978,4310,189587,0.1062,123,67596,0.0000,0,0
2021-07-08,Brazil,203070494,Roraima,636707,0.3026,3075,192662,0.1065,200,67796,0.0000,0,0
2021-07-09,Brazil,203070494,Roraima,636707,0.3075,3150,195812,0.1066,105,67901,0.0000,0,0
2021-07-10,Brazil,203070494,Roraima,636707,0.3093,1143,196955,0.1067,16,67917,0.0000,0,0
2021-07-11,Brazil,203070494,Roraima,636707,0.3094,36,196991,0.1067,15,67932,0.0000,0,0
2021-07-12,Brazil,203070494,Roraima,636707,0.3176,5255,202246,0.1070,209,68141,0.0000,0,0
2021-07-13,Brazil,203070494,Roraima,636707,0.3258,5215,207461,0.1076,368,68509,0.0000,0,0
2021-07-14,Brazil,203070494,Roraima,636707,0.3320,3917,211378,0.1079,223,68732,0.0000,0,0
2021-07-15,Brazil,203070494,Roraima,636707,0.3371,3231,214609,0.1083,229,68961,0.0000,0,0
2021-07-16,Brazil,203070494,Roraima,636707,0.3416,2866,217475,0.1087,238,69199,0.0000,0,0
2021-07-17,Brazil,203070494,Roraima,636707,0.3448,2031,219506,0.1088,100,69299,0.0000,0,0
2021-07-18,Brazil,203070494,Roraima,636707,0.3448,61,219567,0.1089,15,69314,0.0000,0,0
2021-07-19,Brazil,203070494,Roraima,636707,0.3530,5218,224785,0.1093,288,69602,0.0000,0,0
2021-07-20,Brazil,203070494,Roraima,636707,0.3606,4840,229625,0.1097,242,69844,0.0000,0,0
2021-07-21,Brazil,203070494,Roraima,636707,0.3670,4023,233648,0.1100,221,70065,0.0000,0,0
2021-07-22,Brazil,203070494,Roraima,636707,0.3716,2978,236626,0.1105,297,70362,0.0000,0,0
2021-07-23,Brazil,203070494,Roraima,636707,0.3763,2993,239619,0.1107,135,70497,0.0000,0,0
2021-07-24,Brazil,203070494,Roraima,636707,0.3798,2212,241831,0.1108,45,70542,0.0000,0,0
2021-07-25,Brazil,203070494,Roraima,636707,0.3799,32,241863,0.1108,25,70567,0.0000,0,0
2021-07-26,Brazil,203070494,Roraima,636707,0.3858,3802,245665,0.1112,243,70810,0.0000,0,0
2021-07-27,Brazil,203070494,Roraima,636707,0.3911,3381,249046,0.1115,210,71020,0.0000,0,0
2021-07-28,Brazil,203070494,Roraima,636707,0.3946,2214,251260,0.1118,183,71203,0.0000,0,0
2021-07-29,Brazil,203070494,Roraima,636707,0.3976,1895,253155,0.1121,190,71393,0.0000,0,0
2021-07-30,Brazil,203070494,Roraima,636707,0.4006,1922,255077,0.1124,152,71545,0.0000,0,0
2021-07-31,Brazil,203070494,Roraima,636707,0.4025,1218,256295,0.1127,204,71749,0.0000,0,0
2021-08-01,Brazil,203070494,Roraima,636707,0.4026,47,256342,0.1127,36,71785,0.0000,0,0
2021-08-02,Brazil,203070494,Roraima,636707,0.4082,3532,259874,0.1133,336,72121,0.0000,0,0
2021-08-03,Brazil,203070494,Roraima,636707,0.4117,2276,262150,0.1137,241,72362,0.0000,0,0
2021-08-04,Brazil,203070494,Roraima,636707,0.4144,1701,263851,0.1142,330,72692,0.0000,0,0
2021-08-05,Brazil,203070494,Roraima,636707,0.4169,1584,265435,0.1148,373,73065,0.0000,0,0
2021-08-06,Brazil,203070494,Roraima,636707,0.4195,1642,267077,0.1157,614,73679,0.0000,0,0
2021-08-07,Brazil,203070494,Roraima,636707,0.4211,1026,268103,0.1163,401,74080,0.0000,0,0
2021-08-08,Brazil,203070494,Roraima,636707,0.4213,142,268245,0.1164,27,74107,0.0000,0,0
2021-08-09,Brazil,203070494,Roraima,636707,0.4238,1560,269805,0.1179,961,75068,0.0000,0,0
2021-08-10,Brazil,203070494,Roraima,636707,0.4262,1566,271371,0.1201,1411,76479,0.0000,0,0
2021-08-11,Brazil,203070494,Roraima,636707,0.4283,1313,272684,0.1220,1196,77675,0.0000,0,0
2021-08-12,Brazil,203070494,Roraima,636707,0.4307,1552,274236,0.1239,1243,78918,0.0000,0,0
2021-08-13,Brazil,203070494,Roraima,636707,0.4328,1319,275555,0.1265,1622,80540,0.0000,0,0
2021-08-14,Brazil,203070494,Roraima,636707,0.4341,810,276365,0.1287,1378,81918,0.0000,0,0
2021-08-15,Brazil,203070494,Roraima,636707,0.4343,143,276508,0.1287,49,81967,0.0000,0,0
2021-08-16,Brazil,203070494,Roraima,636707,0.4384,2616,279124,0.1304,1075,83042,0.0000,0,0
2021-08-17,Brazil,203070494,Roraima,636707,0.4443,3736,282860,0.1325,1309,84351,0.0000,0,0
2021-08-18,Brazil,203070494,Roraima,636707,0.4522,5056,287916,0.1348,1482,85833,0.0000,0,0
2021-08-19,Brazil,203070494,Roraima,636707,0.4586,4097,292013,0.1368,1291,87124,0.0000,0,0
2021-08-20,Brazil,203070494,Roraima,636707,0.4657,4485,296498,0.1384,985,88109,0.0000,0,0
2021-08-21,Brazil,203070494,Roraima,636707,0.4741,5351,301849,0.1395,683,88792,0.0000,0,0
2021-08-22,Brazil,203070494,Roraima,636707,0.4763,1392,303241,0.1397,149,88941,0.0000,0,0
2021-08-23,Brazil,203070494,Roraima,636707,0.4839,4868,308109,0.1413,1005,89946,0.0000,0,0
2021-08-24,Brazil,203070494,Roraima,636707,0.4906,4257,312366,0.1432,1262,91208,0.0000,0,0
2021-08-25,Brazil,203070494,Roraima,636707,0.4966,3844,316210,0.1451,1159,92367,0.0000,0,0
2021-08-26,Brazil,203070494,Roraima,636707,0.5017,3242,319452,0.1466,1001,93368,0.0000,0,0
2021-08-27,Brazil,203070494,Roraima,636707,0.5064,2982,322434,0.1484,1139,94507,0.0000,0,0
2021-08-28,Brazil,203070494,Roraima,636707,0.5082,1119,323553,0.1496,765,95272,0.0000,0,0
2021-08-29,Brazil,203070494,Roraima,636707,0.5082,1,323554,0.1496,5,95277,0.0000,0,0
2021-08-30,Brazil,203070494,Roraima,636707,0.5120,2425,325979,0.1516,1275,96552,0.0000,0,0
2021-08-31,Brazil,203070494,Roraima,636707,0.5151,1997,327976,0.1536,1251,97803,0.0000,0,0
2021-09-01,Brazil,203070494,Roraima,636707,0.5177,1617,329593,0.1555,1191,98994,0.0000,0,0
2021-09-02,Brazil,203070494,Roraima,636707,0.5203,1670,331263,0.1572,1125,100119,0.0000,0,0
2021-09-03,Brazil,203070494,Roraima,636707,0.5223,1270,332533,0.1589,1055,101174,0.0000,0,0
2021-09-04,Brazil,203070494,Roraima,636707,0.5231,519,333052,0.1597,526,101700,0.0000,0,0
2021-09-05,Brazil,203070494,Roraima,636707,0.5231,10,333062,0.1597,6,101706,0.0000,0,0
2021-09-06,Brazil,203070494,Roraima,636707,0.5242,693,333755,0.1609,726,102432,0.0000,0,0
2021-09-07,Brazil,203070494,Roraima,636707,0.5243,45,333800,0.1609,37,102469,0.0000,0,0
2021-09-08,Brazil,203070494,Roraima,636707,0.5264,1389,335189,0.1641,2019,104488,0.0000,0,0
2021-09-09,Brazil,203070494,Roraima,636707,0.5284,1253,336442,0.1676,2230,106718,0.0000,0,0
2021-09-10,Brazil,203070494,Roraima,636707,0.5306,1366,337808,0.1710,2166,108884,0.0000,0,0
2021-09-11,Brazil,203070494,Roraima,636707,0.5314,521,338329,0.1726,1002,109886,0.0000,0,0
2021-09-12,Brazil,203070494,Roraima,636707,0.5314,13,338342,0.1726,9,109895,0.0000,0,0
2021-09-13,Brazil,203070494,Roraima,636707,0.5337,1489,339831,0.1763,2388,112283,0.0000,0,0
2021-09-14,Brazil,203070494,Roraima,636707,0.5360,1464,341295,0.1809,2871,115154,0.0000,0,0
2021-09-15,Brazil,203070494,Roraima,636707,0.5382,1384,342679,0.1844,2224,117378,0.0000,0,0
2021-09-16,Brazil,203070494,Roraima,636707,0.5401,1201,343880,0.1920,4863,122241,0.0000,0,0
2021-09-17,Brazil,203070494,Roraima,636707,0.5417,1041,344921,0.1993,4657,126898,0.0000,0,0
2021-09-18,Brazil,203070494,Roraima,636707,0.5423,359,345280,0.2036,2709,129607,0.0000,0,0
2021-09-19,Brazil,203070494,Roraima,636707,0.5423,22,345302,0.2036,53,129660,0.0000,0,0
2021-09-20,Brazil,203070494,Roraima,636707,0.5442,1198,346500,0.2133,6149,135809,0.0000,0,0
2021-09-21,Brazil,203070494,Roraima,636707,0.5459,1096,347596,0.2225,5882,141691,0.0000,0,0
2021-09-22,Brazil,203070494,Roraima,636707,0.5478,1163,348759,0.2310,5404,147095,0.0000,0,0
2021-09-23,Brazil,203070494,Roraima,636707,0.5494,1073,349832,0.2376,4217,151312,0.0000,0,0
2021-09-24,Brazil,203070494,Roraima,636707,0.5507,803,350635,0.2433,3595,154907,0.0000,0,0
2021-09-25,Brazil,203070494,Roraima,636707,0.5513,356,350991,0.2480,3027,157934,0.0000,0,0
2021-09-26,Brazil,203070494,Roraima,636707,0.5513,19,351010,0.2481,42,157976,0.0000,0,0
2021-09-27,Brazil,203070494,Roraima,636707,0.5529,1029,352039,0.2551,4471,162447,0.0000,0,0
2021-09-28,Brazil,203070494,Roraima,636707,0.5544,941,352980,0.2611,3829,166276,0.0000,0,0
2021-09-29,Brazil,203070494,Roraima,636707,0.5557,839,353819,0.2664,3354,169630,0.0000,0,0
2021-09-30,Brazil,203070494,Roraima,636707,0.5570,853,354672,0.2714,3165,172795,0.0000,0,0
2021-10-01,Brazil,203070494,Roraima,636707,0.5580,627,355299,0.2759,2854,175649,0.0000,0,0
2021-10-02,Brazil,203070494,Roraima,636707,0.5584,265,355564,0.2782,1487,177136,0.0000,0,0
2021-10-03,Brazil,203070494,Roraima,636707,0.5584,2,355566,0.2782,7,177143,0.0000,0,0
2021-10-04,Brazil,203070494,Roraima,636707,0.5596,718,356284,0.2822,2562,179705,0.0000,0,0
2021-10-05,Brazil,203070494,Roraima,636707,0.5599,186,356470,0.2838,971,180676,0.0000,0,0
2021-10-06,Brazil,203070494,Roraima,636707,0.5610,747,357217,0.2883,2903,183579,0.0000,0,0
2021-10-07,Brazil,203070494,Roraima,636707,0.5623,773,357990,0.2921,2379,185958,0.0000,0,0
2021-10-08,Brazil,203070494,Roraima,636707,0.5632,578,358568,0.2955,2162,188120,0.0000,0,0
2021-10-09,Brazil,203070494,Roraima,636707,0.5636,277,358845,0.2973,1188,189308,0.0000,0,0
2021-10-10,Brazil,203070494,Roraima,636707,0.5636,8,358853,0.2974,28,189336,0.0000,0,0
2021-10-11,Brazil,203070494,Roraima,636707,0.5641,337,359190,0.2993,1233,190569,0.0000,0,0
2021-10-12,Brazil,203070494,Roraima,636707,0.5644,150,359340,0.3004,705,191274,0.0000,0,0
2021-10-13,Brazil,203070494,Roraima,636707,0.5657,859,360199,0.3056,3321,194595,0.0000,0,0
2021-10-14,Brazil,203070494,Roraima,636707,0.5670,819,361018,0.3102,2916,197511,0.0000,0,0
2021-10-15,Brazil,203070494,Roraima,636707,0.5681,686,361704,0.3137,2230,199741,0.0000,0,0
2021-10-16,Brazil,203070494,Roraima,636707,0.5687,389,362093,0.3149,731,200472,0.0000,0,0
2021-10-17,Brazil,203070494,Roraima,636707,0.5689,105,362198,0.3149,31,200503,0.0000,0,0
2021-10-18,Brazil,203070494,Roraima,636707,0.5708,1247,363445,0.3195,2926,203429,0.0000,0,0
2021-10-19,Brazil,203070494,Roraima,636707,0.5723,957,364402,0.3228,2080,205509,0.0000,0,0
2021-10-20,Brazil,203070494,Roraima,636707,0.5739,995,365397,0.3258,1935,207444,0.0000,0,0
2021-10-21,Brazil,203070494,Roraima,636707,0.5755,1017,366414,0.3291,2126,209570,0.0000,0,0
2021-10-22,Brazil,203070494,Roraima,636707,0.5768,869,367283,0.3323,1993,211563,0.0000,0,0
2021-10-23,Brazil,203070494,Roraima,636707,0.5774,383,367666,0.3340,1072,212635,0.0000,0,0
2021-10-24,Brazil,203070494,Roraima,636707,0.5776,80,367746,0.3341,105,212740,0.0000,0,0
2021-10-25,Brazil,203070494,Roraima,636707,0.5790,903,368649,0.3378,2335,215075,0.0000,0,0
2021-10-26,Brazil,203070494,Roraima,636707,0.5800,671,369320,0.3410,2067,217142,0.0000,0,0
2021-10-27,Brazil,203070494,Roraima,636707,0.5811,689,370009,0.3443,2090,219232,0.0000,0,0
2021-10-28,Brazil,203070494,Roraima,636707,0.5821,618,370627,0.3472,1817,221049,0.0000,0,0
2021-10-29,Brazil,203070494,Roraima,636707,0.5823,144,370771,0.3475,231,221280,0.0000,0,0
2021-10-30,Brazil,203070494,Roraima,636707,0.5826,166,370937,0.3484,532,221812,0.0000,0,0
2021-10-31,Brazil,203070494,Roraima,636707,0.5826,1,370938,0.3484,2,221814,0.0000,0,0
2021-11-01,Brazil,203070494,Roraima,636707,0.5830,257,371195,0.3493,583,222397,0.0000,0,0
2021-11-02,Brazil,203070494,Roraima,636707,0.5830,30,371225,0.3493,14,222411,0.0000,0,0
2021-11-03,Brazil,203070494,Roraima,636707,0.5844,872,372097,0.3530,2327,224738,0.0000,0,0
2021-11-04,Brazil,203070494,Roraima,636707,0.5860,985,373082,0.3570,2591,227329,0.0000,0,0
2021-11-05,Brazil,203070494,Roraima,636707,0.5870,693,373775,0.3598,1736,229065,0.0000,0,0
2021-11-06,Brazil,203070494,Roraima,636707,0.5873,161,373936,0.3608,640,229705,0.0000,0,0
2021-11-07,Brazil,203070494,Roraima,636707,0.5874,48,373984,0.3608,15,229720,0.0000,0,0
2021-11-08,Brazil,203070494,Roraima,636707,0.5886,791,374775,0.3636,1795,231515,0.0000,0,0
2021-11-09,Brazil,203070494,Roraima,636707,0.5901,974,375749,0.3670,2179,233694,0.0000,0,0
2021-11-10,Brazil,203070494,Roraima,636707,0.5918,1055,376804,0.3702,2039,235733,0.0000,0,0
2021-11-11,Brazil,203070494,Roraima,636707,0.5933,936,377740,0.3733,1968,237701,0.0000,0,0
2021-11-12,Brazil,203070494,Roraima,636707,0.5945,790,378530,0.3759,1633,239334,0.0000,0,0
2021-11-13,Brazil,203070494,Roraima,636707,0.5948,196,378726,0.3768,609,239943,0.0000,0,0
2021-11-14,Brazil,203070494,Roraima,636707,0.5950,127,378853,0.3771,139,240082,0.0000,0,0
2021-11-15,Brazil,203070494,Roraima,636707,0.5953,153,379006,0.3772,89,240171,0.0000,0,0
2021-11-16,Brazil,203070494,Roraima,636707,0.5966,857,379863,0.3801,1810,241981,0.0000,0,0
2021-11-17,Brazil,203070494,Roraima,636707,0.5978,760,380623,0.3828,1737,243718,0.0000,0,0
2021-11-18,Brazil,203070494,Roraima,636707,0.5990,779,381402,0.3857,1860,245578,0.0000,0,0
2021-11-19,Brazil,203070494,Roraima,636707,0.6003,784,382186,0.3885,1807,247385,0.0000,0,0
2021-11-20,Brazil,203070494,Roraima,636707,0.6007,265,382451,0.3900,912,248297,0.0000,0,0
2021-11-21,Brazil,203070494,Roraima,636707,0.6007,30,382481,0.3900,22,248319,0.0000,0,0
2021-11-22,Brazil,203070494,Roraima,636707,0.6020,801,383282,0.3932,2060,250379,0.0000,0,0
2021-11-23,Brazil,203070494,Roraima,636707,0.6030,679,383961,0.3964,1986,252365,0.0000,0,0
2021-11-24,Brazil,203070494,Roraima,636707,0.6039,552,384513,0.3993,1887,254252,0.0000,0,0
2021-11-25,Brazil,203070494,Roraima,636707,0.6048,572,385085,0.4020,1677,255929,0.0000,0,0
2021-11-26,Brazil,203070494,Roraima,636707,0.6057,553,385638,0.4043,1478,257407,0.0000,0,0
2021-11-27,Brazil,203070494,Roraima,636707,0.6059,112,385750,0.4047,264,257671,0.0000,0,0
2021-11-28,Brazil,203070494,Roraima,636707,0.6059,11,385761,0.4047,12,257683,0.0000,0,0
2021-11-29,Brazil,203070494,Roraima,636707,0.6069,666,386427,0.4076,1827,259510,0.0000,0,0
2021-11-30,Brazil,203070494,Roraima,636707,0.6080,683,387110,0.4107,1969,261479,0.0000,0,0
2021-12-01,Brazil,203070494,Roraima,636707,0.6091,737,387847,0.4134,1764,263243,0.0000,0,0
2021-12-02,Brazil,203070494,Roraima,636707,0.6103,724,388571,0.4160,1655,264898,0.0000,0,0
2021-12-03,Brazil,203070494,Roraima,636707,0.6116,850,389421,0.4186,1641,266539,0.0000,0,0
2021-12-04,Brazil,203070494,Roraima,636707,0.6124,519,389940,0.4202,1030,267569,0.0000,0,0
2021-12-05,Brazil,203070494,Roraima,636707,0.6129,288,390228,0.4209,424,267993,0.0000,0,0
2021-12-06,Brazil,203070494,Roraima,636707,0.6146,1082,391310,0.4243,2158,270151,0.0000,0,0
2021-12-07,Brazil,203070494,Roraima,636707,0.6160,906,392216,0.4272,1865,272016,0.0000,0,0
2021-12-08,Brazil,203070494,Roraima,636707,0.6169,585,392801,0.4288,1010,273026,0.0000,0,0
2021-12-09,Brazil,203070494,Roraima,636707,0.6182,810,393611,0.4311,1449,274475,0.0000,0,0
2021-12-10,Brazil,203070494,Roraima,636707,0.6191,560,394171,0.4329,1127,275602,0.0000,0,0
2021-12-11,Brazil,203070494,Roraima,636707,0.6195,282,394453,0.4337,558,276160,0.0000,0,0
2021-12-12,Brazil,203070494,Roraima,636707,0.6197,125,394578,0.4340,170,276330,0.0000,0,0
2021-12-13,Brazil,203070494,Roraima,636707,0.6204,433,395011,0.4358,1169,277499,0.0000,0,0
2021-12-14,Brazil,203070494,Roraima,636707,0.6211,472,395483,0.4375,1063,278562,0.0000,0,0
2021-12-15,Brazil,203070494,Roraima,636707,0.6217,329,395812,0.4389,905,279467,0.0000,0,0
2021-12-16,Brazil,203070494,Roraima,636707,0.6223,439,396251,0.4401,775,280242,0.0000,0,0
2021-12-17,Brazil,203070494,Roraima,636707,0.6228,277,396528,0.4412,645,280887,0.0000,0,0
2021-12-18,Brazil,203070494,Roraima,636707,0.6229,108,396636,0.4415,242,281129,0.0000,0,0
2021-12-19,Brazil,203070494,Roraima,636707,0.6231,77,396713,0.4416,60,281189,0.0000,0,0
2021-12-20,Brazil,203070494,Roraima,636707,0.6236,343,397056,0.4429,815,282004,0.0000,0,0
2021-12-21,Brazil,203070494,Roraima,636707,0.6240,258,397314,0.4439,641,282645,0.0000,0,0
2021-12-22,Brazil,203070494,Roraima,636707,0.6245,290,397604,0.4448,584,283229,0.0000,0,0
2021-12-23,Brazil,203070494,Roraima,636707,0.6248,239,397843,0.4458,598,283827,0.0000,0,0
2021-12-24,Brazil,203070494,Roraima,636707,0.6249,24,397867,0.4459,57,283884,0.0000,0,0
2021-12-25,Brazil,203070494,Roraima,636707,0.6249,9,397876,0.4459,3,283887,0.0000,0,0
2021-12-26,Brazil,203070494,Roraima,636707,0.6249,5,397881,0.4459,2,283889,0.0000,0,0
2021-12-27,Brazil,203070494,Roraima,636707,0.6254,321,398202,0.4470,696,284585,0.0000,0,0
2021-12-28,Brazil,203070494,Roraima,636707,0.6259,323,398525,0.4481,727,285312,0.0000,0,0
2021-12-29,Brazil,203070494,Roraima,636707,0.6264,306,398831,0.4491,620,285932,0.0000,0,0
2021-12-30,Brazil,203070494,Roraima,636707,0.6267,210,399041,0.4497,423,286355,0.0000,0,0
2021-12-31,Brazil,203070494,Roraima,636707,0.6268,40,399081,0.4499,74,286429,0.0000,0,0
2021-01-04,Brazil,203070494,Santa Catarina,7610361,0.0000,1,1,0.0000,0,0,0.0000,0,0
2021-01-05,Brazil,203070494,Santa Catarina,7610361,0.0000,2,3,0.0000,0,0,0.0000,0,0
2021-01-06,Brazil,203070494,Santa Catarina,7610361,0.0000,1,4,0.0000,0,0,0.0000,0,0
2021-01-07,Brazil,203070494,Santa Catarina,7610361,0.0000,0,4,0.0000,0,0,0.0000,0,0
2021-01-11,Brazil,203070494,Santa Catarina,7610361,0.0000,4,8,0.0000,0,0,0.0000,0,0
2021-01-12,Brazil,203070494,Santa Catarina,7610361,0.0000,1,9,0.0000,1,1,0.0000,0,0
2021-01-13,Brazil,203070494,Santa Catarina,7610361,0.0000,0,9,0.0000,0,1,0.0000,0,0
2021-01-14,Brazil,203070494,Santa Catarina,7610361,0.0000,1,10,0.0000,0,1,0.0000,0,0
2021-01-15,Brazil,203070494,Santa Catarina,7610361,0.0000,2,12,0.0000,1,2,0.0000,0,0
2021-01-16,Brazil,203070494,Santa Catarina,7610361,0.0000,2,14,0.0000,0,2,0.0000,0,0
2021-01-17,Brazil,203070494,Santa Catarina,7610361,0.0000,16,30,0.0000,2,4,0.0000,0,0
2021-01-18,Brazil,203070494,Santa Catarina,7610361,0.0000,15,45,0.0000,3,7,0.0000,0,0
2021-01-19,Brazil,203070494,Santa Catarina,7610361,0.0004,2915,2960,0.0000,6,13,0.0000,0,0
2021-01-20,Brazil,203070494,Santa Catarina,7610361,0.0022,14095,17055,0.0000,20,33,0.0000,0,0
2021-01-21,Brazil,203070494,Santa Catarina,7610361,0.0039,12270,29325,0.0000,20,53,0.0000,0,0
2021-01-22,Brazil,203070494,Santa Catarina,7610361,0.0048,7052,36377,0.0000,30,83,0.0000,0,0
2021-01-23,Brazil,203070494,Santa Catarina,7610361,0.0049,1031,37408,0.0000,2,85,0.0000,0,0
2021-01-24,Brazil,203070494,Santa Catarina,7610361,0.0049,251,37659,0.0000,4,89,0.0000,0,0
2021-01-25,Brazil,203070494,Santa Catarina,7610361,0.0057,5393,43052,0.0000,10,99,0.0000,0,0
2021-01-26,Brazil,203070494,Santa Catarina,7610361,0.0063,4572,47624,0.0000,7,106,0.0000,0,0
2021-01-27,Brazil,203070494,Santa Catarina,7610361,0.0069,4546,52170,0.0000,5,111,0.0000,0,0
2021-01-28,Brazil,203070494,Santa Catarina,7610361,0.0077,6766,58936,0.0000,7,118,0.0000,0,0
2021-01-29,Brazil,203070494,Santa Catarina,7610361,0.0090,9555,68491,0.0000,6,124,0.0000,0,0
2021-01-30,Brazil,203070494,Santa Catarina,7610361,0.0092,1264,69755,0.0000,4,128,0.0000,0,0
2021-01-31,Brazil,203070494,Santa Catarina,7610361,0.0092,197,69952,0.0000,0,128,0.0000,0,0
2021-02-01,Brazil,203070494,Santa Catarina,7610361,0.0099,5345,75297,0.0000,9,137,0.0000,0,0
2021-02-02,Brazil,203070494,Santa Catarina,7610361,0.0106,5192,80489,0.0000,18,155,0.0000,0,0
2021-02-03,Brazil,203070494,Santa Catarina,7610361,0.0112,4746,85235,0.0000,36,191,0.0000,0,0
2021-02-04,Brazil,203070494,Santa Catarina,7610361,0.0118,4273,89508,0.0000,124,315,0.0000,0,0
2021-02-05,Brazil,203070494,Santa Catarina,7610361,0.0124,5065,94573,0.0001,397,712,0.0000,0,0
2021-02-06,Brazil,203070494,Santa Catarina,7610361,0.0126,982,95555,0.0001,2,714,0.0000,0,0
2021-02-07,Brazil,203070494,Santa Catarina,7610361,0.0126,713,96268,0.0001,5,719,0.0000,0,0
2021-02-08,Brazil,203070494,Santa Catarina,7610361,0.0131,3258,99526,0.0002,868,1587,0.0000,0,0
2021-02-09,Brazil,203070494,Santa Catarina,7610361,0.0137,4465,103991,0.0003,1014,2601,0.0000,0,0
2021-02-10,Brazil,203070494,Santa Catarina,7610361,0.0146,7407,111398,0.0009,4321,6922,0.0000,0,0
2021-02-11,Brazil,203070494,Santa Catarina,7610361,0.0158,8857,120255,0.0018,6918,13840,0.0000,0,0
2021-02-12,Brazil,203070494,Santa Catarina,7610361,0.0169,8449,128704,0.0026,5962,19802,0.0000,0,0
2021-02-13,Brazil,203070494,Santa Catarina,7610361,0.0172,2233,130937,0.0027,596,20398,0.0000,0,0
2021-02-14,Brazil,203070494,Santa Catarina,7610361,0.0174,1120,132057,0.0027,257,20655,0.0000,0,0
2021-02-15,Brazil,203070494,Santa Catarina,7610361,0.0179,4468,136525,0.0034,5341,25996,0.0000,0,0
2021-02-16,Brazil,203070494,Santa Catarina,7610361,0.0186,4699,141224,0.0041,5414,31410,0.0000,0,0
2021-02-17,Brazil,203070494,Santa Catarina,7610361,0.0194,6303,147527,0.0050,6756,38166,0.0000,0,0
2021-02-18,Brazil,203070494,Santa Catarina,7610361,0.0200,4391,151918,0.0058,5814,43980,0.0000,0,0
2021-02-19,Brazil,203070494,Santa Catarina,7610361,0.0204,3104,155022,0.0063,3967,47947,0.0000,0,0
2021-02-20,Brazil,203070494,Santa Catarina,7610361,0.0205,654,155676,0.0064,551,48498,0.0000,0,0
2021-02-21,Brazil,203070494,Santa Catarina,7610361,0.0205,62,155738,0.0064,42,48540,0.0000,0,0
2021-02-22,Brazil,203070494,Santa Catarina,7610361,0.0207,1627,157365,0.0067,2656,51196,0.0000,0,0
2021-02-23,Brazil,203070494,Santa Catarina,7610361,0.0209,1747,159112,0.0070,2432,53628,0.0000,0,0
2021-02-24,Brazil,203070494,Santa Catarina,7610361,0.0211,1190,160302,0.0074,2493,56121,0.0000,0,0
2021-02-25,Brazil,203070494,Santa Catarina,7610361,0.0213,1789,162091,0.0077,2329,58450,0.0000,0,0
2021-02-26,Brazil,203070494,Santa Catarina,7610361,0.0225,8766,170857,0.0080,2109,60559,0.0000,0,0
2021-02-27,Brazil,203070494,Santa Catarina,7610361,0.0240,11444,182301,0.0080,247,60806,0.0000,0,0
2021-02-28,Brazil,203070494,Santa Catarina,7610361,0.0243,2697,184998,0.0080,13,60819,0.0000,0,0
2021-03-01,Brazil,203070494,Santa Catarina,7610361,0.0258,11284,196282,0.0083,2315,63134,0.0000,0,0
2021-03-02,Brazil,203070494,Santa Catarina,7610361,0.0273,11854,208136,0.0086,2434,65568,0.0000,0,0
2021-03-03,Brazil,203070494,Santa Catarina,7610361,0.0289,11715,219851,0.0090,2688,68256,0.0000,0,0
2021-03-04,Brazil,203070494,Santa Catarina,7610361,0.0302,9742,229593,0.0094,3495,71751,0.0000,0,0
2021-03-05,Brazil,203070494,Santa Catarina,7610361,0.0321,14397,243990,0.0101,5015,76766,0.0000,0,0
2021-03-06,Brazil,203070494,Santa Catarina,7610361,0.0341,15149,259139,0.0102,1196,77962,0.0000,0,0
2021-03-07,Brazil,203070494,Santa Catarina,7610361,0.0343,1769,260908,0.0102,41,78003,0.0000,0,0
2021-03-08,Brazil,203070494,Santa Catarina,7610361,0.0353,8034,268942,0.0107,3476,81479,0.0000,0,0
2021-03-09,Brazil,203070494,Santa Catarina,7610361,0.0364,7870,276812,0.0113,4602,86081,0.0000,0,0
2021-03-10,Brazil,203070494,Santa Catarina,7610361,0.0371,5729,282541,0.0119,4541,90622,0.0000,0,0
2021-03-11,Brazil,203070494,Santa Catarina,7610361,0.0378,5145,287686,0.0124,3850,94472,0.0000,0,0
2021-03-12,Brazil,203070494,Santa Catarina,7610361,0.0398,15275,302961,0.0128,3006,97478,0.0000,0,0
2021-03-13,Brazil,203070494,Santa Catarina,7610361,0.0412,10570,313531,0.0129,410,97888,0.0000,0,0
2021-03-14,Brazil,203070494,Santa Catarina,7610361,0.0414,1247,314778,0.0129,22,97910,0.0000,0,0
2021-03-15,Brazil,203070494,Santa Catarina,7610361,0.0425,8551,323329,0.0132,2712,100622,0.0000,0,0
2021-03-16,Brazil,203070494,Santa Catarina,7610361,0.0432,5485,328814,0.0136,2990,103612,0.0000,0,0
2021-03-17,Brazil,203070494,Santa Catarina,7610361,0.0437,3678,332492,0.0140,2768,106380,0.0000,0,0
2021-03-18,Brazil,203070494,Santa Catarina,7610361,0.0441,3340,335832,0.0143,2225,108605,0.0000,0,0
2021-03-19,Brazil,203070494,Santa Catarina,7610361,0.0469,20792,356624,0.0149,4948,113553,0.0000,0,0
2021-03-20,Brazil,203070494,Santa Catarina,7610361,0.0530,46823,403447,0.0154,3969,117522,0.0000,0,0
2021-03-21,Brazil,203070494,Santa Catarina,7610361,0.0552,16630,420077,0.0155,357,117879,0.0000,0,0
2021-03-22,Brazil,203070494,Santa Catarina,7610361,0.0575,17861,437938,0.0160,3770,121649,0.0000,0,0
2021-03-23,Brazil,203070494,Santa Catarina,7610361,0.0620,33698,471636,0.0164,3276,124925,0.0000,0,0
2021-03-24,Brazil,203070494,Santa Catarina,7610361,0.0671,38749,510385,0.0168,3220,128145,0.0000,0,0
2021-03-25,Brazil,203070494,Santa Catarina,7610361,0.0715,33809,544194,0.0173,3280,131425,0.0000,0,0
2021-03-26,Brazil,203070494,Santa Catarina,7610361,0.0748,25262,569456,0.0181,6590,138015,0.0000,0,0
2021-03-27,Brazil,203070494,Santa Catarina,7610361,0.0782,25883,595339,0.0189,5693,143708,0.0000,0,0
2021-03-28,Brazil,203070494,Santa Catarina,7610361,0.0792,7255,602594,0.0191,1512,145220,0.0000,0,0
2021-03-29,Brazil,203070494,Santa Catarina,7610361,0.0818,19765,622359,0.0198,5102,150322,0.0000,0,0
2021-03-30,Brazil,203070494,Santa Catarina,7610361,0.0873,42253,664612,0.0205,5565,155887,0.0000,0,0
2021-03-31,Brazil,203070494,Santa Catarina,7610361,0.0915,31885,696497,0.0213,6035,161922,0.0000,0,0
2021-04-01,Brazil,203070494,Santa Catarina,7610361,0.0939,18282,714779,0.0219,5037,166959,0.0000,0,0
2021-04-02,Brazil,203070494,Santa Catarina,7610361,0.0942,2246,717025,0.0221,886,167845,0.0000,0,0
2021-04-03,Brazil,203070494,Santa Catarina,7610361,0.0953,8548,725573,0.0227,5030,172875,0.0000,0,0
2021-04-04,Brazil,203070494,Santa Catarina,7610361,0.0955,1109,726682,0.0228,611,173486,0.0000,0,0
2021-04-05,Brazil,203070494,Santa Catarina,7610361,0.0974,14711,741393,0.0244,12444,185930,0.0000,0,0
2021-04-06,Brazil,203070494,Santa Catarina,7610361,0.1005,23449,764842,0.0255,8444,194374,0.0000,0,0
2021-04-07,Brazil,203070494,Santa Catarina,7610361,0.1025,15514,780356,0.0265,6936,201310,0.0000,0,0
2021-04-08,Brazil,203070494,Santa Catarina,7610361,0.1036,8403,788759,0.0275,8063,209373,0.0000,0,0
2021-04-09,Brazil,203070494,Santa Catarina,7610361,0.1057,15746,804505,0.0292,12913,222286,0.0000,0,0
2021-04-10,Brazil,203070494,Santa Catarina,7610361,0.1083,19747,824252,0.0316,18358,240644,0.0000,0,0
2021-04-11,Brazil,203070494,Santa Catarina,7610361,0.1086,2420,826672,0.0328,8977,249621,0.0000,0,0
2021-04-12,Brazil,203070494,Santa Catarina,7610361,0.1102,12218,838890,0.0349,15787,265408,0.0000,1,1
2021-04-13,Brazil,203070494,Santa Catarina,7610361,0.1118,12100,850990,0.0372,17797,283205,0.0000,0,1
2021-04-14,Brazil,203070494,Santa Catarina,7610361,0.1131,9765,860755,0.0399,20751,303956,0.0000,0,1
2021-04-15,Brazil,203070494,Santa Catarina,7610361,0.1141,7405,868160,0.0435,27435,331391,0.0000,0,1
2021-04-16,Brazil,203070494,Santa Catarina,7610361,0.1157,12014,880174,0.0466,23092,354483,0.0000,0,1
2021-04-17,Brazil,203070494,Santa Catarina,7610361,0.1189,24353,904527,0.0501,26901,381384,0.0000,0,1
2021-04-18,Brazil,203070494,Santa Catarina,7610361,0.1198,6927,911454,0.0507,4367,385751,0.0000,0,1
2021-04-19,Brazil,203070494,Santa Catarina,7610361,0.1220,16727,928181,0.0538,23651,409402,0.0000,0,1
2021-04-20,Brazil,203070494,Santa Catarina,7610361,0.1252,24599,952780,0.0577,29428,438830,0.0000,0,1
2021-04-21,Brazil,203070494,Santa Catarina,7610361,0.1273,16257,969037,0.0588,8841,447671,0.0000,0,1
2021-04-22,Brazil,203070494,Santa Catarina,7610361,0.1293,14853,983890,0.0631,32853,480524,0.0000,0,1
2021-04-23,Brazil,203070494,Santa Catarina,7610361,0.1309,12420,996310,0.0659,21341,501865,0.0000,0,1
2021-04-24,Brazil,203070494,Santa Catarina,7610361,0.1335,19781,1016091,0.0679,14572,516437,0.0000,0,1
2021-04-25,Brazil,203070494,Santa Catarina,7610361,0.1338,1910,1018001,0.0682,2663,519100,0.0000,0,1
2021-04-26,Brazil,203070494,Santa Catarina,7610361,0.1354,12155,1030156,0.0710,21236,540336,0.0000,0,1
2021-04-27,Brazil,203070494,Santa Catarina,7610361,0.1375,16308,1046464,0.0738,21364,561700,0.0000,0,1
2021-04-28,Brazil,203070494,Santa Catarina,7610361,0.1394,14444,1060908,0.0760,16588,578288,0.0000,0,1
2021-04-29,Brazil,203070494,Santa Catarina,7610361,0.1409,11030,1071938,0.0777,13296,591584,0.0000,0,1
2021-04-30,Brazil,203070494,Santa Catarina,7610361,0.1426,13343,1085281,0.0792,10879,602463,0.0000,0,1
2021-05-01,Brazil,203070494,Santa Catarina,7610361,0.1468,31972,1117253,0.0798,4501,606964,0.0000,0,1
2021-05-02,Brazil,203070494,Santa Catarina,7610361,0.1483,11153,1128406,0.0800,1754,608718,0.0000,0,1
2021-05-03,Brazil,203070494,Santa Catarina,7610361,0.1513,23017,1151423,0.0815,11764,620482,0.0000,0,1
2021-05-04,Brazil,203070494,Santa Catarina,7610361,0.1542,22037,1173460,0.0838,17098,637580,0.0000,0,1
2021-05-05,Brazil,203070494,Santa Catarina,7610361,0.1574,24619,1198079,0.0854,12262,649842,0.0000,0,1
2021-05-06,Brazil,203070494,Santa Catarina,7610361,0.1614,30581,1228660,0.0862,6495,656337,0.0000,0,1
2021-05-07,Brazil,203070494,Santa Catarina,7610361,0.1648,25623,1254283,0.0868,3980,660317,0.0000,0,1
2021-05-08,Brazil,203070494,Santa Catarina,7610361,0.1669,15653,1269936,0.0872,3084,663401,0.0000,0,1
2021-05-09,Brazil,203070494,Santa Catarina,7610361,0.1670,1102,1271038,0.0872,47,663448,0.0000,0,1
2021-05-10,Brazil,203070494,Santa Catarina,7610361,0.1696,19372,1290410,0.0884,9602,673050,0.0000,0,1
2021-05-11,Brazil,203070494,Santa Catarina,7610361,0.1726,22891,1313301,0.0898,10088,683138,0.0000,0,1
2021-05-12,Brazil,203070494,Santa Catarina,7610361,0.1750,18678,1331979,0.0906,6022,689160,0.0000,0,1
2021-05-13,Brazil,203070494,Santa Catarina,7610361,0.1777,20286,1352265,0.0911,3860,693020,0.0000,0,1
2021-05-14,Brazil,203070494,Santa Catarina,7610361,0.1806,21931,1374196,0.0915,3187,696207,0.0000,0,1
2021-05-15,Brazil,203070494,Santa Catarina,7610361,0.1834,21518,1395714,0.0917,1772,697979,0.0000,0,1
2021-05-16,Brazil,203070494,Santa Catarina,7610361,0.1842,5924,1401638,0.0918,807,698786,0.0000,0,1
2021-05-17,Brazil,203070494,Santa Catarina,7610361,0.1866,18788,1420426,0.0922,3002,701788,0.0000,0,1
2021-05-18,Brazil,203070494,Santa Catarina,7610361,0.1896,22861,1443287,0.0925,2164,703952,0.0000,0,1
2021-05-19,Brazil,203070494,Santa Catarina,7610361,0.1929,25048,1468335,0.0928,2372,706324,0.0000,0,1
2021-05-20,Brazil,203070494,Santa Catarina,7610361,0.1960,23653,1491988,0.0931,2137,708461,0.0000,0,1
2021-05-21,Brazil,203070494,Santa Catarina,7610361,0.1988,21005,1512993,0.0934,2081,710542,0.0000,0,1
2021-05-22,Brazil,203070494,Santa Catarina,7610361,0.2003,11351,1524344,0.0937,2199,712741,0.0000,0,1
2021-05-23,Brazil,203070494,Santa Catarina,7610361,0.2011,6460,1530804,0.0937,59,712800,0.0000,0,1
2021-05-24,Brazil,203070494,Santa Catarina,7610361,0.2035,18247,1549051,0.0941,3437,716237,0.0000,0,1
2021-05-25,Brazil,203070494,Santa Catarina,7610361,0.2067,24230,1573281,0.0947,4808,721045,0.0000,0,1
2021-05-26,Brazil,203070494,Santa Catarina,7610361,0.2107,30479,1603760,0.0953,4460,725505,0.0000,0,1
2021-05-27,Brazil,203070494,Santa Catarina,7610361,0.2152,33809,1637569,0.0959,4589,730094,0.0000,0,1
2021-05-28,Brazil,203070494,Santa Catarina,7610361,0.2205,40835,1678404,0.0964,3791,733885,0.0000,0,1
2021-05-29,Brazil,203070494,Santa Catarina,7610361,0.2245,29972,1708376,0.0968,2800,736685,0.0000,0,1
2021-05-30,Brazil,203070494,Santa Catarina,7610361,0.2247,1759,1710135,0.0969,810,737495,0.0000,0,1
2021-05-31,Brazil,203070494,Santa Catarina,7610361,0.2292,34079,1744214,0.0974,3692,741187,0.0000,0,1
2021-06-01,Brazil,203070494,Santa Catarina,7610361,0.2342,37796,1782010,0.0981,5616,746803,0.0000,0,1
2021-06-02,Brazil,203070494,Santa Catarina,7610361,0.2390,36886,1818896,0.0989,5792,752595,0.0000,0,1
2021-06-03,Brazil,203070494,Santa Catarina,7610361,0.2402,9277,1828173,0.0991,1386,753981,0.0000,0,1
2021-06-04,Brazil,203070494,Santa Catarina,7610361,0.2435,25300,1853473,0.0994,2413,756394,0.0000,0,1
2021-06-05,Brazil,203070494,Santa Catarina,7610361,0.2471,27202,1880675,0.0995,1155,757549,0.0000,0,1
2021-06-06,Brazil,203070494,Santa Catarina,7610361,0.2476,3738,1884413,0.0995,33,757582,0.0000,0,1
2021-06-07,Brazil,203070494,Santa Catarina,7610361,0.2533,43627,1928040,0.1000,3601,761183,0.0000,0,1
2021-06-08,Brazil,203070494,Santa Catarina,7610361,0.2606,55188,1983228,0.1003,2316,763499,0.0000,0,1
2021-06-09,Brazil,203070494,Santa Catarina,7610361,0.2678,54878,2038106,0.1006,2282,765781,0.0000,0,1
2021-06-10,Brazil,203070494,Santa Catarina,7610361,0.2743,49199,2087305,0.1009,1846,767627,0.0000,0,1
2021-06-11,Brazil,203070494,Santa Catarina,7610361,0.2817,56570,2143875,0.1012,2329,769956,0.0000,0,1
2021-06-12,Brazil,203070494,Santa Catarina,7610361,0.2882,49456,2193331,0.1013,731,770687,0.0000,0,1
2021-06-13,Brazil,203070494,Santa Catarina,7610361,0.2895,9534,2202865,0.1013,44,770731,0.0000,0,1
2021-06-14,Brazil,203070494,Santa Catarina,7610361,0.2956,46927,2249792,0.1015,1887,772618,0.0000,0,1
2021-06-15,Brazil,203070494,Santa Catarina,7610361,0.3021,49625,2299417,0.1019,2535,775153,0.0000,0,1
2021-06-16,Brazil,203070494,Santa Catarina,7610361,0.3082,46184,2345601,0.1023,3270,778423,0.0000,0,1
2021-06-17,Brazil,203070494,Santa Catarina,7610361,0.3130,36699,2382300,0.1027,2993,781416,0.0000,0,1
2021-06-18,Brazil,203070494,Santa Catarina,7610361,0.3168,28983,2411283,0.1030,2577,783993,0.0000,0,1
2021-06-19,Brazil,203070494,Santa Catarina,7610361,0.3212,33041,2444324,0.1032,1072,785065,0.0000,0,1
2021-06-20,Brazil,203070494,Santa Catarina,7610361,0.3217,3996,2448320,0.1032,34,785099,0.0000,0,1
2021-06-21,Brazil,203070494,Santa Catarina,7610361,0.3259,32131,2480451,0.1035,2626,787725,0.0000,0,1
2021-06-22,Brazil,203070494,Santa Catarina,7610361,0.3307,36009,2516460,0.1045,7329,795054,0.0000,0,1
2021-06-23,Brazil,203070494,Santa Catarina,7610361,0.3347,30851,2547311,0.1052,5727,800781,0.0000,0,1
2021-06-24,Brazil,203070494,Santa Catarina,7610361,0.3376,21745,2569056,0.1058,4624,805405,0.0000,0,1
2021-06-25,Brazil,203070494,Santa Catarina,7610361,0.3418,32426,2601482,0.1062,2973,808378,0.0000,0,1
2021-06-26,Brazil,203070494,Santa Catarina,7610361,0.3478,45033,2646515,0.1065,1907,810285,0.0000,0,1
2021-06-27,Brazil,203070494,Santa Catarina,7610361,0.3483,4505,2651020,0.1065,59,810344,0.0000,0,1
2021-06-28,Brazil,203070494,Santa Catarina,7610361,0.3535,39089,2690109,0.1070,3811,814155,0.0000,0,1
2021-06-29,Brazil,203070494,Santa Catarina,7610361,0.3582,36204,2726313,0.1075,4052,818207,0.0000,0,1
2021-06-30,Brazil,203070494,Santa Catarina,7610361,0.3623,30705,2757018,0.1082,4954,823161,0.0000,0,1
2021-07-01,Brazil,203070494,Santa Catarina,7610361,0.3660,28497,2785515,0.1087,4155,827316,0.0000,0,1
2021-07-02,Brazil,203070494,Santa Catarina,7610361,0.3736,58033,2843548,0.1093,4641,831957,0.0000,0,1
2021-07-03,Brazil,203070494,Santa Catarina,7610361,0.3808,54170,2897718,0.1104,7865,839822,0.0000,0,1
2021-07-04,Brazil,203070494,Santa Catarina,7610361,0.3815,5291,2903009,0.1105,1252,841074,0.0000,0,1
2021-07-05,Brazil,203070494,Santa Catarina,7610361,0.3876,46708,2949717,0.1118,10027,851101,0.0000,0,1
2021-07-06,Brazil,203070494,Santa Catarina,7610361,0.4002,96089,3045806,0.1126,6138,857239,0.0000,0,1
2021-07-07,Brazil,203070494,Santa Catarina,7610361,0.4107,79544,3125350,0.1140,10373,867612,0.0000,0,1
2021-07-08,Brazil,203070494,Santa Catarina,7610361,0.4180,55557,3180907,0.1154,10419,878031,0.0000,0,1
2021-07-09,Brazil,203070494,Santa Catarina,7610361,0.4248,52196,3233103,0.1172,13674,891705,0.0000,0,1
2021-07-10,Brazil,203070494,Santa Catarina,7610361,0.4344,72524,3305627,0.1189,12938,904643,0.0000,0,1
2021-07-11,Brazil,203070494,Santa Catarina,7610361,0.4363,15126,3320753,0.1192,2653,907296,0.0000,0,1
2021-07-12,Brazil,203070494,Santa Catarina,7610361,0.4416,40185,3360938,0.1225,25311,932607,0.0000,0,1
2021-07-13,Brazil,203070494,Santa Catarina,7610361,0.4471,41656,3402594,0.1259,25184,957791,0.0000,0,1
2021-07-14,Brazil,203070494,Santa Catarina,7610361,0.4520,37638,3440232,0.1294,26814,984605,0.0000,0,1
2021-07-15,Brazil,203070494,Santa Catarina,7610361,0.4557,27492,3467724,0.1324,23103,1007708,0.0000,0,1
2021-07-16,Brazil,203070494,Santa Catarina,7610361,0.4630,55774,3523498,0.1355,23349,1031057,0.0000,0,1
2021-07-17,Brazil,203070494,Santa Catarina,7610361,0.4664,26005,3549503,0.1383,21184,1052241,0.0000,0,1
2021-07-18,Brazil,203070494,Santa Catarina,7610361,0.4672,5833,3555336,0.1387,3045,1055286,0.0000,0,1
2021-07-19,Brazil,203070494,Santa Catarina,7610361,0.4709,28497,3583833,0.1420,25156,1080442,0.0000,0,1
2021-07-20,Brazil,203070494,Santa Catarina,7610361,0.4740,23807,3607640,0.1457,28133,1108575,0.0000,0,1
2021-07-21,Brazil,203070494,Santa Catarina,7610361,0.4761,15984,3623624,0.1492,26931,1135506,0.0000,0,1
2021-07-22,Brazil,203070494,Santa Catarina,7610361,0.4840,59871,3683495,0.1522,22799,1158305,0.0000,0,1
2021-07-23,Brazil,203070494,Santa Catarina,7610361,0.4913,55642,3739137,0.1553,23472,1181777,0.0000,0,1
2021-07-24,Brazil,203070494,Santa Catarina,7610361,0.4948,26821,3765958,0.1573,15633,1197410,0.0000,0,1
2021-07-25,Brazil,203070494,Santa Catarina,7610361,0.4964,11971,3777929,0.1577,2428,1199838,0.0000,0,1
2021-07-26,Brazil,203070494,Santa Catarina,7610361,0.4998,25654,3803583,0.1620,32747,1232585,0.0000,0,1
2021-07-27,Brazil,203070494,Santa Catarina,7610361,0.5027,22261,3825844,0.1661,31818,1264403,0.0000,0,1
2021-07-28,Brazil,203070494,Santa Catarina,7610361,0.5050,17660,3843504,0.1701,30156,1294559,0.0000,0,1
2021-07-29,Brazil,203070494,Santa Catarina,7610361,0.5088,28807,3872311,0.1730,22085,1316644,0.0000,0,1
2021-07-30,Brazil,203070494,Santa Catarina,7610361,0.5132,33576,3905887,0.1765,26505,1343149,0.0000,0,1
2021-07-31,Brazil,203070494,Santa Catarina,7610361,0.5156,18233,3924120,0.1784,14565,1357714,0.0000,0,1
2021-08-01,Brazil,203070494,Santa Catarina,7610361,0.5160,2608,3926728,0.1786,1714,1359428,0.0000,0,1
2021-08-02,Brazil,203070494,Santa Catarina,7610361,0.5192,24805,3951533,0.1822,26926,1386354,0.0000,0,1
2021-08-03,Brazil,203070494,Santa Catarina,7610361,0.5267,57083,4008616,0.1857,26805,1413159,0.0000,0,1
2021-08-04,Brazil,203070494,Santa Catarina,7610361,0.5323,42150,4050766,0.1892,26658,1439817,0.0000,0,1
2021-08-05,Brazil,203070494,Santa Catarina,7610361,0.5364,31547,4082313,0.1933,31278,1471095,0.0000,0,1
2021-08-06,Brazil,203070494,Santa Catarina,7610361,0.5433,52615,4134928,0.1968,26801,1497896,0.0000,0,1
2021-08-07,Brazil,203070494,Santa Catarina,7610361,0.5464,23296,4158224,0.1996,21154,1519050,0.0000,0,1
2021-08-08,Brazil,203070494,Santa Catarina,7610361,0.5469,3951,4162175,0.1997,682,1519732,0.0000,0,1
2021-08-09,Brazil,203070494,Santa Catarina,7610361,0.5518,37445,4199620,0.2036,29694,1549426,0.0000,0,1
2021-08-10,Brazil,203070494,Santa Catarina,7610361,0.5603,64844,4264464,0.2069,25499,1574925,0.0000,0,1
2021-08-11,Brazil,203070494,Santa Catarina,7610361,0.5670,50930,4315394,0.2108,29573,1604498,0.0000,0,1
2021-08-12,Brazil,203070494,Santa Catarina,7610361,0.5744,55625,4371019,0.2141,24599,1629097,0.0000,0,1
2021-08-13,Brazil,203070494,Santa Catarina,7610361,0.5817,55828,4426847,0.2183,32175,1661272,0.0000,0,1
2021-08-14,Brazil,203070494,Santa Catarina,7610361,0.5881,48539,4475386,0.2207,18365,1679637,0.0000,0,1
2021-08-15,Brazil,203070494,Santa Catarina,7610361,0.5888,5914,4481300,0.2213,4804,1684441,0.0000,0,1
2021-08-16,Brazil,203070494,Santa Catarina,7610361,0.5953,49313,4530613,0.2255,31747,1716188,0.0000,0,1
2021-08-17,Brazil,203070494,Santa Catarina,7610361,0.6037,63729,4594342,0.2291,27419,1743607,0.0000,0,1
2021-08-18,Brazil,203070494,Santa Catarina,7610361,0.6130,70891,4665233,0.2329,29139,1772746,0.0000,0,1
2021-08-19,Brazil,203070494,Santa Catarina,7610361,0.6198,51548,4716781,0.2378,37097,1809843,0.0000,0,1
2021-08-20,Brazil,203070494,Santa Catarina,7610361,0.6274,58230,4775011,0.2428,37936,1847779,0.0000,0,1
2021-08-21,Brazil,203070494,Santa Catarina,7610361,0.6346,54546,4829557,0.2456,21337,1869116,0.0000,0,1
2021-08-22,Brazil,203070494,Santa Catarina,7610361,0.6361,11327,4840884,0.2467,8663,1877779,0.0000,0,1
2021-08-23,Brazil,203070494,Santa Catarina,7610361,0.6427,49952,4890836,0.2507,30319,1908098,0.0000,0,1
2021-08-24,Brazil,203070494,Santa Catarina,7610361,0.6492,49961,4940797,0.2555,36369,1944467,0.0000,0,1
2021-08-25,Brazil,203070494,Santa Catarina,7610361,0.6539,35743,4976540,0.2596,31332,1975799,0.0000,0,1
2021-08-26,Brazil,203070494,Santa Catarina,7610361,0.6613,56327,5032867,0.2636,30578,2006377,0.0000,1,2
2021-08-27,Brazil,203070494,Santa Catarina,7610361,0.6664,38965,5071832,0.2684,36432,2042809,0.0000,0,2
2021-08-28,Brazil,203070494,Santa Catarina,7610361,0.6693,21754,5093586,0.2725,31078,2073887,0.0000,0,2
2021-08-29,Brazil,203070494,Santa Catarina,7610361,0.6708,11643,5105229,0.2730,4007,2077894,0.0000,0,2
2021-08-30,Brazil,203070494,Santa Catarina,7610361,0.6739,23282,5128511,0.2777,35700,2113594,0.0000,0,2
2021-08-31,Brazil,203070494,Santa Catarina,7610361,0.6765,20087,5148598,0.2839,46640,2160234,0.0000,0,2
2021-09-01,Brazil,203070494,Santa Catarina,7610361,0.6787,16503,5165101,0.2894,42467,2202701,0.0000,0,2
2021-09-02,Brazil,203070494,Santa Catarina,7610361,0.6807,15538,5180639,0.2943,36867,2239568,0.0000,0,2
2021-09-03,Brazil,203070494,Santa Catarina,7610361,0.6823,11570,5192209,0.3003,46004,2285572,0.0000,0,2
2021-09-04,Brazil,203070494,Santa Catarina,7610361,0.6830,6038,5198247,0.3033,22438,2308010,0.0000,0,2
2021-09-05,Brazil,203070494,Santa Catarina,7610361,0.6833,1797,5200044,0.3038,3969,2311979,0.0000,0,2
2021-09-06,Brazil,203070494,Santa Catarina,7610361,0.6841,5832,5205876,0.3070,24395,2336374,0.0000,0,2
2021-09-07,Brazil,203070494,Santa Catarina,7610361,0.6846,4251,5210127,0.3077,5435,2341809,0.0000,0,2
2021-09-08,Brazil,203070494,Santa Catarina,7610361,0.6862,11762,5221889,0.3134,42945,2384754,0.0000,0,2
2021-09-09,Brazil,203070494,Santa Catarina,7610361,0.6887,19002,5240891,0.3188,41165,2425919,0.0000,0,2
2021-09-10,Brazil,203070494,Santa Catarina,7610361,0.6905,13797,5254688,0.3237,37739,2463658,0.0000,0,2
2021-09-11,Brazil,203070494,Santa Catarina,7610361,0.6924,14606,5269294,0.3272,26218,2489876,0.0000,0,2
2021-09-12,Brazil,203070494,Santa Catarina,7610361,0.6931,5160,5274454,0.3281,6949,2496825,0.0000,0,2
2021-09-13,Brazil,203070494,Santa Catarina,7610361,0.6958,20614,5295068,0.3334,40486,2537311,0.0000,23,25
2021-09-14,Brazil,203070494,Santa Catarina,7610361,0.6980,16610,5311678,0.3388,40975,2578286,0.0000,68,93
2021-09-15,Brazil,203070494,Santa Catarina,7610361,0.7021,31378,5343056,0.3437,37153,2615439,0.0000,32,125
2021-09-16,Brazil,203070494,Santa Catarina,7610361,0.7060,29925,5372981,0.3483,35299,2650738,0.0000,86,211
2021-09-17,Brazil,203070494,Santa Catarina,7610361,0.7094,25910,5398891,0.3523,30409,2681147,0.0000,36,247
2021-09-18,Brazil,203070494,Santa Catarina,7610361,0.7113,14358,5413249,0.3558,26979,2708126,0.0001,163,410
2021-09-19,Brazil,203070494,Santa Catarina,7610361,0.7117,3360,5416609,0.3567,6311,2714437,0.0001,0,410
2021-09-20,Brazil,203070494,Santa Catarina,7610361,0.7139,16563,5433172,0.3617,38338,2752775,0.0001,58,468
2021-09-21,Brazil,203070494,Santa Catarina,7610361,0.7164,18613,5451785,0.3672,41624,2794399,0.0001,113,581
2021-09-22,Brazil,203070494,Santa Catarina,7610361,0.7186,16907,5468692,0.3731,45212,2839611,0.0001,70,651
2021-09-23,Brazil,203070494,Santa Catarina,7610361,0.7212,19921,5488613,0.3791,45844,2885455,0.0001,130,781
2021-09-24,Brazil,203070494,Santa Catarina,7610361,0.7238,19737,5508350,0.3859,51106,2936561,0.0001,83,864
2021-09-25,Brazil,203070494,Santa Catarina,7610361,0.7253,11202,5519552,0.3905,35221,2971782,0.0001,25,889
2021-09-26,Brazil,203070494,Santa Catarina,7610361,0.7253,287,5519839,0.3915,7677,2979459,0.0001,0,889
2021-09-27,Brazil,203070494,Santa Catarina,7610361,0.7278,18833,5538672,0.3978,47975,3027434,0.0001,159,1048
2021-09-28,Brazil,203070494,Santa Catarina,7610361,0.7306,21329,5560001,0.4050,54506,3081940,0.0002,165,1213
2021-09-29,Brazil,203070494,Santa Catarina,7610361,0.7334,21588,5581589,0.4105,42168,3124108,0.0002,88,1301
2021-09-30,Brazil,203070494,Santa Catarina,7610361,0.7355,15588,5597177,0.4166,46192,3170300,0.0002,46,1347
2021-10-01,Brazil,203070494,Santa Catarina,7610361,0.7376,16073,5613250,0.4225,45349,3215649,0.0002,65,1412
2021-10-02,Brazil,203070494,Santa Catarina,7610361,0.7399,17389,5630639,0.4304,59761,3275410,0.0002,1,1413
2021-10-03,Brazil,203070494,Santa Catarina,7610361,0.7404,3711,5634350,0.4322,13624,3289034,0.0002,0,1413
2021-10-04,Brazil,203070494,Santa Catarina,7610361,0.7418,11256,5645606,0.4373,39324,3328358,0.0002,114,1527
2021-10-05,Brazil,203070494,Santa Catarina,7610361,0.7430,9001,5654607,0.4434,45780,3374138,0.0002,101,1628
2021-10-06,Brazil,203070494,Santa Catarina,7610361,0.7441,8597,5663204,0.4483,37708,3411846,0.0002,66,1694
2021-10-07,Brazil,203070494,Santa Catarina,7610361,0.7452,8053,5671257,0.4540,43193,3455039,0.0002,129,1823
2021-10-08,Brazil,203070494,Santa Catarina,7610361,0.7467,11102,5682359,0.4603,48224,3503263,0.0003,406,2229
2021-10-09,Brazil,203070494,Santa Catarina,7610361,0.7469,1625,5683984,0.4634,23033,3526296,0.0003,7,2236
2021-10-10,Brazil,203070494,Santa Catarina,7610361,0.7469,266,5684250,0.4638,3563,3529859,0.0003,0,2236
2021-10-11,Brazil,203070494,Santa Catarina,7610361,0.7472,2406,5686656,0.4663,19098,3548957,0.0003,0,2236
2021-10-12,Brazil,203070494,Santa Catarina,7610361,0.7473,275,5686931,0.4665,1249,3550206,0.0003,0,2236
2021-10-13,Brazil,203070494,Santa Catarina,7610361,0.7479,4892,5691823,0.4722,43505,3593711,0.0004,650,2886
2021-10-14,Brazil,203070494,Santa Catarina,7610361,0.7485,4610,5696433,0.4782,45645,3639356,0.0004,460,3346
2021-10-15,Brazil,203070494,Santa Catarina,7610361,0.7491,4514,5700947,0.4836,41181,3680537,0.0005,558,3904
2021-10-16,Brazil,203070494,Santa Catarina,7610361,0.7498,5048,5705995,0.4880,33165,3713702,0.0005,38,3942
2021-10-17,Brazil,203070494,Santa Catarina,7610361,0.7498,545,5706540,0.4887,5639,3719341,0.0005,0,3942
2021-10-18,Brazil,203070494,Santa Catarina,7610361,0.7504,3927,5710467,0.4930,32638,3751979,0.0006,688,4630
2021-10-19,Brazil,203070494,Santa Catarina,7610361,0.7509,4317,5714784,0.4982,39742,3791721,0.0007,604,5234
2021-10-20,Brazil,203070494,Santa Catarina,7610361,0.7515,4554,5719338,0.5033,38367,3830088,0.0007,357,5591
2021-10-21,Brazil,203070494,Santa Catarina,7610361,0.7532,12631,5731969,0.5086,40199,3870287,0.0008,311,5902
2021-10-22,Brazil,203070494,Santa Catarina,7610361,0.7553,16083,5748052,0.5140,41528,3911815,0.0008,426,6328
2021-10-23,Brazil,203070494,Santa Catarina,7610361,0.7565,9318,5757370,0.5169,22278,3934093,0.0008,11,6339
2021-10-24,Brazil,203070494,Santa Catarina,7610361,0.7567,1118,5758488,0.5179,7539,3941632,0.0008,1,6340
2021-10-25,Brazil,203070494,Santa Catarina,7610361,0.7580,10356,5768844,0.5225,34566,3976198,0.0009,327,6667
2021-10-26,Brazil,203070494,Santa Catarina,7610361,0.7594,10099,5778943,0.5272,35966,4012164,0.0009,334,7001
2021-10-27,Brazil,203070494,Santa Catarina,7610361,0.7608,10990,5789933,0.5318,35020,4047184,0.0010,311,7312
2021-10-28,Brazil,203070494,Santa Catarina,7610361,0.7622,10906,5800839,0.5364,34941,4082125,0.0010,492,7804
2021-10-29,Brazil,203070494,Santa Catarina,7610361,0.7631,6952,5807791,0.5406,32174,4114299,0.0011,669,8473
2021-10-30,Brazil,203070494,Santa Catarina,7610361,0.7636,3233,5811024,0.5427,16036,4130335,0.0011,16,8489
2021-10-31,Brazil,203070494,Santa Catarina,7610361,0.7636,150,5811174,0.5430,2288,4132623,0.0011,0,8489
2021-11-01,Brazil,203070494,Santa Catarina,7610361,0.7638,1460,5812634,0.5440,7741,4140364,0.0011,1,8490
2021-11-02,Brazil,203070494,Santa Catarina,7610361,0.7638,386,5813020,0.5444,2591,4142955,0.0011,0,8490
2021-11-03,Brazil,203070494,Santa Catarina,7610361,0.7647,6595,5819615,0.5490,35420,4178375,0.0011,36,8526
2021-11-04,Brazil,203070494,Santa Catarina,7610361,0.7656,6503,5826118,0.5539,36880,4215255,0.0011,43,8569
2021-11-05,Brazil,203070494,Santa Catarina,7610361,0.7665,7317,5833435,0.5586,35716,4250971,0.0011,35,8604
2021-11-06,Brazil,203070494,Santa Catarina,7610361,0.7667,1476,5834911,0.5612,20218,4271189,0.0011,0,8604
2021-11-07,Brazil,203070494,Santa Catarina,7610361,0.7667,232,5835143,0.5619,4995,4276184,0.0011,0,8604
2021-11-08,Brazil,203070494,Santa Catarina,7610361,0.7674,5050,5840193,0.5660,30962,4307146,0.0011,80,8684
2021-11-09,Brazil,203070494,Santa Catarina,7610361,0.7682,6228,5846421,0.5705,34484,4341630,0.0011,60,8744
2021-11-10,Brazil,203070494,Santa Catarina,7610361,0.7700,13836,5860257,0.5751,35070,4376700,0.0012,41,8785
2021-11-11,Brazil,203070494,Santa Catarina,7610361,0.7716,11787,5872044,0.5799,36388,4413088,0.0012,35,8820
2021-11-12,Brazil,203070494,Santa Catarina,7610361,0.7727,8478,5880522,0.5847,37023,4450111,0.0012,26,8846
2021-11-13,Brazil,203070494,Santa Catarina,7610361,0.7730,2106,5882628,0.5866,14455,4464566,0.0012,0,8846
2021-11-14,Brazil,203070494,Santa Catarina,7610361,0.7730,164,5882792,0.5872,3914,4468480,0.0012,0,8846
2021-11-15,Brazil,203070494,Santa Catarina,7610361,0.7730,295,5883087,0.5878,5196,4473676,0.0012,0,8846
2021-11-16,Brazil,203070494,Santa Catarina,7610361,0.7740,7094,5890181,0.5927,36768,4510444,0.0012,47,8893
2021-11-17,Brazil,203070494,Santa Catarina,7610361,0.7750,7852,5898033,0.5977,38438,4548882,0.0012,91,8984
2021-11-18,Brazil,203070494,Santa Catarina,7610361,0.7759,6754,5904787,0.6029,39059,4587941,0.0012,37,9021
2021-11-19,Brazil,203070494,Santa Catarina,7610361,0.7768,7079,5911866,0.6082,40372,4628313,0.0012,27,9048
2021-11-20,Brazil,203070494,Santa Catarina,7610361,0.7784,12418,5924284,0.6127,34536,4662849,0.0012,41,9089
2021-11-21,Brazil,203070494,Santa Catarina,7610361,0.7785,195,5924479,0.6131,2896,4665745,0.0012,0,9089
2021-11-22,Brazil,203070494,Santa Catarina,7610361,0.7794,6908,5931387,0.6170,29659,4695404,0.0012,64,9153
2021-11-23,Brazil,203070494,Santa Catarina,7610361,0.7803,7288,5938675,0.6208,29156,4724560,0.0012,56,9209
2021-11-24,Brazil,203070494,Santa Catarina,7610361,0.7811,5450,5944125,0.6242,25480,4750040,0.0012,3,9212
2021-11-25,Brazil,203070494,Santa Catarina,7610361,0.7819,6113,5950238,0.6277,27286,4777326,0.0012,38,9250
2021-11-26,Brazil,203070494,Santa Catarina,7610361,0.7825,4983,5955221,0.6312,26113,4803439,0.0012,52,9302
2021-11-27,Brazil,203070494,Santa Catarina,7610361,0.7828,2133,5957354,0.6328,12750,4816189,0.0012,5,9307
2021-11-28,Brazil,203070494,Santa Catarina,7610361,0.7828,98,5957452,0.6331,2274,4818463,0.0012,0,9307
2021-11-29,Brazil,203070494,Santa Catarina,7610361,0.7834,4321,5961773,0.6359,20914,4839377,0.0012,8,9315
2021-11-30,Brazil,203070494,Santa Catarina,7610361,0.7841,5349,5967122,0.6388,22184,4861561,0.0012,26,9341
2021-12-01,Brazil,203070494,Santa Catarina,7610361,0.7847,4643,5971765,0.6412,18082,4879643,0.0012,33,9374
2021-12-02,Brazil,203070494,Santa Catarina,7610361,0.7852,4202,5975967,0.6437,18802,4898445,0.0012,4,9378
2021-12-03,Brazil,203070494,Santa Catarina,7610361,0.7859,5017,5980984,0.6460,17917,4916362,0.0012,76,9454
2021-12-04,Brazil,203070494,Santa Catarina,7610361,0.7861,1696,5982680,0.6469,6650,4923012,0.0012,31,9485
2021-12-05,Brazil,203070494,Santa Catarina,7610361,0.7861,64,5982744,0.6470,790,4923802,0.0012,0,9485
2021-12-06,Brazil,203070494,Santa Catarina,7610361,0.7867,4394,5987138,0.6490,15297,4939099,0.0012,19,9504
2021-12-07,Brazil,203070494,Santa Catarina,7610361,0.7873,4286,5991424,0.6510,15255,4954354,0.0012,7,9511
2021-12-08,Brazil,203070494,Santa Catarina,7610361,0.7878,3909,5995333,0.6531,15763,4970117,0.0012,0,9511
2021-12-09,Brazil,203070494,Santa Catarina,7610361,0.7883,3668,5999001,0.6547,12713,4982830,0.0013,2,9513
2021-12-10,Brazil,203070494,Santa Catarina,7610361,0.7887,3651,6002652,0.6566,14022,4996852,0.0013,62,9575
2021-12-11,Brazil,203070494,Santa Catarina,7610361,0.7891,2548,6005200,0.6576,7894,5004746,0.0013,33,9608
2021-12-12,Brazil,203070494,Santa Catarina,7610361,0.7891,161,6005361,0.6577,890,5005636,0.0013,0,9608
2021-12-13,Brazil,203070494,Santa Catarina,7610361,0.7895,3215,6008576,0.6594,12599,5018235,0.0013,105,9713
2021-12-14,Brazil,203070494,Santa Catarina,7610361,0.7900,3711,6012287,0.6613,14270,5032505,0.0013,36,9749
2021-12-15,Brazil,203070494,Santa Catarina,7610361,0.7904,3212,6015499,0.6629,12030,5044535,0.0013,17,9766
2021-12-16,Brazil,203070494,Santa Catarina,7610361,0.7909,3182,6018681,0.6645,12912,5057447,0.0013,29,9795
2021-12-17,Brazil,203070494,Santa Catarina,7610361,0.7912,2869,6021550,0.6663,13603,5071050,0.0013,106,9901
2021-12-18,Brazil,203070494,Santa Catarina,7610361,0.7913,780,6022330,0.6669,4544,5075594,0.0013,0,9901
2021-12-19,Brazil,203070494,Santa Catarina,7610361,0.7913,89,6022419,0.6670,573,5076167,0.0013,0,9901
2021-12-20,Brazil,203070494,Santa Catarina,7610361,0.7916,1953,6024372,0.6683,9895,5086062,0.0013,45,9946
2021-12-21,Brazil,203070494,Santa Catarina,7610361,0.7919,2068,6026440,0.6696,9774,5095836,0.0013,99,10045
2021-12-22,Brazil,203070494,Santa Catarina,7610361,0.7921,1646,6028086,0.6708,9316,5105152,0.0013,72,10117
2021-12-23,Brazil,203070494,Santa Catarina,7610361,0.7923,1428,6029514,0.6716,5999,5111151,0.0013,68,10185
2021-12-24,Brazil,203070494,Santa Catarina,7610361,0.7923,44,6029558,0.6716,198,5111349,0.0013,0,10185
2021-12-25,Brazil,203070494,Santa Catarina,7610361,0.7923,2,6029560,0.6716,28,5111377,0.0013,0,10185
2021-12-26,Brazil,203070494,Santa Catarina,7610361,0.7923,1,6029561,0.6716,5,5111382,0.0013,0,10185
2021-12-27,Brazil,203070494,Santa Catarina,7610361,0.7924,913,6030474,0.6721,3916,5115298,0.0013,30,10215
2021-12-28,Brazil,203070494,Santa Catarina,7610361,0.7926,1183,6031657,0.6727,4540,5119838,0.0014,61,10276
2021-12-29,Brazil,203070494,Santa Catarina,7610361,0.7927,1127,6032784,0.6733,4116,5123954,0.0014,35,10311
2021-12-30,Brazil,203070494,Santa Catarina,7610361,0.7928,721,6033505,0.6737,3310,5127264,0.0014,23,10334
2021-12-31,Brazil,203070494,Santa Catarina,7610361,0.7928,30,6033535,0.6737,76,5127340,0.0014,0,10334
2021-01-03,Brazil,203070494,Sergipe,2210004,0.0000,0,0,0.0000,1,1,0.0000,0,0
2021-01-12,Brazil,203070494,Sergipe,2210004,0.0000,1,1,0.0000,0,1,0.0000,0,0
2021-01-14,Brazil,203070494,Sergipe,2210004,0.0000,1,2,0.0000,0,1,0.0000,0,0
2021-01-17,Brazil,203070494,Sergipe,2210004,0.0000,9,11,0.0000,3,4,0.0000,0,0
2021-01-18,Brazil,203070494,Sergipe,2210004,0.0000,25,36,0.0000,3,7,0.0000,0,0
2021-01-19,Brazil,203070494,Sergipe,2210004,0.0004,809,845,0.0000,0,7,0.0000,0,0
2021-01-20,Brazil,203070494,Sergipe,2210004,0.0020,3573,4418,0.0000,4,11,0.0000,0,0
2021-01-21,Brazil,203070494,Sergipe,2210004,0.0037,3671,8089,0.0000,1,12,0.0000,0,0
2021-01-22,Brazil,203070494,Sergipe,2210004,0.0048,2409,10498,0.0000,9,21,0.0000,0,0
2021-01-23,Brazil,203070494,Sergipe,2210004,0.0048,168,10666,0.0000,1,22,0.0000,0,0
2021-01-24,Brazil,203070494,Sergipe,2210004,0.0048,13,10679,0.0000,1,23,0.0000,0,0
2021-01-25,Brazil,203070494,Sergipe,2210004,0.0059,2451,13130,0.0000,1,24,0.0000,0,0
2021-01-26,Brazil,203070494,Sergipe,2210004,0.0070,2435,15565,0.0000,3,27,0.0000,0,0
2021-01-27,Brazil,203070494,Sergipe,2210004,0.0079,1824,17389,0.0000,2,29,0.0000,0,0
2021-01-28,Brazil,203070494,Sergipe,2210004,0.0085,1440,18829,0.0000,3,32,0.0000,0,0
2021-01-29,Brazil,203070494,Sergipe,2210004,0.0091,1320,20149,0.0000,1,33,0.0000,0,0
2021-01-30,Brazil,203070494,Sergipe,2210004,0.0091,18,20167,0.0000,1,34,0.0000,0,0
2021-01-31,Brazil,203070494,Sergipe,2210004,0.0091,9,20176,0.0000,0,34,0.0000,0,0
2021-02-01,Brazil,203070494,Sergipe,2210004,0.0096,1068,21244,0.0000,0,34,0.0000,0,0
2021-02-02,Brazil,203070494,Sergipe,2210004,0.0104,1699,22943,0.0000,6,40,0.0000,0,0
2021-02-03,Brazil,203070494,Sergipe,2210004,0.0111,1628,24571,0.0000,30,70,0.0000,0,0
2021-02-04,Brazil,203070494,Sergipe,2210004,0.0118,1527,26098,0.0000,21,91,0.0000,0,0
2021-02-05,Brazil,203070494,Sergipe,2210004,0.0123,1101,27199,0.0001,24,115,0.0000,0,0
2021-02-06,Brazil,203070494,Sergipe,2210004,0.0132,1876,29075,0.0001,12,127,0.0000,0,0
2021-02-07,Brazil,203070494,Sergipe,2210004,0.0132,32,29107,0.0001,1,128,0.0000,0,0
2021-02-08,Brazil,203070494,Sergipe,2210004,0.0135,723,29830,0.0001,39,167,0.0000,0,0
2021-02-09,Brazil,203070494,Sergipe,2210004,0.0138,698,30528,0.0003,491,658,0.0000,0,0
2021-02-10,Brazil,203070494,Sergipe,2210004,0.0150,2676,33204,0.0015,2696,3354,0.0000,0,0
2021-02-11,Brazil,203070494,Sergipe,2210004,0.0164,3109,36313,0.0030,3292,6646,0.0000,0,0
2021-02-12,Brazil,203070494,Sergipe,2210004,0.0175,2326,38639,0.0042,2568,9214,0.0000,0,0
2021-02-13,Brazil,203070494,Sergipe,2210004,0.0179,837,39476,0.0042,161,9375,0.0000,0,0
2021-02-14,Brazil,203070494,Sergipe,2210004,0.0179,29,39505,0.0042,12,9387,0.0000,0,0
2021-02-15,Brazil,203070494,Sergipe,2210004,0.0183,969,40474,0.0048,1143,10530,0.0000,0,0
2021-02-16,Brazil,203070494,Sergipe,2210004,0.0186,574,41048,0.0052,958,11488,0.0000,0,0
2021-02-17,Brazil,203070494,Sergipe,2210004,0.0188,519,41567,0.0058,1393,12881,0.0000,0,0
2021-02-18,Brazil,203070494,Sergipe,2210004,0.0192,941,42508,0.0074,3563,16444,0.0000,0,0
2021-02-19,Brazil,203070494,Sergipe,2210004,0.0196,916,43424,0.0082,1747,18191,0.0000,0,0
2021-02-20,Brazil,203070494,Sergipe,2210004,0.0197,105,43529,0.0083,125,18316,0.0000,0,0
2021-02-21,Brazil,203070494,Sergipe,2210004,0.0197,15,43544,0.0083,8,18324,0.0000,0,0
2021-02-22,Brazil,203070494,Sergipe,2210004,0.0201,815,44359,0.0087,911,19235,0.0000,0,0
2021-02-23,Brazil,203070494,Sergipe,2210004,0.0204,626,44985,0.0092,1098,20333,0.0000,0,0
2021-02-24,Brazil,203070494,Sergipe,2210004,0.0206,498,45483,0.0098,1241,21574,0.0000,0,0
2021-02-25,Brazil,203070494,Sergipe,2210004,0.0208,441,45924,0.0100,628,22202,0.0000,0,0
2021-02-26,Brazil,203070494,Sergipe,2210004,0.0210,403,46327,0.0102,447,22649,0.0000,0,0
2021-02-27,Brazil,203070494,Sergipe,2210004,0.0210,35,46362,0.0103,43,22692,0.0000,0,0
2021-02-28,Brazil,203070494,Sergipe,2210004,0.0210,6,46368,0.0103,5,22697,0.0000,0,0
2021-03-01,Brazil,203070494,Sergipe,2210004,0.0211,284,46652,0.0105,523,23220,0.0000,0,0
2021-03-02,Brazil,203070494,Sergipe,2210004,0.0237,5692,52344,0.0108,627,23847,0.0000,0,0
2021-03-03,Brazil,203070494,Sergipe,2210004,0.0261,5345,57689,0.0114,1410,25257,0.0000,0,0
2021-03-04,Brazil,203070494,Sergipe,2210004,0.0294,7232,64921,0.0120,1271,26528,0.0000,0,0
2021-03-05,Brazil,203070494,Sergipe,2210004,0.0325,6943,71864,0.0126,1293,27821,0.0000,0,0
2021-03-06,Brazil,203070494,Sergipe,2210004,0.0335,2103,73967,0.0127,300,28121,0.0000,0,0
2021-03-07,Brazil,203070494,Sergipe,2210004,0.0337,457,74424,0.0127,4,28125,0.0000,0,0
2021-03-08,Brazil,203070494,Sergipe,2210004,0.0352,3403,77827,0.0131,895,29020,0.0000,0,0
2021-03-09,Brazil,203070494,Sergipe,2210004,0.0379,5922,83749,0.0135,867,29887,0.0000,0,0
2021-03-10,Brazil,203070494,Sergipe,2210004,0.0395,3478,87227,0.0138,543,30430,0.0000,0,0
2021-03-11,Brazil,203070494,Sergipe,2210004,0.0405,2334,89561,0.0140,502,30932,0.0000,0,0
2021-03-12,Brazil,203070494,Sergipe,2210004,0.0421,3574,93135,0.0142,410,31342,0.0000,0,0
2021-03-13,Brazil,203070494,Sergipe,2210004,0.0427,1193,94328,0.0142,21,31363,0.0000,0,0
2021-03-14,Brazil,203070494,Sergipe,2210004,0.0427,5,94333,0.0142,27,31390,0.0000,0,0
2021-03-15,Brazil,203070494,Sergipe,2210004,0.0442,3396,97729,0.0145,738,32128,0.0000,0,0
2021-03-16,Brazil,203070494,Sergipe,2210004,0.0452,2245,99974,0.0147,380,32508,0.0000,0,0
2021-03-17,Brazil,203070494,Sergipe,2210004,0.0457,961,100935,0.0148,223,32731,0.0000,0,0
2021-03-18,Brazil,203070494,Sergipe,2210004,0.0461,872,101807,0.0149,233,32964,0.0000,0,0
2021-03-19,Brazil,203070494,Sergipe,2210004,0.0478,3754,105561,0.0150,291,33255,0.0000,0,0
2021-03-20,Brazil,203070494,Sergipe,2210004,0.0485,1599,107160,0.0151,10,33265,0.0000,0,0
2021-03-21,Brazil,203070494,Sergipe,2210004,0.0485,93,107253,0.0151,5,33270,0.0000,0,0
2021-03-22,Brazil,203070494,Sergipe,2210004,0.0511,5670,112923,0.0153,483,33753,0.0000,0,0
2021-03-23,Brazil,203070494,Sergipe,2210004,0.0539,6139,119062,0.0161,1734,35487,0.0000,0,0
2021-03-24,Brazil,203070494,Sergipe,2210004,0.0590,11400,130462,0.0168,1688,37175,0.0000,0,0
2021-03-25,Brazil,203070494,Sergipe,2210004,0.0643,11685,142147,0.0177,1878,39053,0.0000,0,0
2021-03-26,Brazil,203070494,Sergipe,2210004,0.0687,9776,151923,0.0185,1772,40825,0.0000,0,0
2021-03-27,Brazil,203070494,Sergipe,2210004,0.0702,3184,155107,0.0188,633,41458,0.0000,0,0
2021-03-28,Brazil,203070494,Sergipe,2210004,0.0709,1630,156737,0.0188,65,41523,0.0000,0,0
2021-03-29,Brazil,203070494,Sergipe,2210004,0.0747,8436,165173,0.0195,1653,43176,0.0000,0,0
2021-03-30,Brazil,203070494,Sergipe,2210004,0.0819,15920,181093,0.0209,2917,46093,0.0000,0,0
2021-03-31,Brazil,203070494,Sergipe,2210004,0.0871,11427,192520,0.0222,2967,49060,0.0000,0,0
2021-04-01,Brazil,203070494,Sergipe,2210004,0.0884,2882,195402,0.0226,934,49994,0.0000,0,0
2021-04-02,Brazil,203070494,Sergipe,2210004,0.0899,3316,198718,0.0231,1165,51159,0.0000,0,0
2021-04-03,Brazil,203070494,Sergipe,2210004,0.0912,2888,201606,0.0235,776,51935,0.0000,0,0
2021-04-04,Brazil,203070494,Sergipe,2210004,0.0918,1223,202829,0.0236,138,52073,0.0000,0,0
2021-04-05,Brazil,203070494,Sergipe,2210004,0.0951,7378,210207,0.0255,4183,56256,0.0000,0,0
2021-04-06,Brazil,203070494,Sergipe,2210004,0.0994,9502,219709,0.0266,2523,58779,0.0000,0,0
2021-04-07,Brazil,203070494,Sergipe,2210004,0.1039,10018,229727,0.0273,1514,60293,0.0000,0,0
2021-04-08,Brazil,203070494,Sergipe,2210004,0.1064,5409,235136,0.0280,1510,61803,0.0000,0,0
2021-04-09,Brazil,203070494,Sergipe,2210004,0.1083,4203,239339,0.0295,3454,65257,0.0000,0,0
2021-04-10,Brazil,203070494,Sergipe,2210004,0.1091,1694,241033,0.0299,878,66135,0.0000,0,0
2021-04-11,Brazil,203070494,Sergipe,2210004,0.1102,2553,243586,0.0300,78,66213,0.0000,0,0
2021-04-12,Brazil,203070494,Sergipe,2210004,0.1142,8848,252434,0.0322,4980,71193,0.0000,0,0
2021-04-13,Brazil,203070494,Sergipe,2210004,0.1189,10296,262730,0.0347,5562,76755,0.0000,0,0
2021-04-14,Brazil,203070494,Sergipe,2210004,0.1216,6049,268779,0.0389,9176,85931,0.0000,0,0
2021-04-15,Brazil,203070494,Sergipe,2210004,0.1231,3180,271959,0.0437,10582,96513,0.0000,0,0
2021-04-16,Brazil,203070494,Sergipe,2210004,0.1240,1989,273948,0.0468,6902,103415,0.0000,0,0
2021-04-17,Brazil,203070494,Sergipe,2210004,0.1244,994,274942,0.0476,1749,105164,0.0000,0,0
2021-04-18,Brazil,203070494,Sergipe,2210004,0.1256,2579,277521,0.0481,1055,106219,0.0000,0,0
2021-04-19,Brazil,203070494,Sergipe,2210004,0.1289,7357,284878,0.0514,7282,113501,0.0000,0,0
2021-04-20,Brazil,203070494,Sergipe,2210004,0.1323,7524,292402,0.0566,11524,125025,0.0000,0,0
2021-04-21,Brazil,203070494,Sergipe,2210004,0.1331,1702,294104,0.0579,2946,127971,0.0000,0,0
2021-04-22,Brazil,203070494,Sergipe,2210004,0.1352,4782,298886,0.0609,6601,134572,0.0000,0,0
2021-04-23,Brazil,203070494,Sergipe,2210004,0.1365,2831,301717,0.0616,1556,136128,0.0000,0,0
2021-04-24,Brazil,203070494,Sergipe,2210004,0.1376,2457,304174,0.0618,353,136481,0.0000,0,0
2021-04-25,Brazil,203070494,Sergipe,2210004,0.1378,290,304464,0.0618,47,136528,0.0000,0,0
2021-04-26,Brazil,203070494,Sergipe,2210004,0.1408,6803,311267,0.0627,1939,138467,0.0000,0,0
2021-04-27,Brazil,203070494,Sergipe,2210004,0.1433,5322,316589,0.0636,2149,140616,0.0000,0,0
2021-04-28,Brazil,203070494,Sergipe,2210004,0.1450,3934,320523,0.0644,1678,142294,0.0000,0,0
2021-04-29,Brazil,203070494,Sergipe,2210004,0.1462,2610,323133,0.0648,895,143189,0.0000,0,0
2021-04-30,Brazil,203070494,Sergipe,2210004,0.1471,1933,325066,0.0652,927,144116,0.0000,0,0
2021-05-01,Brazil,203070494,Sergipe,2210004,0.1472,292,325358,0.0653,237,144353,0.0000,0,0
2021-05-02,Brazil,203070494,Sergipe,2210004,0.1473,237,325595,0.0653,56,144409,0.0000,0,0
2021-05-03,Brazil,203070494,Sergipe,2210004,0.1484,2388,327983,0.0662,1927,146336,0.0000,0,0
2021-05-04,Brazil,203070494,Sergipe,2210004,0.1499,3247,331230,0.0681,4140,150476,0.0000,0,0
2021-05-05,Brazil,203070494,Sergipe,2210004,0.1518,4154,335384,0.0695,3161,153637,0.0000,0,0
2021-05-06,Brazil,203070494,Sergipe,2210004,0.1538,4531,339915,0.0700,990,154627,0.0000,0,0
2021-05-07,Brazil,203070494,Sergipe,2210004,0.1560,4871,344786,0.0709,2100,156727,0.0000,0,0
2021-05-08,Brazil,203070494,Sergipe,2210004,0.1565,1084,345870,0.0710,180,156907,0.0000,0,0
2021-05-09,Brazil,203070494,Sergipe,2210004,0.1567,395,346265,0.0710,25,156932,0.0000,0,0
2021-05-10,Brazil,203070494,Sergipe,2210004,0.1588,4721,350986,0.0722,2576,159508,0.0000,0,0
2021-05-11,Brazil,203070494,Sergipe,2210004,0.1618,6494,357480,0.0743,4590,164098,0.0000,0,0
2021-05-12,Brazil,203070494,Sergipe,2210004,0.1644,5783,363263,0.0760,3786,167884,0.0000,0,0
2021-05-13,Brazil,203070494,Sergipe,2210004,0.1670,5729,368992,0.0777,3853,171737,0.0000,0,0
2021-05-14,Brazil,203070494,Sergipe,2210004,0.1693,5116,374108,0.0791,3183,174920,0.0000,0,0
2021-05-15,Brazil,203070494,Sergipe,2210004,0.1702,1993,376101,0.0804,2816,177736,0.0000,0,0
2021-05-16,Brazil,203070494,Sergipe,2210004,0.1708,1330,377431,0.0809,944,178680,0.0000,0,0
2021-05-17,Brazil,203070494,Sergipe,2210004,0.1735,5925,383356,0.0824,3496,182176,0.0000,0,0
2021-05-18,Brazil,203070494,Sergipe,2210004,0.1772,8344,391700,0.0838,2919,185095,0.0000,0,0
2021-05-19,Brazil,203070494,Sergipe,2210004,0.1812,8719,400419,0.0844,1471,186566,0.0000,0,0
2021-05-20,Brazil,203070494,Sergipe,2210004,0.1856,9699,410118,0.0849,983,187549,0.0000,0,0
2021-05-21,Brazil,203070494,Sergipe,2210004,0.1888,7183,417301,0.0851,416,187965,0.0000,0,0
2021-05-22,Brazil,203070494,Sergipe,2210004,0.1894,1317,418618,0.0851,81,188046,0.0000,0,0
2021-05-23,Brazil,203070494,Sergipe,2210004,0.1896,439,419057,0.0851,7,188053,0.0000,0,0
2021-05-24,Brazil,203070494,Sergipe,2210004,0.1922,5810,424867,0.0854,636,188689,0.0000,0,0
2021-05-25,Brazil,203070494,Sergipe,2210004,0.1972,11030,435897,0.0856,584,189273,0.0000,0,0
2021-05-26,Brazil,203070494,Sergipe,2210004,0.2018,10094,445991,0.0859,674,189947,0.0000,0,0
2021-05-27,Brazil,203070494,Sergipe,2210004,0.2057,8590,454581,0.0862,595,190542,0.0000,0,0
2021-05-28,Brazil,203070494,Sergipe,2210004,0.2085,6245,460826,0.0863,271,190813,0.0000,0,0
2021-05-29,Brazil,203070494,Sergipe,2210004,0.2091,1317,462143,0.0864,53,190866,0.0000,0,0
2021-05-30,Brazil,203070494,Sergipe,2210004,0.2095,793,462936,0.0864,19,190885,0.0000,0,0
2021-05-31,Brazil,203070494,Sergipe,2210004,0.2128,7353,470289,0.0868,1005,191890,0.0000,0,0
2021-06-01,Brazil,203070494,Sergipe,2210004,0.2182,12016,482305,0.0880,2513,194403,0.0000,0,0
2021-06-02,Brazil,203070494,Sergipe,2210004,0.2238,12395,494700,0.0898,4025,198428,0.0000,0,0
2021-06-03,Brazil,203070494,Sergipe,2210004,0.2251,2723,497423,0.0905,1666,200094,0.0000,0,0
2021-06-04,Brazil,203070494,Sergipe,2210004,0.2282,6975,504398,0.0919,3018,203112,0.0000,0,0
2021-06-05,Brazil,203070494,Sergipe,2210004,0.2303,4469,508867,0.0925,1295,204407,0.0000,0,0
2021-06-06,Brazil,203070494,Sergipe,2210004,0.2312,2107,510974,0.0928,620,205027,0.0000,0,0
2021-06-07,Brazil,203070494,Sergipe,2210004,0.2366,11826,522800,0.0940,2781,207808,0.0000,0,0
2021-06-08,Brazil,203070494,Sergipe,2210004,0.2432,14576,537376,0.0953,2872,210680,0.0000,0,0
2021-06-09,Brazil,203070494,Sergipe,2210004,0.2502,15514,552890,0.0964,2358,213038,0.0000,0,0
2021-06-10,Brazil,203070494,Sergipe,2210004,0.2573,15775,568665,0.0970,1415,214453,0.0000,0,0
2021-06-11,Brazil,203070494,Sergipe,2210004,0.2641,14988,583653,0.0974,778,215231,0.0000,0,0
2021-06-12,Brazil,203070494,Sergipe,2210004,0.2695,11913,595566,0.0975,242,215473,0.0000,0,0
2021-06-13,Brazil,203070494,Sergipe,2210004,0.2727,7014,602580,0.0975,63,215536,0.0000,0,0
2021-06-14,Brazil,203070494,Sergipe,2210004,0.2817,20018,622598,0.0977,407,215943,0.0000,0,0
2021-06-15,Brazil,203070494,Sergipe,2210004,0.2909,20342,642940,0.0979,338,216281,0.0000,0,0
2021-06-16,Brazil,203070494,Sergipe,2210004,0.2996,19125,662065,0.0980,369,216650,0.0000,0,0
2021-06-17,Brazil,203070494,Sergipe,2210004,0.3064,15063,677128,0.0982,263,216913,0.0000,0,0
2021-06-18,Brazil,203070494,Sergipe,2210004,0.3122,12855,689983,0.0983,251,217164,0.0000,0,0
2021-06-19,Brazil,203070494,Sergipe,2210004,0.3173,11166,701149,0.0983,42,217206,0.0000,0,0
2021-06-20,Brazil,203070494,Sergipe,2210004,0.3231,12994,714143,0.0983,33,217239,0.0000,0,0
2021-06-21,Brazil,203070494,Sergipe,2210004,0.3311,17479,731622,0.0985,384,217623,0.0000,0,0
2021-06-22,Brazil,203070494,Sergipe,2210004,0.3350,8642,740264,0.0995,2251,219874,0.0000,0,0
2021-06-23,Brazil,203070494,Sergipe,2210004,0.3359,1988,742252,0.1000,1146,221020,0.0000,0,0
2021-06-24,Brazil,203070494,Sergipe,2210004,0.3359,116,742368,0.1003,639,221659,0.0000,0,0
2021-06-25,Brazil,203070494,Sergipe,2210004,0.3364,1187,743555,0.1007,942,222601,0.0000,0,0
2021-06-26,Brazil,203070494,Sergipe,2210004,0.3413,10785,754340,0.1010,582,223183,0.0000,0,0
2021-06-27,Brazil,203070494,Sergipe,2210004,0.3449,7910,762250,0.1012,558,223741,0.0000,0,0
2021-06-28,Brazil,203070494,Sergipe,2210004,0.3514,14260,776510,0.1020,1703,225444,0.0000,0,0
2021-06-29,Brazil,203070494,Sergipe,2210004,0.3531,3756,780266,0.1026,1324,226768,0.0000,0,0
2021-06-30,Brazil,203070494,Sergipe,2210004,0.3577,10251,790517,0.1036,2192,228960,0.0000,0,0
2021-07-01,Brazil,203070494,Sergipe,2210004,0.3616,8687,799204,0.1044,1731,230691,0.0000,0,0
2021-07-02,Brazil,203070494,Sergipe,2210004,0.3663,10425,809629,0.1051,1475,232166,0.0000,0,0
2021-07-03,Brazil,203070494,Sergipe,2210004,0.3721,12798,822427,0.1053,636,232802,0.0000,0,0
2021-07-04,Brazil,203070494,Sergipe,2210004,0.3765,9552,831979,0.1059,1204,234006,0.0000,0,0
2021-07-05,Brazil,203070494,Sergipe,2210004,0.3841,16986,848965,0.1074,3437,237443,0.0000,0,0
2021-07-06,Brazil,203070494,Sergipe,2210004,0.3949,23761,872726,0.1090,3360,240803,0.0000,0,0
2021-07-07,Brazil,203070494,Sergipe,2210004,0.4025,16714,889440,0.1105,3327,244130,0.0000,0,0
2021-07-08,Brazil,203070494,Sergipe,2210004,0.4065,8820,898260,0.1110,1200,245330,0.0000,0,0
2021-07-09,Brazil,203070494,Sergipe,2210004,0.4088,5267,903527,0.1119,2048,247378,0.0000,0,0
2021-07-10,Brazil,203070494,Sergipe,2210004,0.4120,6890,910417,0.1128,1939,249317,0.0000,0,0
2021-07-11,Brazil,203070494,Sergipe,2210004,0.4129,2184,912601,0.1136,1789,251106,0.0000,0,0
2021-07-12,Brazil,203070494,Sergipe,2210004,0.4177,10556,923157,0.1162,5638,256744,0.0000,0,0
2021-07-13,Brazil,203070494,Sergipe,2210004,0.4200,4946,928103,0.1190,6354,263098,0.0000,0,0
2021-07-14,Brazil,203070494,Sergipe,2210004,0.4214,3102,931205,0.1204,2947,266045,0.0000,0,0
2021-07-15,Brazil,203070494,Sergipe,2210004,0.4221,1608,932813,0.1214,2144,268189,0.0000,0,0
2021-07-16,Brazil,203070494,Sergipe,2210004,0.4235,3222,936035,0.1221,1564,269753,0.0000,0,0
2021-07-17,Brazil,203070494,Sergipe,2210004,0.4287,11385,947420,0.1232,2604,272357,0.0000,0,0
2021-07-18,Brazil,203070494,Sergipe,2210004,0.4301,3094,950514,0.1241,1972,274329,0.0000,0,0
2021-07-19,Brazil,203070494,Sergipe,2210004,0.4354,11720,962234,0.1275,7475,281804,0.0000,0,0
2021-07-20,Brazil,203070494,Sergipe,2210004,0.4399,9851,972085,0.1307,7099,288903,0.0000,0,0
2021-07-21,Brazil,203070494,Sergipe,2210004,0.4422,5283,977368,0.1325,3885,292788,0.0000,0,0
2021-07-22,Brazil,203070494,Sergipe,2210004,0.4458,7950,985318,0.1343,4027,296815,0.0000,0,0
2021-07-23,Brazil,203070494,Sergipe,2210004,0.4543,18654,1003972,0.1356,2808,299623,0.0000,0,0
2021-07-24,Brazil,203070494,Sergipe,2210004,0.4561,3973,1007945,0.1378,4995,304618,0.0000,0,0
2021-07-25,Brazil,203070494,Sergipe,2210004,0.4567,1366,1009311,0.1385,1384,306002,0.0000,0,0
2021-07-26,Brazil,203070494,Sergipe,2210004,0.4619,11484,1020795,0.1416,6895,312897,0.0000,0,0
2021-07-27,Brazil,203070494,Sergipe,2210004,0.4647,6264,1027059,0.1449,7349,320246,0.0000,0,0
2021-07-28,Brazil,203070494,Sergipe,2210004,0.4677,6534,1033593,0.1480,6768,327014,0.0000,0,0
2021-07-29,Brazil,203070494,Sergipe,2210004,0.4705,6256,1039849,0.1497,3799,330813,0.0000,0,0
2021-07-30,Brazil,203070494,Sergipe,2210004,0.4764,12909,1052758,0.1509,2776,333589,0.0000,0,0
2021-07-31,Brazil,203070494,Sergipe,2210004,0.4781,3778,1056536,0.1516,1388,334977,0.0000,0,0
2021-08-01,Brazil,203070494,Sergipe,2210004,0.4789,1762,1058298,0.1520,950,335927,0.0000,0,0
2021-08-02,Brazil,203070494,Sergipe,2210004,0.4825,8112,1066410,0.1539,4106,340033,0.0000,0,0
2021-08-03,Brazil,203070494,Sergipe,2210004,0.4927,22561,1088971,0.1564,5669,345702,0.0000,0,0
2021-08-04,Brazil,203070494,Sergipe,2210004,0.4994,14680,1103651,0.1591,5929,351631,0.0000,0,0
2021-08-05,Brazil,203070494,Sergipe,2210004,0.5035,9149,1112800,0.1616,5609,357240,0.0000,0,0
2021-08-06,Brazil,203070494,Sergipe,2210004,0.5066,6766,1119566,0.1640,5302,362542,0.0000,0,0
2021-08-07,Brazil,203070494,Sergipe,2210004,0.5110,9743,1129309,0.1648,1612,364154,0.0000,0,0
2021-08-08,Brazil,203070494,Sergipe,2210004,0.5119,1939,1131248,0.1650,543,364697,0.0000,0,0
2021-08-09,Brazil,203070494,Sergipe,2210004,0.5171,11468,1142716,0.1677,5913,370610,0.0000,0,0
2021-08-10,Brazil,203070494,Sergipe,2210004,0.5252,17942,1160658,0.1706,6467,377077,0.0000,0,0
2021-08-11,Brazil,203070494,Sergipe,2210004,0.5371,26229,1186887,0.1735,6328,383405,0.0000,0,0
2021-08-12,Brazil,203070494,Sergipe,2210004,0.5450,17548,1204435,0.1761,5820,389225,0.0000,0,0
2021-08-13,Brazil,203070494,Sergipe,2210004,0.5513,14035,1218470,0.1781,4376,393601,0.0000,0,0
2021-08-14,Brazil,203070494,Sergipe,2210004,0.5548,7729,1226199,0.1799,3883,397484,0.0000,0,0
2021-08-15,Brazil,203070494,Sergipe,2210004,0.5552,808,1227007,0.1810,2533,400017,0.0000,0,0
2021-08-16,Brazil,203070494,Sergipe,2210004,0.5644,20287,1247294,0.1842,7058,407075,0.0000,0,0
2021-08-17,Brazil,203070494,Sergipe,2210004,0.5725,17906,1265200,0.1885,9417,416492,0.0000,0,0
2021-08-18,Brazil,203070494,Sergipe,2210004,0.5866,31126,1296326,0.1926,9071,425563,0.0000,0,0
2021-08-19,Brazil,203070494,Sergipe,2210004,0.5934,15114,1311440,0.1967,9173,434736,0.0000,0,0
2021-08-20,Brazil,203070494,Sergipe,2210004,0.6035,22366,1333806,0.2007,8808,443544,0.0000,0,0
2021-08-21,Brazil,203070494,Sergipe,2210004,0.6101,14464,1348270,0.2016,1945,445489,0.0000,0,0
2021-08-22,Brazil,203070494,Sergipe,2210004,0.6142,9072,1357342,0.2018,552,446041,0.0000,0,0
2021-08-23,Brazil,203070494,Sergipe,2210004,0.6225,18479,1375821,0.2057,8524,454565,0.0000,0,0
2021-08-24,Brazil,203070494,Sergipe,2210004,0.6318,20434,1396255,0.2110,11716,466281,0.0000,0,0
2021-08-25,Brazil,203070494,Sergipe,2210004,0.6416,21605,1417860,0.2156,10280,476561,0.0000,0,0
2021-08-26,Brazil,203070494,Sergipe,2210004,0.6491,16655,1434515,0.2200,9574,486135,0.0000,0,0
2021-08-27,Brazil,203070494,Sergipe,2210004,0.6557,14624,1449139,0.2246,10228,496363,0.0000,0,0
2021-08-28,Brazil,203070494,Sergipe,2210004,0.6564,1460,1450599,0.2267,4580,500943,0.0000,0,0
2021-08-29,Brazil,203070494,Sergipe,2210004,0.6564,143,1450742,0.2272,1200,502143,0.0000,0,0
2021-08-30,Brazil,203070494,Sergipe,2210004,0.6582,3856,1454598,0.2318,10167,512310,0.0000,0,0
2021-08-31,Brazil,203070494,Sergipe,2210004,0.6603,4745,1459343,0.2375,12570,524880,0.0000,0,0
2021-09-01,Brazil,203070494,Sergipe,2210004,0.6634,6755,1466098,0.2464,19726,544606,0.0000,0,0
2021-09-02,Brazil,203070494,Sergipe,2210004,0.6657,5210,1471308,0.2543,17435,562041,0.0000,0,0
2021-09-03,Brazil,203070494,Sergipe,2210004,0.6681,5115,1476423,0.2600,12625,574666,0.0000,0,0
2021-09-04,Brazil,203070494,Sergipe,2210004,0.6685,1039,1477462,0.2629,6307,580973,0.0000,0,0
2021-09-05,Brazil,203070494,Sergipe,2210004,0.6686,106,1477568,0.2635,1386,582359,0.0000,0,0
2021-09-06,Brazil,203070494,Sergipe,2210004,0.6695,1932,1479500,0.2665,6507,588866,0.0000,0,0
2021-09-07,Brazil,203070494,Sergipe,2210004,0.6695,153,1479653,0.2674,1990,590856,0.0000,0,0
2021-09-08,Brazil,203070494,Sergipe,2210004,0.6723,6072,1485725,0.2751,17200,608056,0.0000,0,0
2021-09-09,Brazil,203070494,Sergipe,2210004,0.6758,7864,1493589,0.2834,18299,626355,0.0000,0,0
2021-09-10,Brazil,203070494,Sergipe,2210004,0.6784,5777,1499366,0.2904,15410,641765,0.0000,0,0
2021-09-11,Brazil,203070494,Sergipe,2210004,0.6801,3651,1503017,0.2951,10359,652124,0.0000,0,0
2021-09-12,Brazil,203070494,Sergipe,2210004,0.6808,1507,1504524,0.2970,4245,656369,0.0000,0,0
2021-09-13,Brazil,203070494,Sergipe,2210004,0.6839,7002,1511526,0.3057,19120,675489,0.0000,0,0
2021-09-14,Brazil,203070494,Sergipe,2210004,0.6865,5651,1517177,0.3156,21926,697415,0.0000,0,0
2021-09-15,Brazil,203070494,Sergipe,2210004,0.6907,9271,1526448,0.3241,18932,716347,0.0000,0,0
2021-09-16,Brazil,203070494,Sergipe,2210004,0.6991,18510,1544958,0.3330,19683,736030,0.0000,0,0
2021-09-17,Brazil,203070494,Sergipe,2210004,0.7041,11180,1556138,0.3389,12903,748933,0.0000,0,0
2021-09-18,Brazil,203070494,Sergipe,2210004,0.7051,2181,1558319,0.3413,5431,754364,0.0000,0,0
2021-09-19,Brazil,203070494,Sergipe,2210004,0.7053,426,1558745,0.3425,2612,756976,0.0000,0,0
2021-09-20,Brazil,203070494,Sergipe,2210004,0.7083,6495,1565240,0.3475,11007,767983,0.0000,0,0
2021-09-21,Brazil,203070494,Sergipe,2210004,0.7146,13990,1579230,0.3553,17329,785312,0.0000,0,0
2021-09-22,Brazil,203070494,Sergipe,2210004,0.7179,7326,1586556,0.3625,15907,801219,0.0000,0,0
2021-09-23,Brazil,203070494,Sergipe,2210004,0.7204,5633,1592189,0.3678,11592,812811,0.0000,0,0
2021-09-24,Brazil,203070494,Sergipe,2210004,0.7220,3474,1595663,0.3709,6946,819757,0.0000,0,0
2021-09-25,Brazil,203070494,Sergipe,2210004,0.7264,9779,1605442,0.3736,5880,825637,0.0000,0,0
2021-09-26,Brazil,203070494,Sergipe,2210004,0.7265,32,1605474,0.3736,55,825692,0.0000,0,0
2021-09-27,Brazil,203070494,Sergipe,2210004,0.7301,8025,1613499,0.3790,11958,837650,0.0000,0,0
2021-09-28,Brazil,203070494,Sergipe,2210004,0.7337,8003,1621502,0.3845,12027,849677,0.0000,0,0
2021-09-29,Brazil,203070494,Sergipe,2210004,0.7368,6919,1628421,0.3897,11523,861200,0.0000,0,0
2021-09-30,Brazil,203070494,Sergipe,2210004,0.7424,12222,1640643,0.3971,16445,877645,0.0000,0,0
2021-10-01,Brazil,203070494,Sergipe,2210004,0.7462,8355,1648998,0.4029,12662,890307,0.0000,0,0
2021-10-02,Brazil,203070494,Sergipe,2210004,0.7472,2320,1651318,0.4062,7495,897802,0.0000,0,0
2021-10-03,Brazil,203070494,Sergipe,2210004,0.7472,20,1651338,0.4063,33,897835,0.0000,0,0
2021-10-04,Brazil,203070494,Sergipe,2210004,0.7502,6673,1658011,0.4119,12411,910246,0.0000,0,0
2021-10-05,Brazil,203070494,Sergipe,2210004,0.7530,6202,1664213,0.4185,14558,924804,0.0000,0,0
2021-10-06,Brazil,203070494,Sergipe,2210004,0.7552,4718,1668931,0.4245,13443,938247,0.0000,2,2
2021-10-07,Brazil,203070494,Sergipe,2210004,0.7566,3133,1672064,0.4289,9638,947885,0.0000,0,2
2021-10-08,Brazil,203070494,Sergipe,2210004,0.7576,2163,1674227,0.4322,7327,955212,0.0000,0,2
2021-10-09,Brazil,203070494,Sergipe,2210004,0.7578,615,1674842,0.4336,3030,958242,0.0000,0,2
2021-10-10,Brazil,203070494,Sergipe,2210004,0.7579,10,1674852,0.4336,26,958268,0.0000,0,2
2021-10-11,Brazil,203070494,Sergipe,2210004,0.7583,1051,1675903,0.4353,3689,961957,0.0000,0,2
2021-10-12,Brazil,203070494,Sergipe,2210004,0.7583,17,1675920,0.4353,44,962001,0.0000,0,2
2021-10-13,Brazil,203070494,Sergipe,2210004,0.7591,1775,1677695,0.4397,9727,971728,0.0000,0,2
2021-10-14,Brazil,203070494,Sergipe,2210004,0.7600,2015,1679710,0.4453,12383,984111,0.0000,0,2
2021-10-15,Brazil,203070494,Sergipe,2210004,0.7608,1671,1681381,0.4498,9993,994104,0.0000,0,2
2021-10-16,Brazil,203070494,Sergipe,2210004,0.7610,502,1681883,0.4508,2122,996226,0.0000,0,2
2021-10-17,Brazil,203070494,Sergipe,2210004,0.7610,10,1681893,0.4508,29,996255,0.0000,0,2
2021-10-18,Brazil,203070494,Sergipe,2210004,0.7617,1437,1683330,0.4586,17227,1013482,0.0000,0,2
2021-10-19,Brazil,203070494,Sergipe,2210004,0.7627,2130,1685460,0.4681,20940,1034422,0.0000,0,2
2021-10-20,Brazil,203070494,Sergipe,2210004,0.7637,2245,1687705,0.4765,18541,1052963,0.0000,0,2
2021-10-21,Brazil,203070494,Sergipe,2210004,0.7656,4246,1691951,0.4839,16565,1069528,0.0000,0,2
2021-10-22,Brazil,203070494,Sergipe,2210004,0.7671,3395,1695346,0.4905,14540,1084068,0.0000,0,2
2021-10-23,Brazil,203070494,Sergipe,2210004,0.7674,642,1695988,0.4915,2046,1086114,0.0000,0,2
2021-10-24,Brazil,203070494,Sergipe,2210004,0.7674,29,1696017,0.4915,35,1086149,0.0000,0,2
2021-10-25,Brazil,203070494,Sergipe,2210004,0.7689,3243,1699260,0.4976,13541,1099690,0.0000,0,2
2021-10-26,Brazil,203070494,Sergipe,2210004,0.7705,3551,1702811,0.5046,15428,1115118,0.0000,0,2
2021-10-27,Brazil,203070494,Sergipe,2210004,0.7716,2355,1705166,0.5109,13978,1129096,0.0000,0,2
2021-10-28,Brazil,203070494,Sergipe,2210004,0.7724,1802,1706968,0.5162,11768,1140864,0.0000,0,2
2021-10-29,Brazil,203070494,Sergipe,2210004,0.7729,1080,1708048,0.5198,7946,1148810,0.0000,0,2
2021-10-30,Brazil,203070494,Sergipe,2210004,0.7729,94,1708142,0.5206,1734,1150544,0.0000,0,2
2021-10-31,Brazil,203070494,Sergipe,2210004,0.7729,2,1708144,0.5206,31,1150575,0.0000,0,2
2021-11-01,Brazil,203070494,Sergipe,2210004,0.7729,74,1708218,0.5208,310,1150885,0.0000,0,2
2021-11-02,Brazil,203070494,Sergipe,2210004,0.7730,31,1708249,0.5208,73,1150958,0.0000,0,2
2021-11-03,Brazil,203070494,Sergipe,2210004,0.7737,1608,1709857,0.5264,12340,1163298,0.0000,0,2
2021-11-04,Brazil,203070494,Sergipe,2210004,0.7747,2145,1712002,0.5323,13151,1176449,0.0000,1,3
2021-11-05,Brazil,203070494,Sergipe,2210004,0.7759,2754,1714756,0.5366,9436,1185885,0.0000,0,3
2021-11-06,Brazil,203070494,Sergipe,2210004,0.7760,209,1714965,0.5370,800,1186685,0.0000,0,3
2021-11-07,Brazil,203070494,Sergipe,2210004,0.7760,39,1715004,0.5370,49,1186734,0.0000,0,3
2021-11-08,Brazil,203070494,Sergipe,2210004,0.7771,2284,1717288,0.5422,11607,1198341,0.0000,1,4
2021-11-09,Brazil,203070494,Sergipe,2210004,0.7783,2819,1720107,0.5483,13397,1211738,0.0000,0,4
2021-11-10,Brazil,203070494,Sergipe,2210004,0.7793,2195,1722302,0.5542,13082,1224820,0.0000,0,4
2021-11-11,Brazil,203070494,Sergipe,2210004,0.7801,1697,1723999,0.5606,14113,1238933,0.0000,0,4
2021-11-12,Brazil,203070494,Sergipe,2210004,0.7807,1446,1725445,0.5660,11944,1250877,0.0000,0,4
2021-11-13,Brazil,203070494,Sergipe,2210004,0.7808,69,1725514,0.5664,809,1251686,0.0000,0,4
2021-11-14,Brazil,203070494,Sergipe,2210004,0.7808,34,1725548,0.5664,62,1251748,0.0000,0,4
2021-11-15,Brazil,203070494,Sergipe,2210004,0.7808,80,1725628,0.5666,492,1252240,0.0000,0,4
2021-11-16,Brazil,203070494,Sergipe,2210004,0.7816,1601,1727229,0.5739,16083,1268323,0.0000,0,4
2021-11-17,Brazil,203070494,Sergipe,2210004,0.7829,2887,1730116,0.5817,17184,1285507,0.0000,0,4
2021-11-18,Brazil,203070494,Sergipe,2210004,0.7837,1774,1731890,0.5891,16467,1301974,0.0000,0,4
2021-11-19,Brazil,203070494,Sergipe,2210004,0.7844,1528,1733418,0.5949,12728,1314702,0.0000,0,4
2021-11-20,Brazil,203070494,Sergipe,2210004,0.7846,570,1733988,0.5978,6374,1321076,0.0000,0,4
2021-11-21,Brazil,203070494,Sergipe,2210004,0.7846,8,1733996,0.5978,129,1321205,0.0000,0,4
2021-11-22,Brazil,203070494,Sergipe,2210004,0.7851,1057,1735053,0.6024,10206,1331411,0.0000,0,4
2021-11-23,Brazil,203070494,Sergipe,2210004,0.7858,1608,1736661,0.6075,11232,1342643,0.0000,0,4
2021-11-24,Brazil,203070494,Sergipe,2210004,0.7869,2462,1739123,0.6128,11666,1354309,0.0000,0,4
2021-11-25,Brazil,203070494,Sergipe,2210004,0.7878,1944,1741067,0.6173,9922,1364231,0.0000,0,4
2021-11-26,Brazil,203070494,Sergipe,2210004,0.7884,1234,1742301,0.6204,6890,1371121,0.0000,0,4
2021-11-27,Brazil,203070494,Sergipe,2210004,0.7885,322,1742623,0.6207,712,1371833,0.0000,0,4
2021-11-28,Brazil,203070494,Sergipe,2210004,0.7885,1,1742624,0.6208,38,1371871,0.0000,0,4
2021-11-29,Brazil,203070494,Sergipe,2210004,0.7890,1131,1743755,0.6244,8014,1379885,0.0000,0,4
2021-11-30,Brazil,203070494,Sergipe,2210004,0.7898,1761,1745516,0.6292,10619,1390504,0.0000,0,4
2021-12-01,Brazil,203070494,Sergipe,2210004,0.7905,1550,1747066,0.6335,9522,1400026,0.0000,0,4
2021-12-02,Brazil,203070494,Sergipe,2210004,0.7916,2461,1749527,0.6375,8939,1408965,0.0000,0,4
2021-12-03,Brazil,203070494,Sergipe,2210004,0.7924,1739,1751266,0.6406,6798,1415763,0.0000,0,4
2021-12-04,Brazil,203070494,Sergipe,2210004,0.7925,159,1751425,0.6409,593,1416356,0.0000,0,4
2021-12-05,Brazil,203070494,Sergipe,2210004,0.7925,21,1751446,0.6409,31,1416387,0.0000,0,4
2021-12-06,Brazil,203070494,Sergipe,2210004,0.7933,1720,1753166,0.6437,6214,1422601,0.0000,0,4
2021-12-07,Brazil,203070494,Sergipe,2210004,0.7939,1433,1754599,0.6470,7300,1429901,0.0000,0,4
2021-12-08,Brazil,203070494,Sergipe,2210004,0.7943,863,1755462,0.6491,4539,1434440,0.0000,0,4
2021-12-09,Brazil,203070494,Sergipe,2210004,0.7949,1274,1756736,0.6520,6518,1440958,0.0000,0,4
2021-12-10,Brazil,203070494,Sergipe,2210004,0.7953,946,1757682,0.6542,4886,1445844,0.0000,0,4
2021-12-11,Brazil,203070494,Sergipe,2210004,0.7954,95,1757777,0.6545,508,1446352,0.0000,0,4
2021-12-12,Brazil,203070494,Sergipe,2210004,0.7954,23,1757800,0.6545,20,1446372,0.0000,0,4
2021-12-13,Brazil,203070494,Sergipe,2210004,0.7959,1213,1759013,0.6567,4854,1451226,0.0000,0,4
2021-12-14,Brazil,203070494,Sergipe,2210004,0.7965,1163,1760176,0.6592,5600,1456826,0.0000,0,4
2021-12-15,Brazil,203070494,Sergipe,2210004,0.7970,1134,1761310,0.6617,5484,1462310,0.0000,0,4
2021-12-16,Brazil,203070494,Sergipe,2210004,0.7974,940,1762250,0.6642,5593,1467903,0.0000,0,4
2021-12-17,Brazil,203070494,Sergipe,2210004,0.7977,723,1762973,0.6659,3734,1471637,0.0000,0,4
2021-12-18,Brazil,203070494,Sergipe,2210004,0.7977,40,1763013,0.6660,222,1471859,0.0000,0,4
2021-12-19,Brazil,203070494,Sergipe,2210004,0.7977,0,1763013,0.6660,31,1471890,0.0000,0,4
2021-12-20,Brazil,203070494,Sergipe,2210004,0.7981,748,1763761,0.6678,3922,1475812,0.0000,0,4
2021-12-21,Brazil,203070494,Sergipe,2210004,0.7984,687,1764448,0.6697,4284,1480096,0.0000,0,4
2021-12-22,Brazil,203070494,Sergipe,2210004,0.7987,619,1765067,0.6716,4153,1484249,0.0000,0,4
2021-12-23,Brazil,203070494,Sergipe,2210004,0.7988,355,1765422,0.6728,2563,1486812,0.0000,0,4
2021-12-24,Brazil,203070494,Sergipe,2210004,0.7988,16,1765438,0.6728,59,1486871,0.0000,0,4
2021-12-25,Brazil,203070494,Sergipe,2210004,0.7988,1,1765439,0.6728,17,1486888,0.0000,0,4
2021-12-26,Brazil,203070494,Sergipe,2210004,0.7988,2,1765441,0.6728,4,1486892,0.0000,0,4
2021-12-27,Brazil,203070494,Sergipe,2210004,0.7990,365,1765806,0.6738,2313,1489205,0.0000,0,4
2021-12-28,Brazil,203070494,Sergipe,2210004,0.7992,390,1766196,0.6750,2577,1491782,0.0000,0,4
2021-12-29,Brazil,203070494,Sergipe,2210004,0.7993,305,1766501,0.6760,2235,1494017,0.0000,0,4
2021-12-30,Brazil,203070494,Sergipe,2210004,0.7994,168,1766669,0.6766,1298,1495315,0.0000,0,4
2021-12-31,Brazil,203070494,Sergipe,2210004,0.7994,4,1766673,0.6766,13,1495328,0.0000,0,4
2021-01-02,Brazil,203070494,São Paulo,44411238,0.0000,0,0,0.0000,1,1,0.0000,0,0
2021-01-03,Brazil,203070494,São Paulo,44411238,0.0000,1,1,0.0000,1,2,0.0000,0,0
2021-01-04,Brazil,203070494,São Paulo,44411238,0.0000,0,1,0.0000,12,14,0.0000,0,0
2021-01-05,Brazil,203070494,São Paulo,44411238,0.0000,2,3,0.0000,13,27,0.0000,0,0
2021-01-06,Brazil,203070494,São Paulo,44411238,0.0000,1,4,0.0000,10,37,0.0000,0,0
2021-01-07,Brazil,203070494,São Paulo,44411238,0.0000,0,4,0.0000,6,43,0.0000,0,0
2021-01-08,Brazil,203070494,São Paulo,44411238,0.0000,1,5,0.0000,5,48,0.0000,0,0
2021-01-09,Brazil,203070494,São Paulo,44411238,0.0000,0,5,0.0000,6,54,0.0000,0,0
2021-01-10,Brazil,203070494,São Paulo,44411238,0.0000,1,6,0.0000,1,55,0.0000,0,0
2021-01-11,Brazil,203070494,São Paulo,44411238,0.0000,2,8,0.0000,2,57,0.0000,0,0
2021-01-12,Brazil,203070494,São Paulo,44411238,0.0000,1,9,0.0000,13,70,0.0000,0,0
2021-01-13,Brazil,203070494,São Paulo,44411238,0.0000,2,11,0.0000,1,71,0.0000,0,0
2021-01-14,Brazil,203070494,São Paulo,44411238,0.0000,0,11,0.0000,0,71,0.0000,0,0
2021-01-16,Brazil,203070494,São Paulo,44411238,0.0000,1,12,0.0000,1,72,0.0000,0,0
2021-01-17,Brazil,203070494,São Paulo,44411238,0.0000,362,374,0.0000,35,107,0.0000,0,0
2021-01-18,Brazil,203070494,São Paulo,44411238,0.0000,1307,1681,0.0000,12,119,0.0000,0,0
2021-01-19,Brazil,203070494,São Paulo,44411238,0.0003,9460,11141,0.0000,23,142,0.0000,0,0
2021-01-20,Brazil,203070494,São Paulo,44411238,0.0009,30377,41518,0.0000,52,194,0.0000,0,0
2021-01-21,Brazil,203070494,São Paulo,44411238,0.0030,90433,131951,0.0000,203,397,0.0000,0,0
2021-01-22,Brazil,203070494,São Paulo,44411238,0.0060,134729,266680,0.0000,313,710,0.0000,0,0
2021-01-23,Brazil,203070494,São Paulo,44411238,0.0067,31512,298192,0.0000,60,770,0.0000,0,0
2021-01-24,Brazil,203070494,São Paulo,44411238,0.0070,10491,308683,0.0000,28,798,0.0000,0,0
2021-01-25,Brazil,203070494,São Paulo,44411238,0.0082,54046,362729,0.0000,84,882,0.0000,0,0
2021-01-26,Brazil,203070494,São Paulo,44411238,0.0094,55666,418395,0.0000,111,993,0.0000,0,0
2021-01-27,Brazil,203070494,São Paulo,44411238,0.0110,72075,490470,0.0000,100,1093,0.0000,0,0
2021-01-28,Brazil,203070494,São Paulo,44411238,0.0133,99661,590131,0.0000,119,1212,0.0000,0,0
2021-01-29,Brazil,203070494,São Paulo,44411238,0.0152,85103,675234,0.0000,76,1288,0.0000,0,0
2021-01-30,Brazil,203070494,São Paulo,44411238,0.0157,20024,695258,0.0000,10,1298,0.0000,0,0
2021-01-31,Brazil,203070494,São Paulo,44411238,0.0157,3749,699007,0.0000,16,1314,0.0000,0,0
2021-02-01,Brazil,203070494,São Paulo,44411238,0.0169,53069,752076,0.0000,80,1394,0.0000,0,0
2021-02-02,Brazil,203070494,São Paulo,44411238,0.0184,64121,816197,0.0000,136,1530,0.0000,0,0
2021-02-03,Brazil,203070494,São Paulo,44411238,0.0202,83114,899311,0.0000,223,1753,0.0000,0,0
2021-02-04,Brazil,203070494,São Paulo,44411238,0.0229,119371,1018682,0.0000,266,2019,0.0000,0,0
2021-02-05,Brazil,203070494,São Paulo,44411238,0.0254,111079,1129761,0.0001,290,2309,0.0000,0,0
2021-02-06,Brazil,203070494,São Paulo,44411238,0.0262,35258,1165019,0.0001,46,2355,0.0000,0,0
2021-02-07,Brazil,203070494,São Paulo,44411238,0.0265,10125,1175144,0.0001,35,2390,0.0000,0,0
2021-02-08,Brazil,203070494,São Paulo,44411238,0.0289,107281,1282425,0.0001,697,3087,0.0000,0,0
2021-02-09,Brazil,203070494,São Paulo,44411238,0.0307,81561,1363986,0.0001,1842,4929,0.0000,0,0
2021-02-10,Brazil,203070494,São Paulo,44411238,0.0323,69373,1433359,0.0003,7342,12271,0.0000,0,0
2021-02-11,Brazil,203070494,São Paulo,44411238,0.0343,91034,1524393,0.0014,50608,62879,0.0000,0,0
2021-02-12,Brazil,203070494,São Paulo,44411238,0.0371,121093,1645486,0.0032,81240,144119,0.0000,0,0
2021-02-13,Brazil,203070494,São Paulo,44411238,0.0376,25416,1670902,0.0036,13645,157764,0.0000,0,0
2021-02-14,Brazil,203070494,São Paulo,44411238,0.0377,4471,1675373,0.0038,10219,167983,0.0000,0,0
2021-02-15,Brazil,203070494,São Paulo,44411238,0.0392,65248,1740621,0.0053,68480,236463,0.0000,0,0
2021-02-16,Brazil,203070494,São Paulo,44411238,0.0400,36917,1777538,0.0070,73762,310225,0.0000,0,0
2021-02-17,Brazil,203070494,São Paulo,44411238,0.0409,37156,1814694,0.0085,65617,375842,0.0000,0,0
2021-02-18,Brazil,203070494,São Paulo,44411238,0.0417,36980,1851674,0.0100,66154,441996,0.0000,0,0
2021-02-19,Brazil,203070494,São Paulo,44411238,0.0424,29171,1880845,0.0110,48702,490698,0.0000,0,0
2021-02-20,Brazil,203070494,São Paulo,44411238,0.0425,7270,1888115,0.0112,5005,495703,0.0000,0,0
2021-02-21,Brazil,203070494,São Paulo,44411238,0.0426,1625,1889740,0.0112,891,496594,0.0000,0,0
2021-02-22,Brazil,203070494,São Paulo,44411238,0.0430,19907,1909647,0.0118,27753,524347,0.0000,0,0
2021-02-23,Brazil,203070494,São Paulo,44411238,0.0434,16548,1926195,0.0123,23681,548028,0.0000,0,0
2021-02-24,Brazil,203070494,São Paulo,44411238,0.0437,16247,1942442,0.0128,19987,568015,0.0000,0,0
2021-02-25,Brazil,203070494,São Paulo,44411238,0.0440,13505,1955947,0.0132,19266,587281,0.0000,0,0
2021-02-26,Brazil,203070494,São Paulo,44411238,0.0445,22393,1978340,0.0139,27856,615137,0.0000,0,0
2021-02-27,Brazil,203070494,São Paulo,44411238,0.0466,90944,2069284,0.0140,5799,620936,0.0000,0,0
2021-02-28,Brazil,203070494,São Paulo,44411238,0.0470,16638,2085922,0.0140,2334,623270,0.0000,0,0
2021-03-01,Brazil,203070494,São Paulo,44411238,0.0510,181150,2267072,0.0150,43705,666975,0.0000,0,0
2021-03-02,Brazil,203070494,São Paulo,44411238,0.0535,106992,2374064,0.0169,83985,750960,0.0000,0,0
2021-03-03,Brazil,203070494,São Paulo,44411238,0.0578,192426,2566490,0.0187,77955,828915,0.0000,0,0
2021-03-04,Brazil,203070494,São Paulo,44411238,0.0596,80151,2646641,0.0202,69351,898266,0.0000,0,0
2021-03-05,Brazil,203070494,São Paulo,44411238,0.0611,68108,2714749,0.0219,75146,973412,0.0000,0,0
2021-03-06,Brazil,203070494,São Paulo,44411238,0.0622,49695,2764444,0.0225,24660,998072,0.0000,0,0
2021-03-07,Brazil,203070494,São Paulo,44411238,0.0625,9754,2774198,0.0225,3400,1001472,0.0000,0,0
2021-03-08,Brazil,203070494,São Paulo,44411238,0.0640,68004,2842202,0.0237,52707,1054179,0.0000,0,0
2021-03-09,Brazil,203070494,São Paulo,44411238,0.0651,49227,2891429,0.0249,52095,1106274,0.0000,0,0
2021-03-10,Brazil,203070494,São Paulo,44411238,0.0662,47507,2938936,0.0260,47832,1154106,0.0000,0,0
2021-03-11,Brazil,203070494,São Paulo,44411238,0.0671,39918,2978854,0.0271,50190,1204296,0.0000,0,0
2021-03-12,Brazil,203070494,São Paulo,44411238,0.0682,48471,3027325,0.0282,47488,1251784,0.0000,0,0
2021-03-13,Brazil,203070494,São Paulo,44411238,0.0690,35474,3062799,0.0284,11708,1263492,0.0000,0,0
2021-03-14,Brazil,203070494,São Paulo,44411238,0.0691,7020,3069819,0.0285,2332,1265824,0.0000,0,0
2021-03-15,Brazil,203070494,São Paulo,44411238,0.0734,188343,3258162,0.0291,28031,1293855,0.0000,0,0
2021-03-16,Brazil,203070494,São Paulo,44411238,0.0752,83260,3341422,0.0296,22038,1315893,0.0000,0,0
2021-03-17,Brazil,203070494,São Paulo,44411238,0.0765,57952,3399374,0.0301,20583,1336476,0.0000,0,0
2021-03-18,Brazil,203070494,São Paulo,44411238,0.0782,73607,3472981,0.0305,17880,1354356,0.0000,0,0
2021-03-19,Brazil,203070494,São Paulo,44411238,0.0852,309616,3782597,0.0308,15156,1369512,0.0000,0,0
2021-03-20,Brazil,203070494,São Paulo,44411238,0.0875,101484,3884081,0.0309,4795,1374307,0.0000,0,0
2021-03-21,Brazil,203070494,São Paulo,44411238,0.0877,11904,3895985,0.0310,1867,1376174,0.0000,0,0
2021-03-22,Brazil,203070494,São Paulo,44411238,0.0906,129409,4025394,0.0314,20501,1396675,0.0000,0,0
2021-03-23,Brazil,203070494,São Paulo,44411238,0.0924,79261,4104655,0.0320,23241,1419916,0.0000,0,0
2021-03-24,Brazil,203070494,São Paulo,44411238,0.0945,92321,4196976,0.0336,72591,1492507,0.0000,0,0
2021-03-25,Brazil,203070494,São Paulo,44411238,0.0983,170269,4367245,0.0347,46400,1538907,0.0000,0,0
2021-03-26,Brazil,203070494,São Paulo,44411238,0.1054,315766,4683011,0.0355,38349,1577256,0.0000,0,0
2021-03-27,Brazil,203070494,São Paulo,44411238,0.1080,114304,4797315,0.0359,15076,1592332,0.0000,0,0
2021-03-28,Brazil,203070494,São Paulo,44411238,0.1082,8672,4805987,0.0360,4402,1596734,0.0000,0,0
2021-03-29,Brazil,203070494,São Paulo,44411238,0.1110,122177,4928164,0.0371,50687,1647421,0.0000,0,0
2021-03-30,Brazil,203070494,São Paulo,44411238,0.1125,69806,4997970,0.0381,44579,1692000,0.0000,0,0
2021-03-31,Brazil,203070494,São Paulo,44411238,0.1138,54181,5052151,0.0395,61275,1753275,0.0000,0,0
2021-04-01,Brazil,203070494,São Paulo,44411238,0.1154,71308,5123459,0.0404,39417,1792692,0.0000,0,0
2021-04-02,Brazil,203070494,São Paulo,44411238,0.1167,57264,5180723,0.0405,6464,1799156,0.0000,0,0
2021-04-03,Brazil,203070494,São Paulo,44411238,0.1175,39339,5220062,0.0408,14593,1813749,0.0000,0,0
2021-04-04,Brazil,203070494,São Paulo,44411238,0.1176,1763,5221825,0.0409,3460,1817209,0.0000,0,0
2021-04-05,Brazil,203070494,São Paulo,44411238,0.1211,154924,5376749,0.0441,141316,1958525,0.0000,0,0
2021-04-06,Brazil,203070494,São Paulo,44411238,0.1232,94415,5471164,0.0461,86809,2045334,0.0000,0,0
2021-04-07,Brazil,203070494,São Paulo,44411238,0.1249,75126,5546290,0.0474,61726,2107060,0.0000,0,0
2021-04-08,Brazil,203070494,São Paulo,44411238,0.1261,52235,5598525,0.0488,61272,2168332,0.0000,0,0
2021-04-09,Brazil,203070494,São Paulo,44411238,0.1272,49740,5648265,0.0537,215780,2384112,0.0000,0,0
2021-04-10,Brazil,203070494,São Paulo,44411238,0.1290,82597,5730862,0.0549,56008,2440120,0.0000,0,0
2021-04-11,Brazil,203070494,São Paulo,44411238,0.1293,11102,5741964,0.0552,10915,2451035,0.0000,0,0
2021-04-12,Brazil,203070494,São Paulo,44411238,0.1337,194331,5936295,0.0583,139184,2590219,0.0000,1,1
2021-04-13,Brazil,203070494,São Paulo,44411238,0.1368,138132,6074427,0.0603,88465,2678684,0.0000,0,1
2021-04-14,Brazil,203070494,São Paulo,44411238,0.1393,113757,6188184,0.0620,76244,2754928,0.0000,0,1
2021-04-15,Brazil,203070494,São Paulo,44411238,0.1409,68337,6256521,0.0649,129372,2884300,0.0000,0,1
2021-04-16,Brazil,203070494,São Paulo,44411238,0.1421,54677,6311198,0.0714,286597,3170897,0.0000,0,1
2021-04-17,Brazil,203070494,São Paulo,44411238,0.1426,22896,6334094,0.0729,68177,3239074,0.0000,0,1
2021-04-18,Brazil,203070494,São Paulo,44411238,0.1428,9582,6343676,0.0732,10352,3249426,0.0000,0,1
2021-04-19,Brazil,203070494,São Paulo,44411238,0.1446,77491,6421167,0.0764,143026,3392452,0.0000,0,1
2021-04-20,Brazil,203070494,São Paulo,44411238,0.1476,135095,6556262,0.0793,130019,3522471,0.0000,0,1
2021-04-21,Brazil,203070494,São Paulo,44411238,0.1530,239449,6795711,0.0802,37810,3560281,0.0000,0,1
2021-04-22,Brazil,203070494,São Paulo,44411238,0.1563,146167,6941878,0.0835,148892,3709173,0.0000,0,1
2021-04-23,Brazil,203070494,São Paulo,44411238,0.1613,221204,7163082,0.0874,171684,3880857,0.0000,0,1
2021-04-24,Brazil,203070494,São Paulo,44411238,0.1626,57564,7220646,0.0887,57625,3938482,0.0000,0,1
2021-04-25,Brazil,203070494,São Paulo,44411238,0.1627,7007,7227653,0.0888,5759,3944241,0.0000,0,1
2021-04-26,Brazil,203070494,São Paulo,44411238,0.1650,100684,7328337,0.0918,131639,4075880,0.0000,0,1
2021-04-27,Brazil,203070494,São Paulo,44411238,0.1667,75530,7403867,0.0943,112054,4187934,0.0000,0,1
2021-04-28,Brazil,203070494,São Paulo,44411238,0.1692,111358,7515225,0.0970,119905,4307839,0.0000,0,1
2021-04-29,Brazil,203070494,São Paulo,44411238,0.1737,198889,7714114,0.0990,88714,4396553,0.0000,0,1
2021-04-30,Brazil,203070494,São Paulo,44411238,0.1757,89527,7803641,0.1006,69483,4466036,0.0000,0,1
2021-05-01,Brazil,203070494,São Paulo,44411238,0.1762,22128,7825769,0.1012,29602,4495638,0.0000,0,1
2021-05-02,Brazil,203070494,São Paulo,44411238,0.1765,14906,7840675,0.1013,1498,4497136,0.0000,0,1
2021-05-03,Brazil,203070494,São Paulo,44411238,0.1784,83443,7924118,0.1041,125086,4622222,0.0000,0,1
2021-05-04,Brazil,203070494,São Paulo,44411238,0.1818,147939,8072057,0.1063,100866,4723088,0.0000,0,1
2021-05-05,Brazil,203070494,São Paulo,44411238,0.1865,211126,8283183,0.1083,87473,4810561,0.0000,0,1
2021-05-06,Brazil,203070494,São Paulo,44411238,0.1958,414372,8697555,0.1096,55451,4866012,0.0000,0,1
2021-05-07,Brazil,203070494,São Paulo,44411238,0.2006,213211,8910766,0.1110,63724,4929736,0.0000,0,1
2021-05-08,Brazil,203070494,São Paulo,44411238,0.2029,101424,9012190,0.1117,31078,4960814,0.0000,0,1
2021-05-09,Brazil,203070494,São Paulo,44411238,0.2030,3603,9015793,0.1117,1865,4962679,0.0000,0,1
2021-05-10,Brazil,203070494,São Paulo,44411238,0.2054,108153,9123946,0.1134,74187,5036866,0.0000,1,2
2021-05-11,Brazil,203070494,São Paulo,44411238,0.2077,102442,9226388,0.1146,52328,5089194,0.0000,0,2
2021-05-12,Brazil,203070494,São Paulo,44411238,0.2125,209923,9436311,0.1153,32874,5122068,0.0000,0,2
2021-05-13,Brazil,203070494,São Paulo,44411238,0.2160,158351,9594662,0.1158,21020,5143088,0.0000,0,2
2021-05-14,Brazil,203070494,São Paulo,44411238,0.2219,261169,9855831,0.1164,28435,5171523,0.0000,0,2
2021-05-15,Brazil,203070494,São Paulo,44411238,0.2244,110418,9966249,0.1168,16804,5188327,0.0000,0,2
2021-05-16,Brazil,203070494,São Paulo,44411238,0.2262,78053,10044302,0.1169,4649,5192976,0.0000,0,2
2021-05-17,Brazil,203070494,São Paulo,44411238,0.2300,168303,10212605,0.1181,49898,5242874,0.0000,0,2
2021-05-18,Brazil,203070494,São Paulo,44411238,0.2346,205838,10418443,0.1193,53949,5296823,0.0000,0,2
2021-05-19,Brazil,203070494,São Paulo,44411238,0.2385,172708,10591151,0.1200,34602,5331425,0.0000,0,2
2021-05-20,Brazil,203070494,São Paulo,44411238,0.2424,175038,10766189,0.1209,39541,5370966,0.0000,0,2
2021-05-21,Brazil,203070494,São Paulo,44411238,0.2471,209684,10975873,0.1222,58208,5429174,0.0000,0,2
2021-05-22,Brazil,203070494,São Paulo,44411238,0.2492,92056,11067929,0.1233,45054,5474228,0.0000,0,2
2021-05-23,Brazil,203070494,São Paulo,44411238,0.2494,10310,11078239,0.1233,3810,5478038,0.0000,0,2
2021-05-24,Brazil,203070494,São Paulo,44411238,0.2527,142713,11220952,0.1257,103832,5581870,0.0000,0,2
2021-05-25,Brazil,203070494,São Paulo,44411238,0.2559,143674,11364626,0.1272,68407,5650277,0.0000,0,2
2021-05-26,Brazil,203070494,São Paulo,44411238,0.2589,131545,11496171,0.1286,61135,5711412,0.0000,0,2
2021-05-27,Brazil,203070494,São Paulo,44411238,0.2619,136312,11632483,0.1298,53431,5764843,0.0000,1,3
2021-05-28,Brazil,203070494,São Paulo,44411238,0.2671,228800,11861283,0.1308,46344,5811187,0.0000,0,3
2021-05-29,Brazil,203070494,São Paulo,44411238,0.2692,93708,11954991,0.1312,15034,5826221,0.0000,0,3
2021-05-30,Brazil,203070494,São Paulo,44411238,0.2695,12897,11967888,0.1312,760,5826981,0.0000,0,3
2021-05-31,Brazil,203070494,São Paulo,44411238,0.2727,143870,12111758,0.1320,33355,5860336,0.0000,0,3
2021-06-01,Brazil,203070494,São Paulo,44411238,0.2763,158753,12270511,0.1333,60737,5921073,0.0000,0,3
2021-06-02,Brazil,203070494,São Paulo,44411238,0.2820,252969,12523480,0.1342,38105,5959178,0.0000,0,3
2021-06-03,Brazil,203070494,São Paulo,44411238,0.2844,105490,12628970,0.1345,16253,5975431,0.0000,0,3
2021-06-04,Brazil,203070494,São Paulo,44411238,0.2873,129390,12758360,0.1348,12267,5987698,0.0000,0,3
2021-06-05,Brazil,203070494,São Paulo,44411238,0.2889,69871,12828231,0.1351,13049,6000747,0.0000,0,3
2021-06-06,Brazil,203070494,São Paulo,44411238,0.2890,8722,12836953,0.1351,270,6001017,0.0000,1,4
2021-06-07,Brazil,203070494,São Paulo,44411238,0.2930,177317,13014270,0.1355,18625,6019642,0.0000,0,4
2021-06-08,Brazil,203070494,São Paulo,44411238,0.2970,176503,13190773,0.1358,12951,6032593,0.0000,0,4
2021-06-09,Brazil,203070494,São Paulo,44411238,0.3013,190351,13381124,0.1361,9714,6042307,0.0000,0,4
2021-06-10,Brazil,203070494,São Paulo,44411238,0.3060,210101,13591225,0.1363,9785,6052092,0.0000,0,4
2021-06-11,Brazil,203070494,São Paulo,44411238,0.3127,296260,13887485,0.1365,8312,6060404,0.0000,0,4
2021-06-12,Brazil,203070494,São Paulo,44411238,0.3167,178177,14065662,0.1365,1895,6062299,0.0000,0,4
2021-06-13,Brazil,203070494,São Paulo,44411238,0.3170,11241,14076903,0.1365,161,6062460,0.0000,0,4
2021-06-14,Brazil,203070494,São Paulo,44411238,0.3233,282556,14359459,0.1367,8337,6070797,0.0000,0,4
2021-06-15,Brazil,203070494,São Paulo,44411238,0.3307,327847,14687306,0.1369,8013,6078810,0.0000,0,4
2021-06-16,Brazil,203070494,São Paulo,44411238,0.3435,566693,15253999,0.1371,7852,6086662,0.0000,0,4
2021-06-17,Brazil,203070494,São Paulo,44411238,0.3553,524857,15778856,0.1372,7957,6094619,0.0000,0,4
2021-06-18,Brazil,203070494,São Paulo,44411238,0.3660,476275,16255131,0.1374,9233,6103852,0.0000,0,4
2021-06-19,Brazil,203070494,São Paulo,44411238,0.3759,440223,16695354,0.1375,4408,6108260,0.0000,0,4
2021-06-20,Brazil,203070494,São Paulo,44411238,0.3767,34305,16729659,0.1376,948,6109208,0.0000,0,4
2021-06-21,Brazil,203070494,São Paulo,44411238,0.3845,345956,17075615,0.1378,8717,6117925,0.0000,0,4
2021-06-22,Brazil,203070494,São Paulo,44411238,0.3916,317247,17392862,0.1379,5826,6123751,0.0000,0,4
2021-06-23,Brazil,203070494,São Paulo,44411238,0.4023,471565,17864427,0.1381,10228,6133979,0.0000,0,4
2021-06-24,Brazil,203070494,São Paulo,44411238,0.4124,449049,18313476,0.1383,6886,6140865,0.0000,0,4
2021-06-25,Brazil,203070494,São Paulo,44411238,0.4222,436443,18749919,0.1384,7251,6148116,0.0000,0,4
2021-06-26,Brazil,203070494,São Paulo,44411238,0.4286,285116,19035035,0.1385,2899,6151015,0.0000,0,4
2021-06-27,Brazil,203070494,São Paulo,44411238,0.4293,32360,19067395,0.1385,267,6151282,0.0000,0,4
2021-06-28,Brazil,203070494,São Paulo,44411238,0.4382,392202,19459597,0.1394,38706,6189988,0.0000,0,4
2021-06-29,Brazil,203070494,São Paulo,44411238,0.4476,418330,19877927,0.1402,38623,6228611,0.0000,0,4
2021-06-30,Brazil,203070494,São Paulo,44411238,0.4583,477790,20355717,0.1411,37742,6266353,0.0000,0,4
2021-07-01,Brazil,203070494,São Paulo,44411238,0.4660,341082,20696799,0.1419,34486,6300839,0.0000,0,4
2021-07-02,Brazil,203070494,São Paulo,44411238,0.4742,362853,21059652,0.1426,32097,6332936,0.0000,0,4
2021-07-03,Brazil,203070494,São Paulo,44411238,0.4777,153767,21213419,0.1429,13946,6346882,0.0000,0,4
2021-07-04,Brazil,203070494,São Paulo,44411238,0.4778,7065,21220484,0.1430,3625,6350507,0.0000,0,4
2021-07-05,Brazil,203070494,São Paulo,44411238,0.4857,350758,21571242,0.1440,46032,6396539,0.0000,0,4
2021-07-06,Brazil,203070494,São Paulo,44411238,0.4934,339150,21910392,0.1451,48229,6444768,0.0000,0,4
2021-07-07,Brazil,203070494,São Paulo,44411238,0.5038,464052,22374444,0.1463,54764,6499532,0.0000,0,4
2021-07-08,Brazil,203070494,São Paulo,44411238,0.5141,458880,22833324,0.1476,54059,6553591,0.0000,0,4
2021-07-09,Brazil,203070494,São Paulo,44411238,0.5215,326683,23160007,0.1480,20003,6573594,0.0000,0,4
2021-07-10,Brazil,203070494,São Paulo,44411238,0.5241,117014,23277021,0.1485,21395,6594989,0.0000,0,4
2021-07-11,Brazil,203070494,São Paulo,44411238,0.5242,3573,23280594,0.1486,2323,6597312,0.0000,0,4
2021-07-12,Brazil,203070494,São Paulo,44411238,0.5317,333395,23613989,0.1502,74219,6671531,0.0000,2,6
2021-07-13,Brazil,203070494,São Paulo,44411238,0.5369,229922,23843911,0.1523,90445,6761976,0.0000,0,6
2021-07-14,Brazil,203070494,São Paulo,44411238,0.5421,232031,24075942,0.1565,187544,6949520,0.0000,0,6
2021-07-15,Brazil,203070494,São Paulo,44411238,0.5520,438737,24514679,0.1600,157387,7106907,0.0000,0,6
2021-07-16,Brazil,203070494,São Paulo,44411238,0.5617,430079,24944758,0.1647,208992,7315899,0.0000,0,6
2021-07-17,Brazil,203070494,São Paulo,44411238,0.5691,331587,25276345,0.1670,100048,7415947,0.0000,0,6
2021-07-18,Brazil,203070494,São Paulo,44411238,0.5700,36996,25313341,0.1671,3259,7419206,0.0000,0,6
2021-07-19,Brazil,203070494,São Paulo,44411238,0.5800,447313,25760654,0.1702,141635,7560841,0.0000,0,6
2021-07-20,Brazil,203070494,São Paulo,44411238,0.5895,421044,26181698,0.1733,136705,7697546,0.0000,0,6
2021-07-21,Brazil,203070494,São Paulo,44411238,0.5984,393133,26574831,0.1795,274471,7972017,0.0000,0,6
2021-07-22,Brazil,203070494,São Paulo,44411238,0.6073,397361,26972192,0.1858,280342,8252359,0.0000,0,6
2021-07-23,Brazil,203070494,São Paulo,44411238,0.6165,405216,27377408,0.1903,198467,8450826,0.0000,1,7
2021-07-24,Brazil,203070494,São Paulo,44411238,0.6206,185385,27562793,0.1921,82319,8533145,0.0000,0,7
2021-07-25,Brazil,203070494,São Paulo,44411238,0.6208,9871,27572664,0.1927,23450,8556595,0.0000,0,7
2021-07-26,Brazil,203070494,São Paulo,44411238,0.6270,274830,27847494,0.1961,154213,8710808,0.0000,0,7
2021-07-27,Brazil,203070494,São Paulo,44411238,0.6345,330502,28177996,0.2008,208883,8919691,0.0000,0,7
2021-07-28,Brazil,203070494,São Paulo,44411238,0.6385,179723,28357719,0.2055,206281,9125972,0.0000,0,7
2021-07-29,Brazil,203070494,São Paulo,44411238,0.6441,246329,28604048,0.2128,325754,9451726,0.0000,0,7
2021-07-30,Brazil,203070494,São Paulo,44411238,0.6523,365116,28969164,0.2169,180702,9632428,0.0000,0,7
2021-07-31,Brazil,203070494,São Paulo,44411238,0.6560,164816,29133980,0.2190,93245,9725673,0.0000,0,7
2021-08-01,Brazil,203070494,São Paulo,44411238,0.6565,21892,29155872,0.2191,4893,9730566,0.0000,0,7
2021-08-02,Brazil,203070494,São Paulo,44411238,0.6636,316123,29471995,0.2224,147973,9878539,0.0000,0,7
2021-08-03,Brazil,203070494,São Paulo,44411238,0.6717,358835,29830830,0.2256,140373,10018912,0.0000,0,7
2021-08-04,Brazil,203070494,São Paulo,44411238,0.6801,375221,30206051,0.2308,231634,10250546,0.0000,1,8
2021-08-05,Brazil,203070494,São Paulo,44411238,0.6891,395838,30601889,0.2350,184609,10435155,0.0000,0,8
2021-08-06,Brazil,203070494,São Paulo,44411238,0.6975,373855,30975744,0.2407,254961,10690116,0.0000,0,8
2021-08-07,Brazil,203070494,São Paulo,44411238,0.7008,147356,31123100,0.2434,118723,10808839,0.0000,0,8
2021-08-08,Brazil,203070494,São Paulo,44411238,0.7009,4865,31127965,0.2448,63377,10872216,0.0000,0,8
2021-08-09,Brazil,203070494,São Paulo,44411238,0.7065,249674,31377639,0.2499,227167,11099383,0.0000,1,9
2021-08-10,Brazil,203070494,São Paulo,44411238,0.7185,532650,31910289,0.2552,232973,11332356,0.0000,0,9
2021-08-11,Brazil,203070494,São Paulo,44411238,0.7280,422419,32332708,0.2597,200049,11532405,0.0000,0,9
2021-08-12,Brazil,203070494,São Paulo,44411238,0.7388,478738,32811446,0.2647,224986,11757391,0.0000,0,9
2021-08-13,Brazil,203070494,São Paulo,44411238,0.7503,509304,33320750,0.2708,268261,12025652,0.0000,0,9
2021-08-14,Brazil,203070494,São Paulo,44411238,0.7600,432203,33752953,0.2755,210601,12236253,0.0000,0,9
2021-08-15,Brazil,203070494,São Paulo,44411238,0.7656,249474,34002427,0.2766,49822,12286075,0.0000,0,9
2021-08-16,Brazil,203070494,São Paulo,44411238,0.7729,324652,34327079,0.2861,418748,12704823,0.0000,0,9
2021-08-17,Brazil,203070494,São Paulo,44411238,0.7791,272492,34599571,0.2954,415520,13120343,0.0000,0,9
2021-08-18,Brazil,203070494,São Paulo,44411238,0.7840,219155,34818726,0.3056,453239,13573582,0.0000,0,9
2021-08-19,Brazil,203070494,São Paulo,44411238,0.7875,154154,34972880,0.3143,382661,13956243,0.0000,1,10
2021-08-20,Brazil,203070494,São Paulo,44411238,0.7905,133664,35106544,0.3232,396843,14353086,0.0000,0,10
2021-08-21,Brazil,203070494,São Paulo,44411238,0.7925,87732,35194276,0.3264,140959,14494045,0.0000,0,10
2021-08-22,Brazil,203070494,São Paulo,44411238,0.7926,7189,35201465,0.3267,12911,14506956,0.0000,0,10
2021-08-23,Brazil,203070494,São Paulo,44411238,0.7958,139811,35341276,0.3337,312135,14819091,0.0000,0,10
2021-08-24,Brazil,203070494,São Paulo,44411238,0.7989,138985,35480261,0.3399,275534,15094625,0.0000,0,10
2021-08-25,Brazil,203070494,São Paulo,44411238,0.8020,135920,35616181,0.3474,332294,15426919,0.0000,0,10
2021-08-26,Brazil,203070494,São Paulo,44411238,0.8047,119357,35735538,0.3530,251558,15678477,0.0000,0,10
2021-08-27,Brazil,203070494,São Paulo,44411238,0.8072,114431,35849969,0.3606,335102,16013579,0.0000,0,10
2021-08-28,Brazil,203070494,São Paulo,44411238,0.8085,58438,35908407,0.3640,153692,16167271,0.0000,0,10
2021-08-29,Brazil,203070494,São Paulo,44411238,0.8091,26772,35935179,0.3643,10454,16177725,0.0000,1,11
2021-08-30,Brazil,203070494,São Paulo,44411238,0.8181,397432,36332611,0.3720,343271,16520996,0.0000,0,11
2021-08-31,Brazil,203070494,São Paulo,44411238,0.8276,423570,36756181,0.3799,349025,16870021,0.0000,1,12
2021-09-01,Brazil,203070494,São Paulo,44411238,0.8355,351160,37107341,0.3877,348041,17218062,0.0000,0,12
2021-09-02,Brazil,203070494,São Paulo,44411238,0.8411,247632,37354973,0.3970,413454,17631516,0.0000,0,12
2021-09-03,Brazil,203070494,São Paulo,44411238,0.8464,233439,37588412,0.4063,413218,18044734,0.0000,0,12
2021-09-04,Brazil,203070494,São Paulo,44411238,0.8483,86803,37675215,0.4107,196318,18241052,0.0000,0,12
2021-09-05,Brazil,203070494,São Paulo,44411238,0.8487,14430,37689645,0.4112,21564,18262616,0.0000,0,12
2021-09-06,Brazil,203070494,São Paulo,44411238,0.8541,243087,37932732,0.4150,168204,18430820,0.0000,0,12
2021-09-07,Brazil,203070494,São Paulo,44411238,0.8549,32344,37965076,0.4163,58495,18489315,0.0000,0,12
2021-09-08,Brazil,203070494,São Paulo,44411238,0.8605,251455,38216531,0.4305,629386,19118701,0.0000,0,12
2021-09-09,Brazil,203070494,São Paulo,44411238,0.8666,271478,38488009,0.4441,605089,19723790,0.0000,1,13
2021-09-10,Brazil,203070494,São Paulo,44411238,0.8723,252150,38740159,0.4547,471342,20195132,0.0000,0,13
2021-09-11,Brazil,203070494,São Paulo,44411238,0.8751,122879,38863038,0.4607,263720,20458852,0.0000,1,14
2021-09-12,Brazil,203070494,São Paulo,44411238,0.8754,16245,38879283,0.4611,20981,20479833,0.0000,0,14
2021-09-13,Brazil,203070494,São Paulo,44411238,0.8799,196634,39075917,0.4719,478486,20958319,0.0000,0,14
2021-09-14,Brazil,203070494,São Paulo,44411238,0.8838,175605,39251522,0.4829,485789,21444108,0.0000,1,15
2021-09-15,Brazil,203070494,São Paulo,44411238,0.8871,146947,39398469,0.4913,376553,21820661,0.0000,6,21
2021-09-16,Brazil,203070494,São Paulo,44411238,0.8897,112069,39510538,0.4998,377290,22197951,0.0000,2,23
2021-09-17,Brazil,203070494,São Paulo,44411238,0.8917,89929,39600467,0.5091,410013,22607964,0.0000,0,23
2021-09-18,Brazil,203070494,São Paulo,44411238,0.8924,31707,39632174,0.5129,169154,22777118,0.0000,1333,1356
2021-09-19,Brazil,203070494,São Paulo,44411238,0.8924,1757,39633931,0.5132,16092,22793210,0.0000,0,1356
2021-09-20,Brazil,203070494,São Paulo,44411238,0.8939,65816,39699747,0.5211,348851,23142061,0.0000,1,1357
2021-09-21,Brazil,203070494,São Paulo,44411238,0.8952,58128,39757875,0.5292,358969,23501030,0.0000,2,1359
2021-09-22,Brazil,203070494,São Paulo,44411238,0.8965,55662,39813537,0.5375,371884,23872914,0.0000,2,1361
2021-09-23,Brazil,203070494,São Paulo,44411238,0.8978,60147,39873684,0.5451,337666,24210580,0.0000,28,1389
2021-09-24,Brazil,203070494,São Paulo,44411238,0.8991,54903,39928587,0.5536,376697,24587277,0.0000,9,1398
2021-09-25,Brazil,203070494,São Paulo,44411238,0.8996,24179,39952766,0.5569,147035,24734312,0.0000,1,1399
2021-09-26,Brazil,203070494,São Paulo,44411238,0.8997,2001,39954767,0.5572,13307,24747619,0.0000,0,1399
2021-09-27,Brazil,203070494,São Paulo,44411238,0.9009,55597,40010364,0.5652,353441,25101060,0.0000,14,1413
2021-09-28,Brazil,203070494,São Paulo,44411238,0.9020,46435,40056799,0.5726,329290,25430350,0.0000,12,1425
2021-09-29,Brazil,203070494,São Paulo,44411238,0.9028,39383,40096182,0.5796,311844,25742194,0.0000,9,1434
2021-09-30,Brazil,203070494,São Paulo,44411238,0.9038,41807,40137989,0.5870,326641,26068835,0.0000,7,1441
2021-10-01,Brazil,203070494,São Paulo,44411238,0.9045,30083,40168072,0.5932,276491,26345326,0.0000,6,1447
2021-10-02,Brazil,203070494,São Paulo,44411238,0.9054,40569,40208641,0.5982,219691,26565017,0.0000,8,1455
2021-10-03,Brazil,203070494,São Paulo,44411238,0.9054,1407,40210048,0.5983,5711,26570728,0.0000,0,1455
2021-10-04,Brazil,203070494,São Paulo,44411238,0.9061,32763,40242811,0.6039,250473,26821201,0.0000,12,1467
2021-10-05,Brazil,203070494,São Paulo,44411238,0.9068,31095,40273906,0.6094,241583,27062784,0.0000,3,1470
2021-10-06,Brazil,203070494,São Paulo,44411238,0.9075,30555,40304461,0.6151,253947,27316731,0.0000,32,1502
2021-10-07,Brazil,203070494,São Paulo,44411238,0.9081,25196,40329657,0.6211,266001,27582732,0.0000,2,1504
2021-10-08,Brazil,203070494,São Paulo,44411238,0.9087,27013,40356670,0.6269,257243,27839975,0.0000,3,1507
2021-10-09,Brazil,203070494,São Paulo,44411238,0.9089,7306,40363976,0.6290,95726,27935701,0.0000,12,1519
2021-10-10,Brazil,203070494,São Paulo,44411238,0.9089,537,40364513,0.6292,9483,27945184,0.0000,0,1519
2021-10-11,Brazil,203070494,São Paulo,44411238,0.9090,5257,40369770,0.6306,59161,28004345,0.0000,27,1546
2021-10-12,Brazil,203070494,São Paulo,44411238,0.9090,1344,40371114,0.6310,18920,28023265,0.0000,0,1546
2021-10-13,Brazil,203070494,São Paulo,44411238,0.9096,24894,40396008,0.6370,265926,28289191,0.0000,5,1551
2021-10-14,Brazil,203070494,São Paulo,44411238,0.9101,24491,40420499,0.6425,243362,28532553,0.0000,7,1558
2021-10-15,Brazil,203070494,São Paulo,44411238,0.9108,27280,40447779,0.6480,244805,28777358,0.0000,18,1576
2021-10-16,Brazil,203070494,São Paulo,44411238,0.9114,26694,40474473,0.6518,171272,28948630,0.0000,2,1578
2021-10-17,Brazil,203070494,São Paulo,44411238,0.9114,793,40475266,0.6520,5557,28954187,0.0000,0,1578
2021-10-18,Brazil,203070494,São Paulo,44411238,0.9119,22132,40497398,0.6565,203296,29157483,0.0000,7,1585
2021-10-19,Brazil,203070494,São Paulo,44411238,0.9124,25081,40522479,0.6613,213786,29371269,0.0000,19,1604
2021-10-20,Brazil,203070494,São Paulo,44411238,0.9130,24425,40546904,0.6658,198836,29570105,0.0000,44,1648
2021-10-21,Brazil,203070494,São Paulo,44411238,0.9135,23866,40570770,0.6699,182657,29752762,0.0000,36,1684
2021-10-22,Brazil,203070494,São Paulo,44411238,0.9141,24536,40595306,0.6744,196108,29948870,0.0000,17,1701
2021-10-23,Brazil,203070494,São Paulo,44411238,0.9143,11220,40606526,0.6761,75771,30024641,0.0000,1,1702
2021-10-24,Brazil,203070494,São Paulo,44411238,0.9144,1306,40607832,0.6762,4637,30029278,0.0000,0,1702
2021-10-25,Brazil,203070494,São Paulo,44411238,0.9149,22706,40630538,0.6813,228558,30257836,0.0000,20,1722
2021-10-26,Brazil,203070494,São Paulo,44411238,0.9154,24246,40654784,0.6870,252302,30510138,0.0000,4,1726
2021-10-27,Brazil,203070494,São Paulo,44411238,0.9160,24846,40679630,0.6931,272507,30782645,0.0000,4,1730
2021-10-28,Brazil,203070494,São Paulo,44411238,0.9165,24262,40703892,0.6979,212658,30995303,0.0000,7,1737
2021-10-29,Brazil,203070494,São Paulo,44411238,0.9168,13450,40717342,0.7008,129155,31124458,0.0000,4,1741
2021-10-30,Brazil,203070494,São Paulo,44411238,0.9170,8972,40726314,0.7022,60434,31184892,0.0000,0,1741
2021-10-31,Brazil,203070494,São Paulo,44411238,0.9170,625,40726939,0.7023,3653,31188545,0.0000,0,1741
2021-11-01,Brazil,203070494,São Paulo,44411238,0.9171,2504,40729443,0.7031,38567,31227112,0.0000,0,1741
2021-11-02,Brazil,203070494,São Paulo,44411238,0.9172,2470,40731913,0.7035,14126,31241238,0.0000,1,1742
2021-11-03,Brazil,203070494,São Paulo,44411238,0.9177,26376,40758289,0.7095,269416,31510654,0.0000,7,1749
2021-11-04,Brazil,203070494,São Paulo,44411238,0.9184,31107,40789396,0.7152,251694,31762348,0.0000,3,1752
2021-11-05,Brazil,203070494,São Paulo,44411238,0.9192,34064,40823460,0.7212,268362,32030710,0.0000,1,1753
2021-11-06,Brazil,203070494,São Paulo,44411238,0.9195,12993,40836453,0.7232,88395,32119105,0.0000,3,1756
2021-11-07,Brazil,203070494,São Paulo,44411238,0.9195,567,40837020,0.7233,3901,32123006,0.0000,0,1756
2021-11-08,Brazil,203070494,São Paulo,44411238,0.9200,20646,40857666,0.7284,227116,32350122,0.0000,2,1758
2021-11-09,Brazil,203070494,São Paulo,44411238,0.9204,18267,40875933,0.7333,216789,32566911,0.0000,18,1776
2021-11-10,Brazil,203070494,São Paulo,44411238,0.9208,16195,40892128,0.7374,183639,32750550,0.0000,15,1791
2021-11-11,Brazil,203070494,São Paulo,44411238,0.9212,17395,40909523,0.7414,178012,32928562,0.0000,25,1816
2021-11-12,Brazil,203070494,São Paulo,44411238,0.9215,17127,40926650,0.7456,183589,33112151,0.0000,4,1820
2021-11-13,Brazil,203070494,São Paulo,44411238,0.9217,5987,40932637,0.7474,78815,33190966,0.0000,0,1820
2021-11-14,Brazil,203070494,São Paulo,44411238,0.9217,465,40933102,0.7474,3438,33194404,0.0000,0,1820
2021-11-15,Brazil,203070494,São Paulo,44411238,0.9217,1357,40934459,0.7478,14387,33208791,0.0000,0,1820
2021-11-16,Brazil,203070494,São Paulo,44411238,0.9221,15586,40950045,0.7512,151583,33360374,0.0000,3,1823
2021-11-17,Brazil,203070494,São Paulo,44411238,0.9224,16221,40966266,0.7546,153003,33513377,0.0000,2,1825
2021-11-18,Brazil,203070494,São Paulo,44411238,0.9228,14333,40980599,0.7573,120124,33633501,0.0000,3,1828
2021-11-19,Brazil,203070494,São Paulo,44411238,0.9231,13255,40993854,0.7599,115990,33749491,0.0000,1,1829
2021-11-20,Brazil,203070494,São Paulo,44411238,0.9232,7519,41001373,0.7608,40543,33790034,0.0000,0,1829
2021-11-21,Brazil,203070494,São Paulo,44411238,0.9232,381,41001754,0.7609,2924,33792958,0.0000,0,1829
2021-11-22,Brazil,203070494,São Paulo,44411238,0.9236,14697,41016451,0.7641,142380,33935338,0.0000,8,1837
2021-11-23,Brazil,203070494,São Paulo,44411238,0.9237,6901,41023352,0.7675,148986,34084324,0.0000,17,1854
2021-11-24,Brazil,203070494,São Paulo,44411238,0.9238,5673,41029025,0.7694,84598,34168922,0.0000,1,1855
2021-11-25,Brazil,203070494,São Paulo,44411238,0.9242,14893,41043918,0.7724,134865,34303787,0.0000,2,1857
2021-11-26,Brazil,203070494,São Paulo,44411238,0.9245,14195,41058113,0.7752,122549,34426336,0.0000,1,1858
2021-11-27,Brazil,203070494,São Paulo,44411238,0.9246,2623,41060736,0.7759,34564,34460900,0.0000,0,1858
2021-11-28,Brazil,203070494,São Paulo,44411238,0.9246,918,41061654,0.7760,3241,34464141,0.0000,0,1858
2021-11-29,Brazil,203070494,São Paulo,44411238,0.9249,14230,41075884,0.7788,123413,34587554,0.0000,1,1859
2021-11-30,Brazil,203070494,São Paulo,44411238,0.9252,14058,41089942,0.7811,100684,34688238,0.0000,10,1869
2021-12-01,Brazil,203070494,São Paulo,44411238,0.9255,14493,41104435,0.7836,113782,34802020,0.0000,5,1874
2021-12-02,Brazil,203070494,São Paulo,44411238,0.9259,15135,41119570,0.7862,114265,34916285,0.0000,14,1888
2021-12-03,Brazil,203070494,São Paulo,44411238,0.9262,14632,41134202,0.7887,110430,35026715,0.0000,5,1893
2021-12-04,Brazil,203070494,São Paulo,44411238,0.9263,4855,41139057,0.7896,40650,35067365,0.0000,3,1896
2021-12-05,Brazil,203070494,São Paulo,44411238,0.9263,362,41139419,0.7897,2192,35069557,0.0000,0,1896
2021-12-06,Brazil,203070494,São Paulo,44411238,0.9266,12940,41152359,0.7917,90524,35160081,0.0000,9,1905
2021-12-07,Brazil,203070494,São Paulo,44411238,0.9269,11825,41164184,0.7935,79443,35239524,0.0000,4,1909
2021-12-08,Brazil,203070494,São Paulo,44411238,0.9271,10538,41174722,0.7950,67860,35307384,0.0000,4,1913
2021-12-09,Brazil,203070494,São Paulo,44411238,0.9274,12242,41186964,0.7970,86706,35394090,0.0000,15,1928
2021-12-10,Brazil,203070494,São Paulo,44411238,0.9277,11588,41198552,0.7987,78361,35472451,0.0000,6,1934
2021-12-11,Brazil,203070494,São Paulo,44411238,0.9278,4080,41202632,0.7993,25338,35497789,0.0000,1,1935
2021-12-12,Brazil,203070494,São Paulo,44411238,0.9278,426,41203058,0.7993,1639,35499428,0.0000,1,1936
2021-12-13,Brazil,203070494,São Paulo,44411238,0.9280,10380,41213438,0.8009,67506,35566934,0.0000,11,1947
2021-12-14,Brazil,203070494,São Paulo,44411238,0.9282,10608,41224046,0.8023,64020,35630954,0.0000,28,1975
2021-12-15,Brazil,203070494,São Paulo,44411238,0.9284,9256,41233302,0.8035,54914,35685868,0.0000,90,2065
2021-12-16,Brazil,203070494,São Paulo,44411238,0.9287,9990,41243292,0.8049,60595,35746463,0.0000,123,2188
2021-12-17,Brazil,203070494,São Paulo,44411238,0.9289,9265,41252557,0.8061,51496,35797959,0.0000,9,2197
2021-12-18,Brazil,203070494,São Paulo,44411238,0.9289,2278,41254835,0.8064,13320,35811279,0.0001,88,2285
2021-12-19,Brazil,203070494,São Paulo,44411238,0.9289,251,41255086,0.8064,1262,35812541,0.0001,0,2285
2021-12-20,Brazil,203070494,São Paulo,44411238,0.9291,9179,41264265,0.8074,45674,35858215,0.0001,5,2290
2021-12-21,Brazil,203070494,São Paulo,44411238,0.9293,8350,41272615,0.8084,43249,35901464,0.0001,7,2297
2021-12-22,Brazil,203070494,São Paulo,44411238,0.9295,7423,41280038,0.8092,37753,35939217,0.0001,5,2302
2021-12-23,Brazil,203070494,São Paulo,44411238,0.9296,5555,41285593,0.8099,27826,35967043,0.0001,5,2307
2021-12-24,Brazil,203070494,São Paulo,44411238,0.9296,542,41286135,0.8099,2731,35969774,0.0001,0,2307
2021-12-25,Brazil,203070494,São Paulo,44411238,0.9296,9,41286144,0.8099,30,35969804,0.0001,0,2307
2021-12-26,Brazil,203070494,São Paulo,44411238,0.9296,73,41286217,0.8099,236,35970040,0.0001,0,2307
2021-12-27,Brazil,203070494,São Paulo,44411238,0.9298,5671,41291888,0.8105,26694,35996734,0.0001,5,2312
2021-12-28,Brazil,203070494,São Paulo,44411238,0.9299,6388,41298276,0.8112,30074,36026808,0.0001,39,2351
2021-12-29,Brazil,203070494,São Paulo,44411238,0.9300,6203,41304479,0.8119,30999,36057807,0.0001,3,2354
2021-12-30,Brazil,203070494,São Paulo,44411238,0.9301,4301,41308780,0.8124,20528,36078335,0.0001,2,2356
2021-12-31,Brazil,203070494,São Paulo,44411238,0.9302,369,41309149,0.8124,1761,36080096,0.0001,0,2356
2021-01-17,Brazil,203070494,Tocantins,1511460,0.0000,6,6,0.0000,1,1,0.0000,0,0
2021-01-18,Brazil,203070494,Tocantins,1511460,0.0000,11,17,0.0000,0,1,0.0000,0,0
2021-01-19,Brazil,203070494,Tocantins,1511460,0.0000,7,24,0.0000,0,1,0.0000,0,0
2021-01-20,Brazil,203070494,Tocantins,1511460,0.0001,127,151,0.0000,1,2,0.0000,0,0
2021-01-21,Brazil,203070494,Tocantins,1511460,0.0006,701,852,0.0000,0,2,0.0000,0,0
2021-01-22,Brazil,203070494,Tocantins,1511460,0.0020,2120,2972,0.0000,12,14,0.0000,0,0
2021-01-23,Brazil,203070494,Tocantins,1511460,0.0023,481,3453,0.0000,0,14,0.0000,0,0
2021-01-24,Brazil,203070494,Tocantins,1511460,0.0023,45,3498,0.0000,1,15,0.0000,0,0
2021-01-25,Brazil,203070494,Tocantins,1511460,0.0034,1606,5104,0.0000,3,18,0.0000,0,0
2021-01-26,Brazil,203070494,Tocantins,1511460,0.0043,1388,6492,0.0000,1,19,0.0000,0,0
2021-01-27,Brazil,203070494,Tocantins,1511460,0.0053,1477,7969,0.0000,0,19,0.0000,0,0
2021-01-28,Brazil,203070494,Tocantins,1511460,0.0063,1598,9567,0.0000,3,22,0.0000,0,0
2021-01-29,Brazil,203070494,Tocantins,1511460,0.0072,1330,10897,0.0000,0,22,0.0000,0,0
2021-01-30,Brazil,203070494,Tocantins,1511460,0.0072,59,10956,0.0000,1,23,0.0000,0,0
2021-01-31,Brazil,203070494,Tocantins,1511460,0.0073,29,10985,0.0000,1,24,0.0000,0,0
2021-02-01,Brazil,203070494,Tocantins,1511460,0.0080,1046,12031,0.0000,4,28,0.0000,0,0
2021-02-02,Brazil,203070494,Tocantins,1511460,0.0092,1811,13842,0.0000,9,37,0.0000,0,0
2021-02-03,Brazil,203070494,Tocantins,1511460,0.0103,1754,15596,0.0000,7,44,0.0000,0,0
2021-02-04,Brazil,203070494,Tocantins,1511460,0.0116,2005,17601,0.0000,8,52,0.0000,0,0
2021-02-05,Brazil,203070494,Tocantins,1511460,0.0129,1940,19541,0.0000,3,55,0.0000,0,0
2021-02-06,Brazil,203070494,Tocantins,1511460,0.0133,581,20122,0.0000,1,56,0.0000,0,0
2021-02-07,Brazil,203070494,Tocantins,1511460,0.0135,229,20351,0.0000,2,58,0.0000,0,0
2021-02-08,Brazil,203070494,Tocantins,1511460,0.0144,1485,21836,0.0001,37,95,0.0000,0,0
2021-02-09,Brazil,203070494,Tocantins,1511460,0.0153,1276,23112,0.0001,99,194,0.0000,0,0
2021-02-10,Brazil,203070494,Tocantins,1511460,0.0160,1104,24216,0.0003,188,382,0.0000,0,0
2021-02-11,Brazil,203070494,Tocantins,1511460,0.0175,2208,26424,0.0003,109,491,0.0000,0,0
2021-02-12,Brazil,203070494,Tocantins,1511460,0.0201,3992,30416,0.0004,180,671,0.0000,0,0
2021-02-13,Brazil,203070494,Tocantins,1511460,0.0209,1115,31531,0.0005,17,688,0.0000,0,0
2021-02-14,Brazil,203070494,Tocantins,1511460,0.0209,6,31537,0.0005,0,688,0.0000,0,0
2021-02-15,Brazil,203070494,Tocantins,1511460,0.0225,2430,33967,0.0005,84,772,0.0000,0,0
2021-02-16,Brazil,203070494,Tocantins,1511460,0.0233,1176,35143,0.0006,152,924,0.0000,0,0
2021-02-17,Brazil,203070494,Tocantins,1511460,0.0245,1833,36976,0.0009,435,1359,0.0000,0,0
2021-02-18,Brazil,203070494,Tocantins,1511460,0.0269,3665,40641,0.0016,1028,2387,0.0000,0,0
2021-02-19,Brazil,203070494,Tocantins,1511460,0.0287,2711,43352,0.0024,1253,3640,0.0000,0,0
2021-02-20,Brazil,203070494,Tocantins,1511460,0.0290,429,43781,0.0031,1048,4688,0.0000,0,0
2021-02-21,Brazil,203070494,Tocantins,1511460,0.0290,22,43803,0.0031,7,4695,0.0000,0,0
2021-02-22,Brazil,203070494,Tocantins,1511460,0.0301,1758,45561,0.0040,1363,6058,0.0000,0,0
2021-02-23,Brazil,203070494,Tocantins,1511460,0.0310,1220,46781,0.0048,1130,7188,0.0000,0,0
2021-02-24,Brazil,203070494,Tocantins,1511460,0.0318,1230,48011,0.0057,1491,8679,0.0000,0,0
2021-02-25,Brazil,203070494,Tocantins,1511460,0.0323,848,48859,0.0065,1124,9803,0.0000,0,0
2021-02-26,Brazil,203070494,Tocantins,1511460,0.0328,647,49506,0.0072,1006,10809,0.0000,0,0
2021-02-27,Brazil,203070494,Tocantins,1511460,0.0328,29,49535,0.0077,766,11575,0.0000,0,0
2021-02-28,Brazil,203070494,Tocantins,1511460,0.0328,8,49543,0.0077,14,11589,0.0000,0,0
2021-03-01,Brazil,203070494,Tocantins,1511460,0.0331,458,50001,0.0080,551,12140,0.0000,0,0
2021-03-02,Brazil,203070494,Tocantins,1511460,0.0342,1738,51739,0.0084,511,12651,0.0000,0,0
2021-03-03,Brazil,203070494,Tocantins,1511460,0.0353,1609,53348,0.0091,1122,13773,0.0000,0,0
2021-03-04,Brazil,203070494,Tocantins,1511460,0.0359,952,54300,0.0102,1581,15354,0.0000,0,0
2021-03-05,Brazil,203070494,Tocantins,1511460,0.0365,859,55159,0.0105,568,15922,0.0000,0,0
2021-03-06,Brazil,203070494,Tocantins,1511460,0.0365,40,55199,0.0110,672,16594,0.0000,0,0
2021-03-07,Brazil,203070494,Tocantins,1511460,0.0365,12,55211,0.0110,11,16605,0.0000,0,0
2021-03-08,Brazil,203070494,Tocantins,1511460,0.0369,635,55846,0.0112,388,16993,0.0000,0,0
2021-03-09,Brazil,203070494,Tocantins,1511460,0.0378,1300,57146,0.0115,456,17449,0.0000,0,0
2021-03-10,Brazil,203070494,Tocantins,1511460,0.0386,1179,58325,0.0122,928,18377,0.0000,0,0
2021-03-11,Brazil,203070494,Tocantins,1511460,0.0393,1028,59353,0.0134,1801,20178,0.0000,0,0
2021-03-12,Brazil,203070494,Tocantins,1511460,0.0397,678,60031,0.0146,1890,22068,0.0000,0,0
2021-03-13,Brazil,203070494,Tocantins,1511460,0.0398,61,60092,0.0149,519,22587,0.0000,0,0
2021-03-14,Brazil,203070494,Tocantins,1511460,0.0398,6,60098,0.0149,6,22593,0.0000,0,0
2021-03-15,Brazil,203070494,Tocantins,1511460,0.0401,525,60623,0.0162,1886,24479,0.0000,0,0
2021-03-16,Brazil,203070494,Tocantins,1511460,0.0406,769,61392,0.0175,1946,26425,0.0000,0,0
2021-03-17,Brazil,203070494,Tocantins,1511460,0.0410,532,61924,0.0184,1428,27853,0.0000,0,0
2021-03-18,Brazil,203070494,Tocantins,1511460,0.0434,3598,65522,0.0199,2269,30122,0.0000,0,0
2021-03-19,Brazil,203070494,Tocantins,1511460,0.0443,1406,66928,0.0211,1707,31829,0.0000,0,0
2021-03-20,Brazil,203070494,Tocantins,1511460,0.0444,108,67036,0.0212,180,32009,0.0000,0,0
2021-03-21,Brazil,203070494,Tocantins,1511460,0.0444,41,67077,0.0212,10,32019,0.0000,0,0
2021-03-22,Brazil,203070494,Tocantins,1511460,0.0451,1098,68175,0.0222,1486,33505,0.0000,0,0
2021-03-23,Brazil,203070494,Tocantins,1511460,0.0456,816,68991,0.0229,1168,34673,0.0000,0,0
2021-03-24,Brazil,203070494,Tocantins,1511460,0.0465,1366,70357,0.0237,1111,35784,0.0000,0,0
2021-03-25,Brazil,203070494,Tocantins,1511460,0.0525,8920,79277,0.0242,852,36636,0.0000,0,0
2021-03-26,Brazil,203070494,Tocantins,1511460,0.0597,10922,90199,0.0246,487,37123,0.0000,0,0
2021-03-27,Brazil,203070494,Tocantins,1511460,0.0643,6961,97160,0.0246,80,37203,0.0000,0,0
2021-03-28,Brazil,203070494,Tocantins,1511460,0.0645,254,97414,0.0246,16,37219,0.0000,0,0
2021-03-29,Brazil,203070494,Tocantins,1511460,0.0680,5380,102794,0.0249,470,37689,0.0000,0,0
2021-03-30,Brazil,203070494,Tocantins,1511460,0.0725,6762,109556,0.0254,729,38418,0.0000,0,0
2021-03-31,Brazil,203070494,Tocantins,1511460,0.0787,9349,118905,0.0258,508,38926,0.0000,0,0
2021-04-01,Brazil,203070494,Tocantins,1511460,0.0827,6083,124988,0.0259,234,39160,0.0000,0,0
2021-04-02,Brazil,203070494,Tocantins,1511460,0.0828,178,125166,0.0259,26,39186,0.0000,0,0
2021-04-03,Brazil,203070494,Tocantins,1511460,0.0831,480,125646,0.0259,21,39207,0.0000,0,0
2021-04-04,Brazil,203070494,Tocantins,1511460,0.0832,67,125713,0.0259,7,39214,0.0000,0,0
2021-04-05,Brazil,203070494,Tocantins,1511460,0.0868,5497,131210,0.0264,754,39968,0.0000,0,0
2021-04-06,Brazil,203070494,Tocantins,1511460,0.0900,4781,135991,0.0271,1048,41016,0.0000,0,0
2021-04-07,Brazil,203070494,Tocantins,1511460,0.0922,3441,139432,0.0276,758,41774,0.0000,0,0
2021-04-08,Brazil,203070494,Tocantins,1511460,0.0942,2940,142372,0.0285,1250,43024,0.0000,0,0
2021-04-09,Brazil,203070494,Tocantins,1511460,0.0959,2582,144954,0.0289,675,43699,0.0000,0,0
2021-04-10,Brazil,203070494,Tocantins,1511460,0.0961,310,145264,0.0290,83,43782,0.0000,0,0
2021-04-11,Brazil,203070494,Tocantins,1511460,0.0961,7,145271,0.0290,2,43784,0.0000,0,0
2021-04-12,Brazil,203070494,Tocantins,1511460,0.0967,947,146218,0.0293,533,44317,0.0000,0,0
2021-04-13,Brazil,203070494,Tocantins,1511460,0.0975,1167,147385,0.0298,658,44975,0.0000,0,0
2021-04-14,Brazil,203070494,Tocantins,1511460,0.0979,640,148025,0.0303,773,45748,0.0000,0,0
2021-04-15,Brazil,203070494,Tocantins,1511460,0.1009,4492,152517,0.0324,3263,49011,0.0000,0,0
2021-04-16,Brazil,203070494,Tocantins,1511460,0.1025,2380,154897,0.0343,2792,51803,0.0000,0,0
2021-04-17,Brazil,203070494,Tocantins,1511460,0.1027,352,155249,0.0365,3309,55112,0.0000,0,0
2021-04-18,Brazil,203070494,Tocantins,1511460,0.1027,3,155252,0.0365,20,55132,0.0000,0,0
2021-04-19,Brazil,203070494,Tocantins,1511460,0.1038,1630,156882,0.0376,1742,56874,0.0000,0,0
2021-04-20,Brazil,203070494,Tocantins,1511460,0.1051,1933,158815,0.0396,2934,59808,0.0000,0,0
2021-04-21,Brazil,203070494,Tocantins,1511460,0.1078,4159,162974,0.0412,2520,62328,0.0000,0,0
2021-04-22,Brazil,203070494,Tocantins,1511460,0.1113,5216,168190,0.0457,6802,69130,0.0000,0,0
2021-04-23,Brazil,203070494,Tocantins,1511460,0.1141,4304,172494,0.0504,7104,76234,0.0000,0,0
2021-04-24,Brazil,203070494,Tocantins,1511460,0.1147,910,173404,0.0525,3060,79294,0.0000,0,0
2021-04-25,Brazil,203070494,Tocantins,1511460,0.1148,97,173501,0.0527,330,79624,0.0000,0,0
2021-04-26,Brazil,203070494,Tocantins,1511460,0.1163,2340,175841,0.0568,6273,85897,0.0000,0,0
2021-04-27,Brazil,203070494,Tocantins,1511460,0.1177,2099,177940,0.0595,4095,89992,0.0000,0,0
2021-04-28,Brazil,203070494,Tocantins,1511460,0.1186,1352,179292,0.0644,7386,97378,0.0000,0,0
2021-04-29,Brazil,203070494,Tocantins,1511460,0.1232,6974,186266,0.0679,5295,102673,0.0000,0,0
2021-04-30,Brazil,203070494,Tocantins,1511460,0.1262,4432,190698,0.0694,2178,104851,0.0000,0,0
2021-05-01,Brazil,203070494,Tocantins,1511460,0.1271,1476,192174,0.0695,247,105098,0.0000,0,0
2021-05-02,Brazil,203070494,Tocantins,1511460,0.1272,20,192194,0.0695,10,105108,0.0000,0,0
2021-05-03,Brazil,203070494,Tocantins,1511460,0.1284,1925,194119,0.0726,4600,109708,0.0000,0,0
2021-05-04,Brazil,203070494,Tocantins,1511460,0.1308,3598,197717,0.0748,3361,113069,0.0000,0,0
2021-05-05,Brazil,203070494,Tocantins,1511460,0.1315,972,198689,0.0770,3375,116444,0.0000,0,0
2021-05-06,Brazil,203070494,Tocantins,1511460,0.1356,6292,204981,0.0791,3053,119497,0.0000,0,0
2021-05-07,Brazil,203070494,Tocantins,1511460,0.1397,6157,211138,0.0802,1702,121199,0.0000,0,0
2021-05-08,Brazil,203070494,Tocantins,1511460,0.1408,1729,212867,0.0803,134,121333,0.0000,0,0
2021-05-09,Brazil,203070494,Tocantins,1511460,0.1408,12,212879,0.0803,72,121405,0.0000,0,0
2021-05-10,Brazil,203070494,Tocantins,1511460,0.1429,3070,215949,0.0814,1674,123079,0.0000,0,0
2021-05-11,Brazil,203070494,Tocantins,1511460,0.1450,3208,219157,0.0824,1509,124588,0.0000,0,0
2021-05-12,Brazil,203070494,Tocantins,1511460,0.1471,3192,222349,0.0830,922,125510,0.0000,0,0
2021-05-13,Brazil,203070494,Tocantins,1511460,0.1497,3943,226292,0.0839,1239,126749,0.0000,0,0
2021-05-14,Brazil,203070494,Tocantins,1511460,0.1528,4595,230887,0.0842,557,127306,0.0000,0,0
2021-05-15,Brazil,203070494,Tocantins,1511460,0.1538,1551,232438,0.0842,5,127311,0.0000,0,0
2021-05-16,Brazil,203070494,Tocantins,1511460,0.1538,8,232446,0.0842,4,127315,0.0000,0,0
2021-05-17,Brazil,203070494,Tocantins,1511460,0.1565,4118,236564,0.0846,597,127912,0.0000,0,0
2021-05-18,Brazil,203070494,Tocantins,1511460,0.1594,4363,240927,0.0852,801,128713,0.0000,0,0
2021-05-19,Brazil,203070494,Tocantins,1511460,0.1622,4198,245125,0.0856,664,129377,0.0000,0,0
2021-05-20,Brazil,203070494,Tocantins,1511460,0.1658,5409,250534,0.0859,436,129813,0.0000,0,0
2021-05-21,Brazil,203070494,Tocantins,1511460,0.1678,3088,253622,0.0861,269,130082,0.0000,0,0
2021-05-22,Brazil,203070494,Tocantins,1511460,0.1682,575,254197,0.0861,13,130095,0.0000,0,0
2021-05-23,Brazil,203070494,Tocantins,1511460,0.1682,14,254211,0.0861,11,130106,0.0000,0,0
2021-05-24,Brazil,203070494,Tocantins,1511460,0.1703,3152,257363,0.0863,288,130394,0.0000,0,0
2021-05-25,Brazil,203070494,Tocantins,1511460,0.1729,3964,261327,0.0865,332,130726,0.0000,0,0
2021-05-26,Brazil,203070494,Tocantins,1511460,0.1751,3320,264647,0.0867,354,131080,0.0000,0,0
2021-05-27,Brazil,203070494,Tocantins,1511460,0.1776,3775,268422,0.0870,446,131526,0.0000,0,0
2021-05-28,Brazil,203070494,Tocantins,1511460,0.1807,4624,273046,0.0873,450,131976,0.0000,0,0
2021-05-29,Brazil,203070494,Tocantins,1511460,0.1813,979,274025,0.0873,8,131984,0.0000,0,0
2021-05-30,Brazil,203070494,Tocantins,1511460,0.1813,12,274037,0.0873,8,131992,0.0000,0,0
2021-05-31,Brazil,203070494,Tocantins,1511460,0.1837,3632,277669,0.0877,523,132515,0.0000,0,0
2021-06-01,Brazil,203070494,Tocantins,1511460,0.1873,5486,283155,0.0890,2065,134580,0.0000,0,0
2021-06-02,Brazil,203070494,Tocantins,1511460,0.1919,6926,290081,0.0910,2999,137579,0.0000,0,0
2021-06-03,Brazil,203070494,Tocantins,1511460,0.1937,2666,292747,0.0913,471,138050,0.0000,0,0
2021-06-04,Brazil,203070494,Tocantins,1511460,0.1952,2250,294997,0.0918,632,138682,0.0000,0,0
2021-06-05,Brazil,203070494,Tocantins,1511460,0.1954,380,295377,0.0919,290,138972,0.0000,0,0
2021-06-06,Brazil,203070494,Tocantins,1511460,0.1955,77,295454,0.0920,10,138982,0.0000,0,0
2021-06-07,Brazil,203070494,Tocantins,1511460,0.1984,4406,299860,0.0928,1261,140243,0.0000,0,0
2021-06-08,Brazil,203070494,Tocantins,1511460,0.2028,6694,306554,0.0933,799,141042,0.0000,0,0
2021-06-09,Brazil,203070494,Tocantins,1511460,0.2078,7549,314103,0.0938,801,141843,0.0000,0,0
2021-06-10,Brazil,203070494,Tocantins,1511460,0.2140,9296,323399,0.0945,935,142778,0.0000,0,0
2021-06-11,Brazil,203070494,Tocantins,1511460,0.2199,8936,332335,0.0948,569,143347,0.0000,0,0
2021-06-12,Brazil,203070494,Tocantins,1511460,0.2216,2615,334950,0.0950,208,143555,0.0000,0,0
2021-06-13,Brazil,203070494,Tocantins,1511460,0.2216,36,334986,0.0950,2,143557,0.0000,0,0
2021-06-14,Brazil,203070494,Tocantins,1511460,0.2263,7112,342098,0.0953,458,144015,0.0000,0,0
2021-06-15,Brazil,203070494,Tocantins,1511460,0.2320,8615,350713,0.0956,477,144492,0.0000,0,0
2021-06-16,Brazil,203070494,Tocantins,1511460,0.2374,8173,358886,0.0958,322,144814,0.0000,0,0
2021-06-17,Brazil,203070494,Tocantins,1511460,0.2430,8427,367313,0.0961,365,145179,0.0000,0,0
2021-06-18,Brazil,203070494,Tocantins,1511460,0.2495,9732,377045,0.0964,458,145637,0.0000,0,0
2021-06-19,Brazil,203070494,Tocantins,1511460,0.2517,3333,380378,0.0964,24,145661,0.0000,0,0
2021-06-20,Brazil,203070494,Tocantins,1511460,0.2517,38,380416,0.0964,12,145673,0.0000,0,0
2021-06-21,Brazil,203070494,Tocantins,1511460,0.2581,9751,390167,0.0966,403,146076,0.0000,0,0
2021-06-22,Brazil,203070494,Tocantins,1511460,0.2652,10701,400868,0.0969,385,146461,0.0000,0,0
2021-06-23,Brazil,203070494,Tocantins,1511460,0.2725,11050,411918,0.0973,598,147059,0.0000,0,0
2021-06-24,Brazil,203070494,Tocantins,1511460,0.2802,11586,423504,0.0978,709,147768,0.0000,0,0
2021-06-25,Brazil,203070494,Tocantins,1511460,0.2875,11092,434596,0.0981,570,148338,0.0000,0,0
2021-06-26,Brazil,203070494,Tocantins,1511460,0.2902,4091,438687,0.0983,298,148636,0.0000,0,0
2021-06-27,Brazil,203070494,Tocantins,1511460,0.2903,150,438837,0.0983,2,148638,0.0000,0,0
2021-06-28,Brazil,203070494,Tocantins,1511460,0.2978,11277,450114,0.0988,712,149350,0.0000,0,0
2021-06-29,Brazil,203070494,Tocantins,1511460,0.3046,10268,460382,0.0994,826,150176,0.0000,0,0
2021-06-30,Brazil,203070494,Tocantins,1511460,0.3095,7364,467746,0.1000,962,151138,0.0000,0,0
2021-07-01,Brazil,203070494,Tocantins,1511460,0.3174,12061,479807,0.1009,1330,152468,0.0000,0,0
2021-07-02,Brazil,203070494,Tocantins,1511460,0.3251,11542,491349,0.1017,1320,153788,0.0000,0,0
2021-07-03,Brazil,203070494,Tocantins,1511460,0.3297,6913,498262,0.1019,190,153978,0.0000,0,0
2021-07-04,Brazil,203070494,Tocantins,1511460,0.3297,48,498310,0.1019,16,153994,0.0000,0,0
2021-07-05,Brazil,203070494,Tocantins,1511460,0.3368,10775,509085,0.1028,1390,155384,0.0000,0,0
2021-07-06,Brazil,203070494,Tocantins,1511460,0.3436,10258,519343,0.1037,1314,156698,0.0000,0,0
2021-07-07,Brazil,203070494,Tocantins,1511460,0.3502,9901,529244,0.1045,1237,157935,0.0000,0,0
2021-07-08,Brazil,203070494,Tocantins,1511460,0.3590,13327,542571,0.1053,1182,159117,0.0000,0,0
2021-07-09,Brazil,203070494,Tocantins,1511460,0.3664,11204,553775,0.1062,1356,160473,0.0000,0,0
2021-07-10,Brazil,203070494,Tocantins,1511460,0.3682,2670,556445,0.1065,467,160940,0.0000,0,0
2021-07-11,Brazil,203070494,Tocantins,1511460,0.3682,5,556450,0.1065,7,160947,0.0000,0,0
2021-07-12,Brazil,203070494,Tocantins,1511460,0.3742,9088,565538,0.1083,2712,163659,0.0000,0,0
2021-07-13,Brazil,203070494,Tocantins,1511460,0.3797,8392,573930,0.1097,2101,165760,0.0000,0,0
2021-07-14,Brazil,203070494,Tocantins,1511460,0.3857,9000,582930,0.1113,2435,168195,0.0000,0,0
2021-07-15,Brazil,203070494,Tocantins,1511460,0.3909,7939,590869,0.1128,2263,170458,0.0000,0,0
2021-07-16,Brazil,203070494,Tocantins,1511460,0.3956,7100,597969,0.1143,2377,172835,0.0000,0,0
2021-07-17,Brazil,203070494,Tocantins,1511460,0.3970,2131,600100,0.1145,228,173063,0.0000,0,0
2021-07-18,Brazil,203070494,Tocantins,1511460,0.3970,14,600114,0.1145,6,173069,0.0000,0,0
2021-07-19,Brazil,203070494,Tocantins,1511460,0.4015,6786,606900,0.1161,2417,175486,0.0000,0,0
2021-07-20,Brazil,203070494,Tocantins,1511460,0.4056,6159,613059,0.1182,3183,178669,0.0000,0,0
2021-07-21,Brazil,203070494,Tocantins,1511460,0.4084,4267,617326,0.1207,3742,182411,0.0000,0,0
2021-07-22,Brazil,203070494,Tocantins,1511460,0.4149,9768,627094,0.1232,3836,186247,0.0000,0,0
2021-07-23,Brazil,203070494,Tocantins,1511460,0.4184,5333,632427,0.1251,2854,189101,0.0000,0,0
2021-07-24,Brazil,203070494,Tocantins,1511460,0.4192,1235,633662,0.1252,196,189297,0.0000,0,0
2021-07-25,Brazil,203070494,Tocantins,1511460,0.4192,4,633666,0.1252,7,189304,0.0000,0,0
2021-07-26,Brazil,203070494,Tocantins,1511460,0.4217,3647,637313,0.1273,3097,192401,0.0000,0,0
2021-07-27,Brazil,203070494,Tocantins,1511460,0.4239,3358,640671,0.1294,3129,195530,0.0000,0,0
2021-07-28,Brazil,203070494,Tocantins,1511460,0.4267,4215,644886,0.1322,4301,199831,0.0000,0,0
2021-07-29,Brazil,203070494,Tocantins,1511460,0.4347,12110,656996,0.1354,4894,204725,0.0000,0,0
2021-07-30,Brazil,203070494,Tocantins,1511460,0.4404,8683,665679,0.1378,3615,208340,0.0000,0,0
2021-07-31,Brazil,203070494,Tocantins,1511460,0.4433,4419,670098,0.1382,510,208850,0.0000,0,0
2021-08-01,Brazil,203070494,Tocantins,1511460,0.4434,15,670113,0.1382,28,208878,0.0000,0,0
2021-08-02,Brazil,203070494,Tocantins,1511460,0.4474,6131,676244,0.1411,4415,213293,0.0000,0,0
2021-08-03,Brazil,203070494,Tocantins,1511460,0.4518,6603,682847,0.1438,4127,217420,0.0000,0,0
2021-08-04,Brazil,203070494,Tocantins,1511460,0.4558,6018,688865,0.1465,3941,221361,0.0000,0,0
2021-08-05,Brazil,203070494,Tocantins,1511460,0.4647,13563,702428,0.1501,5527,226888,0.0000,0,0
2021-08-06,Brazil,203070494,Tocantins,1511460,0.4719,10780,713208,0.1537,5351,232239,0.0000,0,0
2021-08-07,Brazil,203070494,Tocantins,1511460,0.4754,5338,718546,0.1546,1433,233672,0.0000,0,0
2021-08-08,Brazil,203070494,Tocantins,1511460,0.4754,20,718566,0.1546,10,233682,0.0000,0,0
2021-08-09,Brazil,203070494,Tocantins,1511460,0.4802,7182,725748,0.1582,5395,239077,0.0000,0,0
2021-08-10,Brazil,203070494,Tocantins,1511460,0.4847,6904,732652,0.1623,6250,245327,0.0000,0,0
2021-08-11,Brazil,203070494,Tocantins,1511460,0.4884,5489,738141,0.1663,6022,251349,0.0000,0,0
2021-08-12,Brazil,203070494,Tocantins,1511460,0.4988,15780,753921,0.1702,5975,257324,0.0000,0,0
2021-08-13,Brazil,203070494,Tocantins,1511460,0.5079,13736,767657,0.1739,5564,262888,0.0000,0,0
2021-08-14,Brazil,203070494,Tocantins,1511460,0.5129,7604,775261,0.1747,1120,264008,0.0000,0,0
2021-08-15,Brazil,203070494,Tocantins,1511460,0.5129,15,775276,0.1747,33,264041,0.0000,0,0
2021-08-16,Brazil,203070494,Tocantins,1511460,0.5183,8182,783458,0.1786,5901,269942,0.0000,0,0
2021-08-17,Brazil,203070494,Tocantins,1511460,0.5249,9901,793359,0.1822,5375,275317,0.0000,0,0
2021-08-18,Brazil,203070494,Tocantins,1511460,0.5299,7610,800969,0.1855,5089,280406,0.0000,0,0
2021-08-19,Brazil,203070494,Tocantins,1511460,0.5412,17022,817991,0.1895,5983,286389,0.0000,0,0
2021-08-20,Brazil,203070494,Tocantins,1511460,0.5494,12365,830356,0.1928,5087,291476,0.0000,0,0
2021-08-21,Brazil,203070494,Tocantins,1511460,0.5575,12216,842572,0.1942,2056,293532,0.0000,0,0
2021-08-22,Brazil,203070494,Tocantins,1511460,0.5575,9,842581,0.1942,9,293541,0.0000,0,0
2021-08-23,Brazil,203070494,Tocantins,1511460,0.5623,7336,849917,0.1983,6127,299668,0.0000,0,0
2021-08-24,Brazil,203070494,Tocantins,1511460,0.5672,7416,857333,0.2019,5526,305194,0.0000,0,0
2021-08-25,Brazil,203070494,Tocantins,1511460,0.5712,5940,863273,0.2052,5007,310201,0.0000,0,0
2021-08-26,Brazil,203070494,Tocantins,1511460,0.5771,9038,872311,0.2084,4785,314986,0.0000,0,0
2021-08-27,Brazil,203070494,Tocantins,1511460,0.5805,5162,877473,0.2113,4353,319339,0.0000,0,0
2021-08-28,Brazil,203070494,Tocantins,1511460,0.5815,1486,878959,0.2134,3227,322566,0.0000,0,0
2021-08-29,Brazil,203070494,Tocantins,1511460,0.5815,4,878963,0.2134,9,322575,0.0000,0,0
2021-08-30,Brazil,203070494,Tocantins,1511460,0.5842,3970,882933,0.2173,5920,328495,0.0000,0,0
2021-08-31,Brazil,203070494,Tocantins,1511460,0.5868,4046,886979,0.2213,6041,334536,0.0000,0,0
2021-09-01,Brazil,203070494,Tocantins,1511460,0.5894,3902,890881,0.2267,8099,342635,0.0000,0,0
2021-09-02,Brazil,203070494,Tocantins,1511460,0.5922,4209,895090,0.2339,10825,353460,0.0000,0,0
2021-09-03,Brazil,203070494,Tocantins,1511460,0.5968,6940,902030,0.2404,9970,363430,0.0000,0,0
2021-09-04,Brazil,203070494,Tocantins,1511460,0.5987,2809,904839,0.2418,2092,365522,0.0000,0,0
2021-09-05,Brazil,203070494,Tocantins,1511460,0.5987,60,904899,0.2419,38,365560,0.0000,0,0
2021-09-06,Brazil,203070494,Tocantins,1511460,0.6013,3938,908837,0.2446,4096,369656,0.0000,0,0
2021-09-07,Brazil,203070494,Tocantins,1511460,0.6020,990,909827,0.2447,247,369903,0.0000,0,0
2021-09-08,Brazil,203070494,Tocantins,1511460,0.6045,3912,913739,0.2461,2119,372022,0.0000,0,0
2021-09-09,Brazil,203070494,Tocantins,1511460,0.6103,8720,922459,0.2539,11761,383783,0.0000,0,0
2021-09-10,Brazil,203070494,Tocantins,1511460,0.6185,12406,934865,0.2597,8765,392548,0.0000,0,0
2021-09-11,Brazil,203070494,Tocantins,1511460,0.6211,3848,938713,0.2599,286,392834,0.0000,0,0
2021-09-12,Brazil,203070494,Tocantins,1511460,0.6212,183,938896,0.2599,22,392856,0.0000,0,0
2021-09-13,Brazil,203070494,Tocantins,1511460,0.6262,7532,946428,0.2657,8668,401524,0.0000,0,0
2021-09-14,Brazil,203070494,Tocantins,1511460,0.6317,8392,954820,0.2716,9010,410534,0.0000,0,0
2021-09-15,Brazil,203070494,Tocantins,1511460,0.6372,8229,963049,0.2772,8470,419004,0.0000,0,0
2021-09-16,Brazil,203070494,Tocantins,1511460,0.6449,11617,974666,0.2829,8556,427560,0.0000,0,0
2021-09-17,Brazil,203070494,Tocantins,1511460,0.6466,2639,977305,0.2880,7698,435258,0.0000,0,0
2021-09-18,Brazil,203070494,Tocantins,1511460,0.6471,807,978112,0.2889,1348,436606,0.0000,0,0
2021-09-19,Brazil,203070494,Tocantins,1511460,0.6471,7,978119,0.2889,12,436618,0.0000,0,0
2021-09-20,Brazil,203070494,Tocantins,1511460,0.6489,2614,980733,0.2946,8653,445271,0.0000,0,0
2021-09-21,Brazil,203070494,Tocantins,1511460,0.6507,2749,983482,0.2997,7742,453013,0.0000,0,0
2021-09-22,Brazil,203070494,Tocantins,1511460,0.6540,5077,988559,0.3043,6972,459985,0.0000,0,0
2021-09-23,Brazil,203070494,Tocantins,1511460,0.6583,6364,994923,0.3101,8645,468630,0.0000,0,0
2021-09-24,Brazil,203070494,Tocantins,1511460,0.6641,8848,1003771,0.3148,7203,475833,0.0000,0,0
2021-09-25,Brazil,203070494,Tocantins,1511460,0.6660,2898,1006669,0.3164,2417,478250,0.0000,0,0
2021-09-26,Brazil,203070494,Tocantins,1511460,0.6660,5,1006674,0.3164,29,478279,0.0000,0,0
2021-09-27,Brazil,203070494,Tocantins,1511460,0.6685,3776,1010450,0.3217,7929,486208,0.0000,0,0
2021-09-28,Brazil,203070494,Tocantins,1511460,0.6716,4576,1015026,0.3264,7155,493363,0.0000,0,0
2021-09-29,Brazil,203070494,Tocantins,1511460,0.6749,5076,1020102,0.3314,7609,500972,0.0000,0,0
2021-09-30,Brazil,203070494,Tocantins,1511460,0.6784,5232,1025334,0.3373,8913,509885,0.0000,0,0
2021-10-01,Brazil,203070494,Tocantins,1511460,0.6804,3114,1028448,0.3417,6524,516409,0.0000,0,0
2021-10-02,Brazil,203070494,Tocantins,1511460,0.6809,678,1029126,0.3432,2252,518661,0.0000,0,0
2021-10-03,Brazil,203070494,Tocantins,1511460,0.6809,7,1029133,0.3432,10,518671,0.0000,0,0
2021-10-04,Brazil,203070494,Tocantins,1511460,0.6818,1379,1030512,0.3465,5032,523703,0.0000,0,0
2021-10-05,Brazil,203070494,Tocantins,1511460,0.6819,146,1030658,0.3467,273,523976,0.0000,0,0
2021-10-06,Brazil,203070494,Tocantins,1511460,0.6839,3003,1033661,0.3532,9897,533873,0.0000,0,0
2021-10-07,Brazil,203070494,Tocantins,1511460,0.6863,3592,1037253,0.3599,10045,543918,0.0000,0,0
2021-10-08,Brazil,203070494,Tocantins,1511460,0.6881,2830,1040083,0.3653,8152,552070,0.0000,0,0
2021-10-09,Brazil,203070494,Tocantins,1511460,0.6884,470,1040553,0.3668,2346,554416,0.0000,0,0
2021-10-10,Brazil,203070494,Tocantins,1511460,0.6885,41,1040594,0.3668,53,554469,0.0000,0,0
2021-10-11,Brazil,203070494,Tocantins,1511460,0.6892,1067,1041661,0.3699,4608,559077,0.0000,0,0
2021-10-12,Brazil,203070494,Tocantins,1511460,0.6893,236,1041897,0.3701,290,559367,0.0000,0,0
2021-10-13,Brazil,203070494,Tocantins,1511460,0.6911,2668,1044565,0.3763,9393,568760,0.0000,0,0
2021-10-14,Brazil,203070494,Tocantins,1511460,0.6927,2451,1047016,0.3825,9331,578091,0.0000,0,0
2021-10-15,Brazil,203070494,Tocantins,1511460,0.6940,1954,1048970,0.3872,7123,585214,0.0000,0,0
2021-10-16,Brazil,203070494,Tocantins,1511460,0.6948,1175,1050145,0.3905,5034,590248,0.0000,0,0
2021-10-17,Brazil,203070494,Tocantins,1511460,0.6948,14,1050159,0.3905,32,590280,0.0000,0,0
2021-10-18,Brazil,203070494,Tocantins,1511460,0.6958,1487,1051646,0.3952,7054,597334,0.0000,0,0
2021-10-19,Brazil,203070494,Tocantins,1511460,0.6971,1929,1053575,0.4010,8711,606045,0.0000,0,0
2021-10-20,Brazil,203070494,Tocantins,1511460,0.6985,2120,1055695,0.4066,8525,614570,0.0000,0,0
2021-10-21,Brazil,203070494,Tocantins,1511460,0.6996,1662,1057357,0.4120,8152,622722,0.0000,0,0
2021-10-22,Brazil,203070494,Tocantins,1511460,0.7006,1498,1058855,0.4180,9124,631846,0.0000,0,0
2021-10-23,Brazil,203070494,Tocantins,1511460,0.7009,524,1059379,0.4205,3753,635599,0.0000,0,0
2021-10-24,Brazil,203070494,Tocantins,1511460,0.7010,124,1059503,0.4207,337,635936,0.0000,0,0
2021-10-25,Brazil,203070494,Tocantins,1511460,0.7019,1416,1060919,0.4253,6957,642893,0.0000,0,0
2021-10-26,Brazil,203070494,Tocantins,1511460,0.7029,1477,1062396,0.4307,8086,650979,0.0000,0,0
2021-10-27,Brazil,203070494,Tocantins,1511460,0.7039,1530,1063926,0.4352,6869,657848,0.0000,0,0
2021-10-28,Brazil,203070494,Tocantins,1511460,0.7048,1374,1065300,0.4396,6598,664446,0.0000,0,0
2021-10-29,Brazil,203070494,Tocantins,1511460,0.7055,1023,1066323,0.4441,6759,671205,0.0000,0,0
2021-10-30,Brazil,203070494,Tocantins,1511460,0.7056,167,1066490,0.4447,872,672077,0.0000,0,0
2021-10-31,Brazil,203070494,Tocantins,1511460,0.7056,53,1066543,0.4449,401,672478,0.0000,0,0
2021-11-01,Brazil,203070494,Tocantins,1511460,0.7058,175,1066718,0.4454,742,673220,0.0000,0,0
2021-11-02,Brazil,203070494,Tocantins,1511460,0.7058,4,1066722,0.4454,15,673235,0.0000,0,0
2021-11-03,Brazil,203070494,Tocantins,1511460,0.7065,1151,1067873,0.4495,6148,679383,0.0000,0,0
2021-11-04,Brazil,203070494,Tocantins,1511460,0.7074,1380,1069253,0.4541,6963,686346,0.0000,0,0
2021-11-05,Brazil,203070494,Tocantins,1511460,0.7082,1228,1070481,0.4588,7081,693427,0.0000,0,0
2021-11-06,Brazil,203070494,Tocantins,1511460,0.7084,221,1070702,0.4604,2376,695803,0.0000,0,0
2021-11-07,Brazil,203070494,Tocantins,1511460,0.7084,40,1070742,0.4606,307,696110,0.0000,0,0
2021-11-08,Brazil,203070494,Tocantins,1511460,0.7090,907,1071649,0.4641,5357,701467,0.0000,0,0
2021-11-09,Brazil,203070494,Tocantins,1511460,0.7098,1244,1072893,0.4688,7080,708547,0.0000,0,0
2021-11-10,Brazil,203070494,Tocantins,1511460,0.7107,1290,1074183,0.4726,5832,714379,0.0000,0,0
2021-11-11,Brazil,203070494,Tocantins,1511460,0.7116,1441,1075624,0.4775,7384,721763,0.0000,0,0
2021-11-12,Brazil,203070494,Tocantins,1511460,0.7124,1140,1076764,0.4811,5435,727198,0.0000,0,0
2021-11-13,Brazil,203070494,Tocantins,1511460,0.7125,129,1076893,0.4816,763,727961,0.0000,0,0
2021-11-14,Brazil,203070494,Tocantins,1511460,0.7125,63,1076956,0.4818,237,728198,0.0000,0,0
2021-11-15,Brazil,203070494,Tocantins,1511460,0.7126,55,1077011,0.4819,229,728427,0.0000,0,0
2021-11-16,Brazil,203070494,Tocantins,1511460,0.7132,993,1078004,0.4858,5895,734322,0.0000,0,0
2021-11-17,Brazil,203070494,Tocantins,1511460,0.7140,1151,1079155,0.4907,7319,741641,0.0000,0,0
2021-11-18,Brazil,203070494,Tocantins,1511460,0.7147,1154,1080309,0.4965,8847,750488,0.0000,0,0
2021-11-19,Brazil,203070494,Tocantins,1511460,0.7155,1160,1081469,0.5007,6322,756810,0.0000,0,0
2021-11-20,Brazil,203070494,Tocantins,1511460,0.7156,187,1081656,0.5014,1016,757826,0.0000,0,0
2021-11-21,Brazil,203070494,Tocantins,1511460,0.7157,37,1081693,0.5015,108,757934,0.0000,0,0
2021-11-22,Brazil,203070494,Tocantins,1511460,0.7163,943,1082636,0.5052,5657,763591,0.0000,0,0
2021-11-23,Brazil,203070494,Tocantins,1511460,0.7170,1062,1083698,0.5097,6835,770426,0.0000,0,0
2021-11-24,Brazil,203070494,Tocantins,1511460,0.7177,1086,1084784,0.5141,6560,776986,0.0000,0,0
2021-11-25,Brazil,203070494,Tocantins,1511460,0.7184,1062,1085846,0.5178,5592,782578,0.0000,0,0
2021-11-26,Brazil,203070494,Tocantins,1511460,0.7190,882,1086728,0.5214,5563,788141,0.0000,0,0
2021-11-27,Brazil,203070494,Tocantins,1511460,0.7191,105,1086833,0.5217,436,788577,0.0000,0,0
2021-11-28,Brazil,203070494,Tocantins,1511460,0.7191,40,1086873,0.5218,168,788745,0.0000,0,0
2021-11-29,Brazil,203070494,Tocantins,1511460,0.7196,820,1087693,0.5247,4246,792991,0.0000,0,0
2021-11-30,Brazil,203070494,Tocantins,1511460,0.7203,1001,1088694,0.5285,5762,798753,0.0000,0,0
2021-12-01,Brazil,203070494,Tocantins,1511460,0.7209,915,1089609,0.5314,4442,803195,0.0000,0,0
2021-12-02,Brazil,203070494,Tocantins,1511460,0.7216,1026,1090635,0.5346,4842,808037,0.0000,0,0
2021-12-03,Brazil,203070494,Tocantins,1511460,0.7222,886,1091521,0.5377,4698,812735,0.0000,0,0
2021-12-04,Brazil,203070494,Tocantins,1511460,0.7222,78,1091599,0.5381,639,813374,0.0000,0,0
2021-12-05,Brazil,203070494,Tocantins,1511460,0.7222,42,1091641,0.5383,170,813544,0.0000,0,0
2021-12-06,Brazil,203070494,Tocantins,1511460,0.7228,882,1092523,0.5412,4461,818005,0.0000,0,0
2021-12-07,Brazil,203070494,Tocantins,1511460,0.7235,1046,1093569,0.5444,4898,822903,0.0000,0,0
2021-12-08,Brazil,203070494,Tocantins,1511460,0.7241,945,1094514,0.5473,4324,827227,0.0000,0,0
2021-12-09,Brazil,203070494,Tocantins,1511460,0.7248,1062,1095576,0.5506,4945,832172,0.0000,0,0
2021-12-10,Brazil,203070494,Tocantins,1511460,0.7252,574,1096150,0.5526,3133,835305,0.0000,0,0
2021-12-11,Brazil,203070494,Tocantins,1511460,0.7253,93,1096243,0.5529,395,835700,0.0000,0,0
2021-12-12,Brazil,203070494,Tocantins,1511460,0.7253,64,1096307,0.5531,250,835950,0.0000,0,0
2021-12-13,Brazil,203070494,Tocantins,1511460,0.7258,723,1097030,0.5555,3649,839599,0.0000,0,0
2021-12-14,Brazil,203070494,Tocantins,1511460,0.7263,724,1097754,0.5581,3952,843551,0.0000,0,0
2021-12-15,Brazil,203070494,Tocantins,1511460,0.7268,781,1098535,0.5605,3583,847134,0.0000,0,0
2021-12-16,Brazil,203070494,Tocantins,1511460,0.7273,739,1099274,0.5628,3591,850725,0.0000,0,0
2021-12-17,Brazil,203070494,Tocantins,1511460,0.7276,519,1099793,0.5647,2795,853520,0.0000,0,0
2021-12-18,Brazil,203070494,Tocantins,1511460,0.7277,98,1099891,0.5650,409,853929,0.0000,0,0
2021-12-19,Brazil,203070494,Tocantins,1511460,0.7277,38,1099929,0.5651,218,854147,0.0000,0,0
2021-12-20,Brazil,203070494,Tocantins,1511460,0.7281,510,1100439,0.5669,2627,856774,0.0000,0,0
2021-12-21,Brazil,203070494,Tocantins,1511460,0.7285,605,1101044,0.5687,2727,859501,0.0000,0,0
2021-12-22,Brazil,203070494,Tocantins,1511460,0.7287,419,1101463,0.5701,2200,861701,0.0000,0,0
2021-12-23,Brazil,203070494,Tocantins,1511460,0.7289,260,1101723,0.5710,1388,863089,0.0000,0,0
2021-12-24,Brazil,203070494,Tocantins,1511460,0.7289,16,1101739,0.5711,74,863163,0.0000,0,0
2021-12-25,Brazil,203070494,Tocantins,1511460,0.7289,1,1101740,0.5711,2,863165,0.0000,0,0
2021-12-26,Brazil,203070494,Tocantins,1511460,0.7289,3,1101743,0.5711,4,863169,0.0000,0,0
2021-12-27,Brazil,203070494,Tocantins,1511460,0.7291,243,1101986,0.5719,1266,864435,0.0000,0,0
2021-12-28,Brazil,203070494,Tocantins,1511460,0.7293,306,1102292,0.5729,1508,865943,0.0000,0,0
2021-12-29,Brazil,203070494,Tocantins,1511460,0.7295,267,1102559,0.5738,1395,867338,0.0000,0,0
2021-12-30,Brazil,203070494,Tocantins,1511460,0.7296,230,1102789,0.5745,998,868336,0.0000,0,0
2021-12-31,Brazil,203070494,Tocantins,1511460,0.7296,12,1102801,0.5745,63,868399,0.0000,0,0
